,date,team_name,games,minutes,field_goals,field_goal_attempts,field_goal_percentage,three_points,three_point_attempts,three_point_percentage,two_points,two_point_attempts,two_point_percentage,free_throws,free_throw_attempts,free_throw_percentage,offensive_rebounds,defensive_rebounds,total_rebounds,assists,steals,turn_overs,personal_fouls,points
0,2017-10-18,Houston Rockets,1,240,47,97,0.485,15,41,0.366,32,56,0.571,13,19,0.684,10,33,43,28,9,12,16,122
1,2017-10-18,Golden State Warriors,1,240,43,80,0.538,16,30,0.533,27,50,0.54,19,21,0.905,6,35,41,34,5,17,25,121
2,2017-10-18,Cleveland Cavaliers,1,240,38,83,0.458,5,22,0.227,33,61,0.541,21,25,0.84,9,41,50,19,3,17,25,102
3,2017-10-18,Boston Celtics,1,240,36,88,0.409,8,32,0.25,28,56,0.5,19,25,0.76,9,37,46,24,11,10,24,99
4,2017-10-19,Indiana Pacers,1,240,53,102,0.52,9,34,0.265,44,68,0.647,25,32,0.781,14,33,47,29,12,14,25,140
5,2017-10-19,Brooklyn Nets,1,240,45,94,0.479,12,30,0.4,33,64,0.516,29,32,0.906,11,32,43,22,7,20,25,131
6,2017-10-19,Portland Trail Blazers,1,240,44,90,0.489,14,24,0.583,30,66,0.455,22,28,0.786,15,42,57,22,8,16,20,124
7,2017-10-19,Golden State Warriors,1,240,43,80,0.538,16,30,0.533,27,50,0.54,19,21,0.905,6,35,41,34,5,17,25,121
8,2017-10-19,Washington Wizards,1,240,42,97,0.433,6,22,0.273,36,75,0.48,30,38,0.789,16,36,52,21,8,9,20,120
9,2017-10-19,Atlanta Hawks,1,240,48,94,0.511,9,18,0.5,39,76,0.513,12,15,0.8,14,36,50,20,11,13,18,117
10,2017-10-19,Orlando Magic,1,240,43,90,0.478,8,21,0.381,35,69,0.507,22,29,0.759,11,39,50,22,8,14,18,116
11,2017-10-19,Philadelphia 76ers,1,240,43,93,0.462,15,35,0.429,28,58,0.483,14,19,0.737,11,37,48,25,6,17,28,115
12,2017-10-19,Houston Rockets,2,480,80,180,0.444,27,86,0.314,53,94,0.564,40,48,0.833,22,65,87,47,16,26,30,227
13,2017-10-19,Dallas Mavericks,1,240,38,86,0.442,17,45,0.378,21,41,0.512,18,21,0.857,9,32,41,27,5,15,19,111
14,2017-10-19,Miami Heat,1,240,44,101,0.436,8,30,0.267,36,71,0.507,13,17,0.765,11,33,44,27,6,13,20,109
15,2017-10-19,Milwaukee Bucks,1,240,38,76,0.5,7,21,0.333,31,55,0.564,25,30,0.833,6,39,45,19,6,15,22,108
16,2017-10-19,San Antonio Spurs,1,240,41,89,0.461,8,21,0.381,33,68,0.485,17,19,0.895,12,38,50,22,8,11,18,107
17,2017-10-19,Utah Jazz,1,240,41,81,0.506,9,24,0.375,32,57,0.561,15,16,0.938,6,30,36,28,9,15,18,106
18,2017-10-19,Memphis Grizzlies,1,240,39,92,0.424,9,29,0.31,30,63,0.476,16,28,0.571,15,30,45,19,9,11,29,103
19,2017-10-19,Detroit Pistons,1,240,41,96,0.427,9,26,0.346,32,70,0.457,11,12,0.917,9,38,47,24,14,8,21,102
20,2017-10-19,Cleveland Cavaliers,1,240,38,83,0.458,5,22,0.227,33,61,0.541,21,25,0.84,9,41,50,19,3,17,25,102
21,2017-10-19,Sacramento Kings,1,240,42,88,0.477,8,23,0.348,34,65,0.523,8,10,0.8,9,33,42,19,5,17,20,100
22,2017-10-19,Boston Celtics,2,480,75,179,0.419,19,60,0.317,56,119,0.471,30,46,0.652,20,69,89,47,23,22,51,199
23,2017-10-19,Minnesota Timberwolves,1,240,37,85,0.435,8,19,0.421,29,66,0.439,17,23,0.739,11,31,42,23,7,13,16,99
24,2017-10-19,Denver Nuggets,1,240,36,77,0.468,13,27,0.481,23,50,0.46,11,12,0.917,7,31,38,21,4,20,18,96
25,2017-10-19,New Orleans Pelicans,1,240,30,79,0.38,7,25,0.28,23,54,0.426,24,29,0.828,16,35,51,15,4,17,31,91
26,2017-10-19,Charlotte Hornets,1,240,29,73,0.397,9,30,0.3,20,43,0.465,23,29,0.793,3,44,47,16,4,17,15,90
27,2017-10-19,Phoenix Suns,1,240,28,89,0.315,7,27,0.259,21,62,0.339,13,18,0.722,10,23,33,10,9,16,22,76
28,2017-10-20,Indiana Pacers,1,240,53,102,0.52,9,34,0.265,44,68,0.647,25,32,0.781,14,33,47,29,12,14,25,140
29,2017-10-20,Brooklyn Nets,1,240,45,94,0.479,12,30,0.4,33,64,0.516,29,32,0.906,11,32,43,22,7,20,25,131
30,2017-10-20,Portland Trail Blazers,1,240,44,90,0.489,14,24,0.583,30,66,0.455,22,28,0.786,15,42,57,22,8,16,20,124
31,2017-10-20,Golden State Warriors,1,240,43,80,0.538,16,30,0.533,27,50,0.54,19,21,0.905,6,35,41,34,5,17,25,121
32,2017-10-20,Washington Wizards,1,240,42,97,0.433,6,22,0.273,36,75,0.48,30,38,0.789,16,36,52,21,8,9,20,120
33,2017-10-20,Atlanta Hawks,1,240,48,94,0.511,9,18,0.5,39,76,0.513,12,15,0.8,14,36,50,20,11,13,18,117
34,2017-10-20,Toronto Raptors,1,240,39,83,0.47,13,29,0.448,26,54,0.481,26,28,0.929,13,36,49,26,10,17,19,117
35,2017-10-20,Orlando Magic,1,240,43,90,0.478,8,21,0.381,35,69,0.507,22,29,0.759,11,39,50,22,8,14,18,116
36,2017-10-20,Philadelphia 76ers,1,240,43,93,0.462,15,35,0.429,28,58,0.483,14,19,0.737,11,37,48,25,6,17,28,115
37,2017-10-20,Houston Rockets,2,480,80,180,0.444,27,86,0.314,53,94,0.564,40,48,0.833,22,65,87,47,16,26,30,227
38,2017-10-20,Dallas Mavericks,1,240,38,86,0.442,17,45,0.378,21,41,0.512,18,21,0.857,9,32,41,27,5,15,19,111
39,2017-10-20,Miami Heat,1,240,44,101,0.436,8,30,0.267,36,71,0.507,13,17,0.765,11,33,44,27,6,13,20,109
40,2017-10-20,Milwaukee Bucks,1,240,38,76,0.5,7,21,0.333,31,55,0.564,25,30,0.833,6,39,45,19,6,15,22,108
41,2017-10-20,Los Angeles Clippers,1,240,42,107,0.393,12,33,0.364,30,74,0.405,12,13,0.923,17,42,59,23,12,14,20,108
42,2017-10-20,San Antonio Spurs,1,240,41,89,0.461,8,21,0.381,33,68,0.485,17,19,0.895,12,38,50,22,8,11,18,107
43,2017-10-20,Utah Jazz,1,240,41,81,0.506,9,24,0.375,32,57,0.561,15,16,0.938,6,30,36,28,9,15,18,106
44,2017-10-20,Oklahoma City Thunder,1,240,39,90,0.433,11,38,0.289,28,52,0.538,16,22,0.727,13,28,41,26,14,18,22,105
45,2017-10-20,Memphis Grizzlies,1,240,39,92,0.424,9,29,0.31,30,63,0.476,16,28,0.571,15,30,45,19,9,11,29,103
46,2017-10-20,Detroit Pistons,1,240,41,96,0.427,9,26,0.346,32,70,0.457,11,12,0.917,9,38,47,24,14,8,21,102
47,2017-10-20,Cleveland Cavaliers,1,240,38,83,0.458,5,22,0.227,33,61,0.541,21,25,0.84,9,41,50,19,3,17,25,102
48,2017-10-20,Sacramento Kings,1,240,42,88,0.477,8,23,0.348,34,65,0.523,8,10,0.8,9,33,42,19,5,17,20,100
49,2017-10-20,Chicago Bulls,1,240,37,89,0.416,10,32,0.313,27,57,0.474,16,19,0.842,10,29,39,22,7,19,23,100
50,2017-10-20,Boston Celtics,2,480,75,179,0.419,19,60,0.317,56,119,0.471,30,46,0.652,20,69,89,47,23,22,51,199
51,2017-10-20,Minnesota Timberwolves,1,240,37,85,0.435,8,19,0.421,29,66,0.439,17,23,0.739,11,31,42,23,7,13,16,99
52,2017-10-20,Denver Nuggets,1,240,36,77,0.468,13,27,0.481,23,50,0.46,11,12,0.917,7,31,38,21,4,20,18,96
53,2017-10-20,Los Angeles Lakers,1,240,37,91,0.407,4,16,0.25,33,75,0.44,14,23,0.609,12,40,52,21,8,19,15,92
54,2017-10-20,New Orleans Pelicans,1,240,30,79,0.38,7,25,0.28,23,54,0.426,24,29,0.828,16,35,51,15,4,17,31,91
55,2017-10-20,Charlotte Hornets,1,240,29,73,0.397,9,30,0.3,20,43,0.465,23,29,0.793,3,44,47,16,4,17,15,90
56,2017-10-20,New York Knicks,1,240,32,79,0.405,7,24,0.292,25,55,0.455,13,19,0.684,11,30,41,19,8,25,23,84
57,2017-10-20,Phoenix Suns,1,240,28,89,0.315,7,27,0.259,21,62,0.339,13,18,0.722,10,23,33,10,9,16,22,76
58,2017-10-21,Brooklyn Nets,2,480,91,186,0.489,21,57,0.368,70,129,0.543,54,67,0.806,26,65,91,44,20,38,42,257
59,2017-10-21,Golden State Warriors,2,480,90,171,0.526,34,70,0.486,56,101,0.554,35,41,0.854,16,74,90,63,11,35,48,249
60,2017-10-21,Portland Trail Blazers,2,480,90,185,0.486,23,43,0.535,67,142,0.472,35,45,0.778,26,82,108,41,13,25,46,238
61,2017-10-21,Orlando Magic,2,480,88,179,0.492,26,54,0.481,62,125,0.496,35,44,0.795,20,70,90,52,17,36,45,237
62,2017-10-21,Indiana Pacers,2,480,88,180,0.489,13,52,0.25,75,128,0.586,47,65,0.723,20,66,86,44,13,26,42,236
63,2017-10-21,Washington Wizards,2,480,82,172,0.477,12,39,0.308,70,133,0.526,59,73,0.808,23,66,89,46,20,25,38,235
64,2017-10-21,Toronto Raptors,1,240,39,83,0.47,13,29,0.448,26,54,0.481,26,28,0.929,13,36,49,26,10,17,19,117
65,2017-10-21,Houston Rockets,2,480,80,180,0.444,27,86,0.314,53,94,0.564,40,48,0.833,22,65,87,47,16,26,30,227
66,2017-10-21,Los Angeles Lakers,2,480,85,184,0.462,16,42,0.381,69,142,0.486,38,56,0.679,17,77,94,43,16,37,46,224
67,2017-10-21,Cleveland Cavaliers,2,480,82,164,0.5,16,48,0.333,66,116,0.569,38,42,0.905,18,76,94,44,11,34,35,218
68,2017-10-21,Miami Heat,1,240,44,101,0.436,8,30,0.267,36,71,0.507,13,17,0.765,11,33,44,27,6,13,20,109
69,2017-10-21,Los Angeles Clippers,1,240,42,107,0.393,12,33,0.364,30,74,0.405,12,13,0.923,17,42,59,23,12,14,20,108
70,2017-10-21,San Antonio Spurs,1,240,41,89,0.461,8,21,0.381,33,68,0.485,17,19,0.895,12,38,50,22,8,11,18,107
71,2017-10-21,Detroit Pistons,2,480,84,183,0.459,19,49,0.388,65,134,0.485,26,32,0.813,19,61,80,43,26,27,53,213
72,2017-10-21,New Orleans Pelicans,2,480,75,177,0.424,23,61,0.377,52,116,0.448,38,51,0.745,32,70,102,41,12,34,50,211
73,2017-10-21,Oklahoma City Thunder,1,240,39,90,0.433,11,38,0.289,28,52,0.538,16,22,0.727,13,28,41,26,14,18,22,105
74,2017-10-21,Atlanta Hawks,2,480,84,189,0.444,16,48,0.333,68,141,0.482,24,29,0.828,20,68,88,39,22,26,47,208
75,2017-10-21,Philadelphia 76ers,2,480,78,185,0.422,25,67,0.373,53,118,0.449,26,35,0.743,25,70,95,45,13,33,58,207
76,2017-10-21,Phoenix Suns,2,480,73,181,0.403,21,56,0.375,52,125,0.416,39,56,0.696,20,63,83,27,17,35,47,206
77,2017-10-21,Memphis Grizzlies,1,240,39,92,0.424,9,29,0.31,30,63,0.476,16,28,0.571,15,30,45,19,9,11,29,103
78,2017-10-21,Milwaukee Bucks,2,480,76,158,0.481,18,56,0.321,58,102,0.569,35,42,0.833,14,61,75,42,15,29,39,205
79,2017-10-21,Utah Jazz,2,480,78,158,0.494,18,46,0.391,60,112,0.536,29,33,0.879,13,61,74,51,19,34,39,203
80,2017-10-21,Boston Celtics,3,720,110,263,0.418,29,89,0.326,81,174,0.466,52,78,0.667,34,110,144,63,27,41,75,301
81,2017-10-21,Chicago Bulls,1,240,37,89,0.416,10,32,0.313,27,57,0.474,16,19,0.842,10,29,39,22,7,19,23,100
82,2017-10-21,Charlotte Hornets,2,480,66,159,0.415,20,66,0.303,46,93,0.495,47,59,0.797,15,89,104,33,9,38,33,199
83,2017-10-21,Minnesota Timberwolves,2,480,73,166,0.44,15,41,0.366,58,125,0.464,38,49,0.776,21,65,86,40,18,28,33,199
84,2017-10-21,Dallas Mavericks,2,480,69,161,0.429,28,78,0.359,41,83,0.494,33,42,0.786,16,61,77,46,13,27,32,199
85,2017-10-21,Sacramento Kings,2,480,79,175,0.451,18,46,0.391,61,129,0.473,17,23,0.739,25,74,99,39,13,31,38,193
86,2017-10-21,Denver Nuggets,1,240,36,77,0.468,13,27,0.481,23,50,0.46,11,12,0.917,7,31,38,21,4,20,18,96
87,2017-10-21,New York Knicks,1,240,32,79,0.405,7,24,0.292,25,55,0.455,13,19,0.684,11,30,41,19,8,25,23,84
88,2017-10-22,Brooklyn Nets,2,480,91,186,0.489,21,57,0.368,70,129,0.543,54,67,0.806,26,65,91,44,20,38,42,257
89,2017-10-22,Toronto Raptors,2,480,81,172,0.471,26,73,0.356,55,99,0.556,57,65,0.877,21,79,100,49,15,30,48,245
90,2017-10-22,Los Angeles Clippers,2,480,90,195,0.462,24,59,0.407,66,136,0.485,34,43,0.791,27,84,111,49,23,26,52,238
91,2017-10-22,Washington Wizards,2,480,82,172,0.477,12,39,0.308,70,133,0.526,59,73,0.808,23,66,89,46,20,25,38,235
92,2017-10-22,Orlando Magic,3,720,128,269,0.476,43,89,0.483,85,180,0.472,52,64,0.813,32,108,140,80,24,48,73,351
93,2017-10-22,Golden State Warriors,3,720,123,255,0.482,46,108,0.426,77,147,0.524,58,68,0.853,28,108,136,83,21,52,76,350
94,2017-10-22,Portland Trail Blazers,3,720,124,266,0.466,34,71,0.479,90,195,0.462,66,80,0.825,39,111,150,59,23,41,68,348
95,2017-10-22,Indiana Pacers,3,720,131,276,0.475,20,71,0.282,111,205,0.541,62,86,0.721,33,98,131,62,22,36,60,344
96,2017-10-22,Los Angeles Lakers,2,480,85,184,0.462,16,42,0.381,69,142,0.486,38,56,0.679,17,77,94,43,16,37,46,224
97,2017-10-22,Houston Rockets,3,720,119,262,0.454,38,133,0.286,81,129,0.628,58,70,0.829,30,111,141,64,28,39,54,334
98,2017-10-22,Miami Heat,2,480,89,188,0.473,22,64,0.344,67,124,0.54,21,31,0.677,17,72,89,51,12,27,39,221
99,2017-10-22,Detroit Pistons,3,720,128,274,0.467,28,79,0.354,100,195,0.513,40,47,0.851,34,89,123,64,31,39,78,324
100,2017-10-22,Memphis Grizzlies,2,480,75,169,0.444,19,56,0.339,56,113,0.496,45,65,0.692,21,64,85,39,17,25,54,214
101,2017-10-22,Milwaukee Bucks,3,720,118,238,0.496,25,74,0.338,93,164,0.567,57,72,0.792,21,89,110,64,24,43,62,318
102,2017-10-22,New Orleans Pelicans,2,480,75,177,0.424,23,61,0.377,52,116,0.448,38,51,0.745,32,70,102,41,12,34,50,211
103,2017-10-22,Atlanta Hawks,2,480,84,189,0.444,16,48,0.333,68,141,0.482,24,29,0.828,20,68,88,39,22,26,47,208
104,2017-10-22,Cleveland Cavaliers,3,720,115,250,0.46,23,73,0.315,92,177,0.52,58,69,0.841,29,109,138,59,15,50,49,311
105,2017-10-22,Boston Celtics,3,720,110,263,0.418,29,89,0.326,81,174,0.466,52,78,0.667,34,110,144,63,27,41,75,301
106,2017-10-22,Philadelphia 76ers,3,720,110,267,0.412,33,91,0.363,77,176,0.438,48,71,0.676,33,103,136,63,18,53,84,301
107,2017-10-22,Utah Jazz,3,720,116,235,0.494,27,75,0.36,89,160,0.556,40,47,0.851,20,95,115,73,30,52,60,299
108,2017-10-22,Charlotte Hornets,2,480,66,159,0.415,20,66,0.303,46,93,0.495,47,59,0.797,15,89,104,33,9,38,33,199
109,2017-10-22,Minnesota Timberwolves,2,480,73,166,0.44,15,41,0.366,58,125,0.464,38,49,0.776,21,65,86,40,18,28,33,199
110,2017-10-22,Phoenix Suns,3,720,100,252,0.397,27,80,0.338,73,172,0.424,67,94,0.713,24,95,119,46,25,54,74,294
111,2017-10-22,San Antonio Spurs,2,480,79,182,0.434,9,33,0.273,70,149,0.47,27,35,0.771,26,76,102,47,16,22,32,194
112,2017-10-22,Dallas Mavericks,3,720,100,245,0.408,41,109,0.376,59,136,0.434,49,63,0.778,24,94,118,65,19,41,51,290
113,2017-10-22,Denver Nuggets,2,480,73,162,0.451,23,57,0.404,50,105,0.476,23,32,0.719,25,71,96,46,11,36,37,192
114,2017-10-22,Oklahoma City Thunder,2,480,71,168,0.423,22,71,0.31,49,97,0.505,28,41,0.683,21,58,79,41,28,35,38,192
115,2017-10-22,New York Knicks,2,480,69,160,0.431,15,54,0.278,54,106,0.509,38,50,0.76,23,57,80,39,14,37,44,191
116,2017-10-22,Sacramento Kings,3,720,110,260,0.423,26,68,0.382,84,192,0.438,26,36,0.722,37,101,138,54,19,44,59,272
117,2017-10-22,Chicago Bulls,2,480,68,171,0.398,18,60,0.3,50,111,0.45,23,28,0.821,18,69,87,40,10,38,38,177
118,2017-10-23,Brooklyn Nets,3,720,132,273,0.484,32,84,0.381,100,189,0.529,77,101,0.762,39,103,142,71,32,56,69,373
119,2017-10-23,Toronto Raptors,2,480,81,172,0.471,26,73,0.356,55,99,0.556,57,65,0.877,21,79,100,49,15,30,48,245
120,2017-10-23,Los Angeles Clippers,2,480,90,195,0.462,24,59,0.407,66,136,0.485,34,43,0.791,27,84,111,49,23,26,52,238
121,2017-10-23,Washington Wizards,2,480,82,172,0.477,12,39,0.308,70,133,0.526,59,73,0.808,23,66,89,46,20,25,38,235
122,2017-10-23,Orlando Magic,3,720,128,269,0.476,43,89,0.483,85,180,0.472,52,64,0.813,32,108,140,80,24,48,73,351
123,2017-10-23,Golden State Warriors,3,720,123,255,0.482,46,108,0.426,77,147,0.524,58,68,0.853,28,108,136,83,21,52,76,350
124,2017-10-23,Portland Trail Blazers,3,720,124,266,0.466,34,71,0.479,90,195,0.462,66,80,0.825,39,111,150,59,23,41,68,348
125,2017-10-23,Indiana Pacers,3,720,131,276,0.475,20,71,0.282,111,205,0.541,62,86,0.721,33,98,131,62,22,36,60,344
126,2017-10-23,Los Angeles Lakers,3,720,129,274,0.471,25,69,0.362,104,205,0.507,53,76,0.697,26,106,132,70,23,54,70,336
127,2017-10-23,Houston Rockets,3,720,119,262,0.454,38,133,0.286,81,129,0.628,58,70,0.829,30,111,141,64,28,39,54,334
128,2017-10-23,Miami Heat,2,480,89,188,0.473,22,64,0.344,67,124,0.54,21,31,0.677,17,72,89,51,12,27,39,221
129,2017-10-23,New Orleans Pelicans,3,720,122,260,0.469,33,93,0.355,89,167,0.533,53,72,0.736,38,106,144,67,26,52,70,330
130,2017-10-23,Detroit Pistons,3,720,128,274,0.467,28,79,0.354,100,195,0.513,40,47,0.851,34,89,123,64,31,39,78,324
131,2017-10-23,Memphis Grizzlies,2,480,75,169,0.444,19,56,0.339,56,113,0.496,45,65,0.692,21,64,85,39,17,25,54,214
132,2017-10-23,Milwaukee Bucks,3,720,118,238,0.496,25,74,0.338,93,164,0.567,57,72,0.792,21,89,110,64,24,43,62,318
133,2017-10-23,Minnesota Timberwolves,3,720,116,252,0.46,25,66,0.379,91,186,0.489,57,72,0.792,31,100,131,65,23,45,50,314
134,2017-10-23,Atlanta Hawks,3,720,116,283,0.41,23,75,0.307,93,208,0.447,57,65,0.877,36,100,136,60,28,42,72,312
135,2017-10-23,Cleveland Cavaliers,3,720,115,250,0.46,23,73,0.315,92,177,0.52,58,69,0.841,29,109,138,59,15,50,49,311
136,2017-10-23,Oklahoma City Thunder,3,720,117,264,0.443,33,102,0.324,84,162,0.519,38,57,0.667,30,85,115,67,37,46,60,305
137,2017-10-23,Boston Celtics,3,720,110,263,0.418,29,89,0.326,81,174,0.466,52,78,0.667,34,110,144,63,27,41,75,301
138,2017-10-23,Philadelphia 76ers,3,720,110,267,0.412,33,91,0.363,77,176,0.438,48,71,0.676,33,103,136,63,18,53,84,301
139,2017-10-23,Utah Jazz,3,720,116,235,0.494,27,75,0.36,89,160,0.556,40,47,0.851,20,95,115,73,30,52,60,299
140,2017-10-23,Charlotte Hornets,2,480,66,159,0.415,20,66,0.303,46,93,0.495,47,59,0.797,15,89,104,33,9,38,33,199
141,2017-10-23,Phoenix Suns,3,720,100,252,0.397,27,80,0.338,73,172,0.424,67,94,0.713,24,95,119,46,25,54,74,294
142,2017-10-23,San Antonio Spurs,2,480,79,182,0.434,9,33,0.273,70,149,0.47,27,35,0.771,26,76,102,47,16,22,32,194
143,2017-10-23,Dallas Mavericks,3,720,100,245,0.408,41,109,0.376,59,136,0.434,49,63,0.778,24,94,118,65,19,41,51,290
144,2017-10-23,Denver Nuggets,2,480,73,162,0.451,23,57,0.404,50,105,0.476,23,32,0.719,25,71,96,46,11,36,37,192
145,2017-10-23,New York Knicks,2,480,69,160,0.431,15,54,0.278,54,106,0.509,38,50,0.76,23,57,80,39,14,37,44,191
146,2017-10-23,Sacramento Kings,3,720,110,260,0.423,26,68,0.382,84,192,0.438,26,36,0.722,37,101,138,54,19,44,59,272
147,2017-10-23,Chicago Bulls,2,480,68,171,0.398,18,60,0.3,50,111,0.45,23,28,0.821,18,69,87,40,10,38,38,177
148,2017-10-24,Brooklyn Nets,3,720,132,273,0.484,32,84,0.381,100,189,0.529,77,101,0.762,39,103,142,71,32,56,69,373
149,2017-10-24,Golden State Warriors,4,960,171,341,0.501,61,147,0.415,110,194,0.567,80,94,0.851,38,148,186,116,27,68,99,483
150,2017-10-24,Los Angeles Clippers,2,480,90,195,0.462,24,59,0.407,66,136,0.485,34,43,0.791,27,84,111,49,23,26,52,238
151,2017-10-24,Orlando Magic,3,720,128,269,0.476,43,89,0.483,85,180,0.472,52,64,0.813,32,108,140,80,24,48,73,351
152,2017-10-24,Portland Trail Blazers,3,720,124,266,0.466,34,71,0.479,90,195,0.462,66,80,0.825,39,111,150,59,23,41,68,348
153,2017-10-24,Washington Wizards,3,720,119,256,0.465,21,69,0.304,98,187,0.524,85,101,0.842,33,94,127,70,33,40,62,344
154,2017-10-24,Indiana Pacers,3,720,131,276,0.475,20,71,0.282,111,205,0.541,62,86,0.721,33,98,131,62,22,36,60,344
155,2017-10-24,Toronto Raptors,3,720,115,252,0.456,36,110,0.327,79,142,0.556,76,89,0.854,26,108,134,66,26,44,78,342
156,2017-10-24,Los Angeles Lakers,3,720,129,274,0.471,25,69,0.362,104,205,0.507,53,76,0.697,26,106,132,70,23,54,70,336
157,2017-10-24,New Orleans Pelicans,3,720,122,260,0.469,33,93,0.355,89,167,0.533,53,72,0.736,38,106,144,67,26,52,70,330
158,2017-10-24,Miami Heat,3,720,128,273,0.469,36,101,0.356,92,172,0.535,33,49,0.673,27,103,130,72,24,46,58,325
159,2017-10-24,Houston Rockets,4,960,151,339,0.445,47,171,0.275,104,168,0.619,75,93,0.806,39,141,180,89,33,55,85,424
160,2017-10-24,Milwaukee Bucks,4,960,158,323,0.489,34,100,0.34,124,223,0.556,71,88,0.807,26,126,152,88,32,56,89,421
161,2017-10-24,Minnesota Timberwolves,3,720,116,252,0.46,25,66,0.379,91,186,0.489,57,72,0.792,31,100,131,65,23,45,50,314
162,2017-10-24,Memphis Grizzlies,3,720,104,237,0.439,25,75,0.333,79,162,0.488,79,102,0.775,24,99,123,55,22,37,75,312
163,2017-10-24,Cleveland Cavaliers,3,720,115,250,0.46,23,73,0.315,92,177,0.52,58,69,0.841,29,109,138,59,15,50,49,311
164,2017-10-24,Phoenix Suns,4,960,142,329,0.432,37,110,0.336,105,219,0.479,90,121,0.744,30,134,164,66,31,74,99,411
165,2017-10-24,Detroit Pistons,4,960,161,359,0.448,34,109,0.312,127,250,0.508,54,66,0.818,43,119,162,78,36,53,99,410
166,2017-10-24,Oklahoma City Thunder,3,720,117,264,0.443,33,102,0.324,84,162,0.519,38,57,0.667,30,85,115,67,37,46,60,305
167,2017-10-24,Atlanta Hawks,4,960,152,359,0.423,30,92,0.326,122,267,0.457,71,83,0.855,42,135,177,74,37,62,89,405
168,2017-10-24,Boston Celtics,3,720,110,263,0.418,29,89,0.326,81,174,0.466,52,78,0.667,34,110,144,63,27,41,75,301
169,2017-10-24,Utah Jazz,3,720,116,235,0.494,27,75,0.36,89,160,0.556,40,47,0.851,20,95,115,73,30,52,60,299
170,2017-10-24,Philadelphia 76ers,4,960,145,342,0.424,42,115,0.365,103,227,0.454,66,95,0.695,41,144,185,88,29,74,108,398
171,2017-10-24,Denver Nuggets,3,720,112,242,0.463,31,80,0.388,81,162,0.5,41,55,0.745,34,106,140,73,16,59,59,296
172,2017-10-24,San Antonio Spurs,3,720,119,272,0.438,14,53,0.264,105,219,0.479,43,58,0.741,44,113,157,66,20,42,54,295
173,2017-10-24,Dallas Mavericks,4,960,138,341,0.405,50,138,0.362,88,203,0.433,67,93,0.72,38,122,160,86,30,53,71,393
174,2017-10-24,Charlotte Hornets,3,720,99,237,0.418,27,92,0.293,72,145,0.497,68,95,0.716,25,127,152,50,12,52,54,293
175,2017-10-24,Sacramento Kings,4,960,153,359,0.426,35,90,0.389,118,269,0.439,46,65,0.708,50,125,175,73,32,53,84,387
176,2017-10-24,New York Knicks,2,480,69,160,0.431,15,54,0.278,54,106,0.509,38,50,0.76,23,57,80,39,14,37,44,191
177,2017-10-24,Chicago Bulls,2,480,68,171,0.398,18,60,0.3,50,111,0.45,23,28,0.821,18,69,87,40,10,38,38,177
178,2017-10-25,Brooklyn Nets,4,960,172,369,0.466,43,119,0.361,129,250,0.516,107,135,0.793,53,138,191,92,40,71,96,494
179,2017-10-25,Golden State Warriors,4,960,171,341,0.501,61,147,0.415,110,194,0.567,80,94,0.851,38,148,186,116,27,68,99,483
180,2017-10-25,Orlando Magic,4,960,169,352,0.48,51,112,0.455,118,240,0.492,87,104,0.837,38,146,184,100,32,59,96,476
181,2017-10-25,Indiana Pacers,4,960,187,360,0.519,30,93,0.323,157,267,0.588,70,97,0.722,41,132,173,93,30,53,81,474
182,2017-10-25,Washington Wizards,3,720,119,256,0.465,21,69,0.304,98,187,0.524,85,101,0.842,33,94,127,70,33,40,62,344
183,2017-10-25,Toronto Raptors,3,720,115,252,0.456,36,110,0.327,79,142,0.556,76,89,0.854,26,108,134,66,26,44,78,342
184,2017-10-25,Los Angeles Clippers,3,720,129,278,0.464,34,88,0.386,95,190,0.5,48,64,0.75,38,117,155,70,35,39,68,340
185,2017-10-25,Portland Trail Blazers,4,960,157,354,0.444,44,100,0.44,113,254,0.445,93,113,0.823,57,156,213,76,30,59,90,451
186,2017-10-25,Los Angeles Lakers,3,720,129,274,0.471,25,69,0.362,104,205,0.507,53,76,0.697,26,106,132,70,23,54,70,336
187,2017-10-25,Miami Heat,3,720,128,273,0.469,36,101,0.356,92,172,0.535,33,49,0.673,27,103,130,72,24,46,58,325
188,2017-10-25,Cleveland Cavaliers,4,960,158,333,0.474,39,111,0.351,119,222,0.536,75,91,0.824,37,140,177,87,20,59,63,430
189,2017-10-25,Houston Rockets,4,960,151,339,0.445,47,171,0.275,104,168,0.619,75,93,0.806,39,141,180,89,33,55,85,424
190,2017-10-25,New Orleans Pelicans,4,960,152,336,0.452,42,123,0.341,110,213,0.516,77,104,0.74,42,144,186,84,31,69,96,423
191,2017-10-25,Milwaukee Bucks,4,960,158,323,0.489,34,100,0.34,124,223,0.556,71,88,0.807,26,126,152,88,32,56,89,421
192,2017-10-25,Minnesota Timberwolves,4,960,158,338,0.467,34,90,0.378,124,248,0.5,71,94,0.755,40,118,158,92,32,59,64,421
193,2017-10-25,Memphis Grizzlies,3,720,104,237,0.439,25,75,0.333,79,162,0.488,79,102,0.775,24,99,123,55,22,37,75,312
194,2017-10-25,Phoenix Suns,4,960,142,329,0.432,37,110,0.336,105,219,0.479,90,121,0.744,30,134,164,66,31,74,99,411
195,2017-10-25,Boston Celtics,4,960,147,338,0.435,43,118,0.364,104,220,0.473,74,105,0.705,39,146,185,89,38,53,99,411
196,2017-10-25,Detroit Pistons,4,960,161,359,0.448,34,109,0.312,127,250,0.508,54,66,0.818,43,119,162,78,36,53,99,410
197,2017-10-25,Oklahoma City Thunder,3,720,117,264,0.443,33,102,0.324,84,162,0.519,38,57,0.667,30,85,115,67,37,46,60,305
198,2017-10-25,Atlanta Hawks,4,960,152,359,0.423,30,92,0.326,122,267,0.457,71,83,0.855,42,135,177,74,37,62,89,405
199,2017-10-25,Philadelphia 76ers,4,960,145,342,0.424,42,115,0.365,103,227,0.454,66,95,0.695,41,144,185,88,29,74,108,398
200,2017-10-25,Denver Nuggets,3,720,112,242,0.463,31,80,0.388,81,162,0.5,41,55,0.745,34,106,140,73,16,59,59,296
201,2017-10-25,San Antonio Spurs,3,720,119,272,0.438,14,53,0.264,105,219,0.479,43,58,0.741,44,113,157,66,20,42,54,295
202,2017-10-25,Dallas Mavericks,4,960,138,341,0.405,50,138,0.362,88,203,0.433,67,93,0.72,38,122,160,86,30,53,71,393
203,2017-10-25,Charlotte Hornets,3,720,99,237,0.418,27,92,0.293,72,145,0.497,68,95,0.716,25,127,152,50,12,52,54,293
204,2017-10-25,Sacramento Kings,4,960,153,359,0.426,35,90,0.389,118,269,0.439,46,65,0.708,50,125,175,73,32,53,84,387
205,2017-10-25,Chicago Bulls,3,720,110,259,0.425,35,93,0.376,75,166,0.452,34,41,0.829,26,100,126,68,13,47,58,289
206,2017-10-25,Utah Jazz,4,960,150,314,0.478,34,103,0.33,116,211,0.55,49,58,0.845,28,128,156,93,37,70,83,383
207,2017-10-25,New York Knicks,3,720,105,245,0.429,16,66,0.242,89,179,0.497,54,75,0.72,34,89,123,59,22,51,61,280
208,2017-10-26,Brooklyn Nets,5,1200,212,462,0.459,60,165,0.364,152,297,0.512,122,156,0.782,63,166,229,114,51,83,118,606
209,2017-10-26,Golden State Warriors,5,1200,214,418,0.512,73,173,0.422,141,245,0.576,99,116,0.853,44,179,223,148,37,85,114,600
210,2017-10-26,Orlando Magic,4,960,169,352,0.48,51,112,0.455,118,240,0.492,87,104,0.837,38,146,184,100,32,59,96,476
211,2017-10-26,Indiana Pacers,5,1200,215,443,0.485,40,122,0.328,175,321,0.545,100,132,0.758,55,159,214,106,43,72,104,570
212,2017-10-26,Toronto Raptors,4,960,158,346,0.457,44,144,0.306,114,202,0.564,94,108,0.87,43,133,176,96,36,60,94,454
213,2017-10-26,Los Angeles Clippers,3,720,129,278,0.464,34,88,0.386,95,190,0.5,48,64,0.75,38,117,155,70,35,39,68,340
214,2017-10-26,Portland Trail Blazers,4,960,157,354,0.444,44,100,0.44,113,254,0.445,93,113,0.823,57,156,213,76,30,59,90,451
215,2017-10-26,Washington Wizards,4,985,158,351,0.45,27,95,0.284,131,256,0.512,100,124,0.806,40,132,172,90,44,53,81,443
216,2017-10-26,Los Angeles Lakers,4,985,170,366,0.464,32,99,0.323,138,267,0.517,66,92,0.717,32,153,185,97,32,75,96,438
217,2017-10-26,Cleveland Cavaliers,5,1200,197,414,0.476,51,146,0.349,146,268,0.545,92,117,0.786,46,178,224,108,25,80,80,537
218,2017-10-26,Detroit Pistons,5,1200,209,451,0.463,49,143,0.343,160,308,0.519,65,83,0.783,55,154,209,110,43,67,121,532
219,2017-10-26,Miami Heat,4,960,165,353,0.467,45,127,0.354,120,226,0.531,50,67,0.746,31,131,162,91,30,55,83,425
220,2017-10-26,Houston Rockets,5,1200,187,414,0.452,59,210,0.281,128,204,0.627,96,117,0.821,46,174,220,111,44,74,98,529
221,2017-10-26,New Orleans Pelicans,4,960,152,336,0.452,42,123,0.341,110,213,0.516,77,104,0.74,42,144,186,84,31,69,96,423
222,2017-10-26,Milwaukee Bucks,4,960,158,323,0.489,34,100,0.34,124,223,0.556,71,88,0.807,26,126,152,88,32,56,89,421
223,2017-10-26,Oklahoma City Thunder,4,960,160,353,0.453,43,129,0.333,117,224,0.522,56,83,0.675,46,118,164,93,45,66,87,419
224,2017-10-26,Minnesota Timberwolves,5,1200,195,423,0.461,43,115,0.374,152,308,0.494,89,115,0.774,47,148,195,111,37,73,83,522
225,2017-10-26,San Antonio Spurs,4,960,161,348,0.463,24,70,0.343,137,278,0.493,66,88,0.75,52,149,201,84,26,55,74,412
226,2017-10-26,Boston Celtics,4,960,147,338,0.435,43,118,0.364,104,220,0.473,74,105,0.705,39,146,185,89,38,53,99,411
227,2017-10-26,Phoenix Suns,5,1200,184,425,0.433,43,129,0.333,141,296,0.476,97,130,0.746,46,173,219,84,39,90,124,508
228,2017-10-26,Memphis Grizzlies,4,960,137,309,0.443,37,106,0.349,100,203,0.493,95,126,0.754,30,129,159,69,29,54,97,406
229,2017-10-26,Atlanta Hawks,4,960,152,359,0.423,30,92,0.326,122,267,0.457,71,83,0.855,42,135,177,74,37,62,89,405
230,2017-10-26,Charlotte Hornets,4,960,137,318,0.431,40,123,0.325,97,195,0.497,89,121,0.736,35,167,202,67,17,66,70,403
231,2017-10-26,Philadelphia 76ers,5,1200,188,439,0.428,54,151,0.358,134,288,0.465,72,105,0.686,53,175,228,117,43,88,127,502
232,2017-10-26,Dallas Mavericks,5,1200,174,415,0.419,61,164,0.372,113,251,0.45,87,122,0.713,42,153,195,106,36,64,91,496
233,2017-10-26,Denver Nuggets,4,960,150,342,0.439,39,111,0.351,111,231,0.481,50,70,0.714,52,139,191,91,22,72,82,389
234,2017-10-26,Sacramento Kings,4,960,153,359,0.426,35,90,0.389,118,269,0.439,46,65,0.708,50,125,175,73,32,53,84,387
235,2017-10-26,Chicago Bulls,3,720,110,259,0.425,35,93,0.376,75,166,0.452,34,41,0.829,26,100,126,68,13,47,58,289
236,2017-10-26,Utah Jazz,5,1200,182,391,0.465,40,128,0.313,142,263,0.54,67,83,0.807,35,165,200,113,45,93,102,471
237,2017-10-26,New York Knicks,3,720,105,245,0.429,16,66,0.242,89,179,0.497,54,75,0.72,34,89,123,59,22,51,61,280
238,2017-10-27,Brooklyn Nets,5,1200,212,462,0.459,60,165,0.364,152,297,0.512,122,156,0.782,63,166,229,114,51,83,118,606
239,2017-10-27,Golden State Warriors,5,1200,214,418,0.512,73,173,0.422,141,245,0.576,99,116,0.853,44,179,223,148,37,85,114,600
240,2017-10-27,Orlando Magic,4,960,169,352,0.48,51,112,0.455,118,240,0.492,87,104,0.837,38,146,184,100,32,59,96,476
241,2017-10-27,Indiana Pacers,5,1200,215,443,0.485,40,122,0.328,175,321,0.545,100,132,0.758,55,159,214,106,43,72,104,570
242,2017-10-27,Toronto Raptors,4,960,158,346,0.457,44,144,0.306,114,202,0.564,94,108,0.87,43,133,176,96,36,60,94,454
243,2017-10-27,Los Angeles Clippers,4,960,165,355,0.465,43,116,0.371,122,239,0.51,71,100,0.71,52,149,201,81,39,50,87,444
244,2017-10-27,Portland Trail Blazers,5,1200,192,443,0.433,58,131,0.443,134,312,0.429,112,135,0.83,73,184,257,95,35,68,116,554
245,2017-10-27,Washington Wizards,4,985,158,351,0.45,27,95,0.284,131,256,0.512,100,124,0.806,40,132,172,90,44,53,81,443
246,2017-10-27,Los Angeles Lakers,4,985,170,366,0.464,32,99,0.323,138,267,0.517,66,92,0.717,32,153,185,97,32,75,96,438
247,2017-10-27,Cleveland Cavaliers,5,1200,197,414,0.476,51,146,0.349,146,268,0.545,92,117,0.786,46,178,224,108,25,80,80,537
248,2017-10-27,New Orleans Pelicans,5,1200,194,422,0.46,55,155,0.355,139,267,0.521,94,127,0.74,52,181,233,106,36,84,120,537
249,2017-10-27,Detroit Pistons,5,1200,209,451,0.463,49,143,0.343,160,308,0.519,65,83,0.783,55,154,209,110,43,67,121,532
250,2017-10-27,Miami Heat,4,960,165,353,0.467,45,127,0.354,120,226,0.531,50,67,0.746,31,131,162,91,30,55,83,425
251,2017-10-27,Houston Rockets,5,1200,187,414,0.452,59,210,0.281,128,204,0.627,96,117,0.821,46,174,220,111,44,74,98,529
252,2017-10-27,Oklahoma City Thunder,4,960,160,353,0.453,43,129,0.333,117,224,0.522,56,83,0.675,46,118,164,93,45,66,87,419
253,2017-10-27,Minnesota Timberwolves,5,1200,195,423,0.461,43,115,0.374,152,308,0.494,89,115,0.774,47,148,195,111,37,73,83,522
254,2017-10-27,San Antonio Spurs,4,960,161,348,0.463,24,70,0.343,137,278,0.493,66,88,0.75,52,149,201,84,26,55,74,412
255,2017-10-27,Milwaukee Bucks,5,1200,193,400,0.483,45,125,0.36,148,275,0.538,79,102,0.775,28,161,189,110,38,72,109,510
256,2017-10-27,Phoenix Suns,5,1200,184,425,0.433,43,129,0.333,141,296,0.476,97,130,0.746,46,173,219,84,39,90,124,508
257,2017-10-27,Boston Celtics,5,1200,180,416,0.433,54,148,0.365,126,268,0.47,93,127,0.732,45,185,230,110,45,68,113,507
258,2017-10-27,Charlotte Hornets,4,960,137,318,0.431,40,123,0.325,97,195,0.497,89,121,0.736,35,167,202,67,17,66,70,403
259,2017-10-27,Memphis Grizzlies,5,1200,167,382,0.437,47,140,0.336,120,242,0.496,121,156,0.776,39,166,205,87,36,72,120,502
260,2017-10-27,Philadelphia 76ers,5,1200,188,439,0.428,54,151,0.358,134,288,0.465,72,105,0.686,53,175,228,117,43,88,127,502
261,2017-10-27,Sacramento Kings,5,1200,191,440,0.434,42,110,0.382,149,330,0.452,69,90,0.767,55,154,209,98,39,65,101,493
262,2017-10-27,Atlanta Hawks,5,1200,184,440,0.418,41,120,0.342,143,320,0.447,82,96,0.854,49,168,217,96,47,72,112,491
263,2017-10-27,Dallas Mavericks,6,1440,206,509,0.405,71,198,0.359,135,311,0.434,104,142,0.732,60,188,248,126,46,78,113,587
264,2017-10-27,Denver Nuggets,4,960,150,342,0.439,39,111,0.351,111,231,0.481,50,70,0.714,52,139,191,91,22,72,82,389
265,2017-10-27,Chicago Bulls,4,960,141,345,0.409,42,125,0.336,99,220,0.45,56,70,0.8,44,144,188,88,18,60,73,380
266,2017-10-27,Utah Jazz,5,1200,182,391,0.465,40,128,0.313,142,263,0.54,67,83,0.807,35,165,200,113,45,93,102,471
267,2017-10-27,New York Knicks,3,720,105,245,0.429,16,66,0.242,89,179,0.497,54,75,0.72,34,89,123,59,22,51,61,280
268,2017-10-28,Golden State Warriors,6,1440,260,513,0.507,83,211,0.393,177,302,0.586,117,136,0.86,59,217,276,181,44,102,134,720
269,2017-10-28,Orlando Magic,5,1200,217,436,0.498,62,135,0.459,155,301,0.515,94,118,0.797,44,185,229,122,41,76,120,590
270,2017-10-28,Brooklyn Nets,6,1440,242,537,0.451,71,195,0.364,171,342,0.5,137,177,0.774,68,196,264,132,56,99,138,692
271,2017-10-28,Indiana Pacers,5,1200,215,443,0.485,40,122,0.328,175,321,0.545,100,132,0.758,55,159,214,106,43,72,104,570
272,2017-10-28,Washington Wizards,5,1225,201,448,0.449,42,128,0.328,159,320,0.497,116,146,0.795,52,161,213,120,51,67,102,560
273,2017-10-28,Los Angeles Clippers,4,960,165,355,0.465,43,116,0.371,122,239,0.51,71,100,0.71,52,149,201,81,39,50,87,444
274,2017-10-28,Toronto Raptors,5,1200,198,439,0.451,51,173,0.295,147,266,0.553,108,128,0.844,52,164,216,123,48,72,118,555
275,2017-10-28,Portland Trail Blazers,5,1200,192,443,0.433,58,131,0.443,134,312,0.429,112,135,0.83,73,184,257,95,35,68,116,554
276,2017-10-28,Cleveland Cavaliers,5,1200,197,414,0.476,51,146,0.349,146,268,0.545,92,117,0.786,46,178,224,108,25,80,80,537
277,2017-10-28,New Orleans Pelicans,5,1200,194,422,0.46,55,155,0.355,139,267,0.521,94,127,0.74,52,181,233,106,36,84,120,537
278,2017-10-28,Oklahoma City Thunder,5,1200,203,439,0.462,51,157,0.325,152,282,0.539,78,108,0.722,57,142,199,112,53,80,116,535
279,2017-10-28,Minnesota Timberwolves,6,1440,237,509,0.466,51,137,0.372,186,372,0.5,116,150,0.773,64,175,239,134,42,88,104,641
280,2017-10-28,Detroit Pistons,5,1200,209,451,0.463,49,143,0.343,160,308,0.519,65,83,0.783,55,154,209,110,43,67,121,532
281,2017-10-28,Houston Rockets,6,1440,225,499,0.451,81,267,0.303,144,232,0.621,107,130,0.823,53,218,271,132,49,89,124,638
282,2017-10-28,Miami Heat,4,960,165,353,0.467,45,127,0.354,120,226,0.531,50,67,0.746,31,131,162,91,30,55,83,425
283,2017-10-28,Los Angeles Lakers,5,1225,206,445,0.463,35,122,0.287,171,323,0.529,83,116,0.716,41,193,234,117,39,96,118,530
284,2017-10-28,Milwaukee Bucks,5,1200,193,400,0.483,45,125,0.36,148,275,0.538,79,102,0.775,28,161,189,110,38,72,109,510
285,2017-10-28,Phoenix Suns,5,1200,184,425,0.433,43,129,0.333,141,296,0.476,97,130,0.746,46,173,219,84,39,90,124,508
286,2017-10-28,Boston Celtics,5,1200,180,416,0.433,54,148,0.365,126,268,0.47,93,127,0.732,45,185,230,110,45,68,113,507
287,2017-10-28,Memphis Grizzlies,5,1200,167,382,0.437,47,140,0.336,120,242,0.496,121,156,0.776,39,166,205,87,36,72,120,502
288,2017-10-28,Philadelphia 76ers,5,1200,188,439,0.428,54,151,0.358,134,288,0.465,72,105,0.686,53,175,228,117,43,88,127,502
289,2017-10-28,San Antonio Spurs,5,1200,191,437,0.437,28,94,0.298,163,343,0.475,89,115,0.774,69,181,250,103,34,72,89,499
290,2017-10-28,Charlotte Hornets,5,1200,170,406,0.419,51,152,0.336,119,254,0.469,105,149,0.705,46,200,246,83,23,75,84,496
291,2017-10-28,Denver Nuggets,5,1200,192,433,0.443,43,131,0.328,149,302,0.493,67,93,0.72,63,174,237,115,30,83,94,494
292,2017-10-28,Sacramento Kings,5,1200,191,440,0.434,42,110,0.382,149,330,0.452,69,90,0.767,55,154,209,98,39,65,101,493
293,2017-10-28,Atlanta Hawks,6,1440,221,529,0.418,55,153,0.359,166,376,0.441,94,108,0.87,60,200,260,119,54,84,133,591
294,2017-10-28,Dallas Mavericks,6,1440,206,509,0.405,71,198,0.359,135,311,0.434,104,142,0.732,60,188,248,126,46,78,113,587
295,2017-10-28,New York Knicks,4,960,149,343,0.434,25,93,0.269,124,250,0.496,64,92,0.696,53,125,178,78,29,62,80,387
296,2017-10-28,Chicago Bulls,4,960,141,345,0.409,42,125,0.336,99,220,0.45,56,70,0.8,44,144,188,88,18,60,73,380
297,2017-10-28,Utah Jazz,5,1200,182,391,0.465,40,128,0.313,142,263,0.54,67,83,0.807,35,165,200,113,45,93,102,471
298,2017-10-29,Golden State Warriors,6,1440,260,513,0.507,83,211,0.393,177,302,0.586,117,136,0.86,59,217,276,181,44,102,134,720
299,2017-10-29,Orlando Magic,5,1200,217,436,0.498,62,135,0.459,155,301,0.515,94,118,0.797,44,185,229,122,41,76,120,590
300,2017-10-29,Brooklyn Nets,6,1440,242,537,0.451,71,195,0.364,171,342,0.5,137,177,0.774,68,196,264,132,56,99,138,692
301,2017-10-29,Indiana Pacers,5,1200,215,443,0.485,40,122,0.328,175,321,0.545,100,132,0.758,55,159,214,106,43,72,104,570
302,2017-10-29,Washington Wizards,5,1225,201,448,0.449,42,128,0.328,159,320,0.497,116,146,0.795,52,161,213,120,51,67,102,560
303,2017-10-29,Portland Trail Blazers,6,1440,232,534,0.434,69,157,0.439,163,377,0.432,135,163,0.828,85,225,310,122,43,82,142,668
304,2017-10-29,Toronto Raptors,5,1200,198,439,0.451,51,173,0.295,147,266,0.553,108,128,0.844,52,164,216,123,48,72,118,555
305,2017-10-29,New Orleans Pelicans,6,1440,243,517,0.47,68,188,0.362,175,329,0.532,106,143,0.741,62,218,280,139,46,95,140,660
306,2017-10-29,Minnesota Timberwolves,6,1440,237,509,0.466,51,137,0.372,186,372,0.5,116,150,0.773,64,175,239,134,42,88,104,641
307,2017-10-29,Cleveland Cavaliers,6,1440,233,492,0.474,63,178,0.354,170,314,0.541,109,140,0.779,51,210,261,127,33,98,99,638
308,2017-10-29,Los Angeles Clippers,5,1200,193,439,0.44,58,154,0.377,135,285,0.474,87,122,0.713,67,185,252,100,45,68,105,531
309,2017-10-29,Oklahoma City Thunder,6,1440,242,527,0.459,64,191,0.335,178,336,0.53,88,122,0.721,68,183,251,140,69,91,133,636
310,2017-10-29,Detroit Pistons,6,1440,245,539,0.455,58,171,0.339,187,368,0.508,79,104,0.76,67,192,259,126,54,79,141,627
311,2017-10-29,Houston Rockets,7,1680,254,576,0.441,95,305,0.311,159,271,0.587,124,151,0.821,61,253,314,150,53,106,147,727
312,2017-10-29,Miami Heat,5,1200,199,432,0.461,52,158,0.329,147,274,0.536,65,83,0.783,37,165,202,108,36,74,106,515
313,2017-10-29,Phoenix Suns,6,1440,221,512,0.432,52,155,0.335,169,357,0.473,121,160,0.756,58,207,265,105,51,107,147,615
314,2017-10-29,Philadelphia 76ers,6,1440,231,526,0.439,70,186,0.376,161,340,0.474,82,119,0.689,64,206,270,142,53,101,148,614
315,2017-10-29,Milwaukee Bucks,5,1200,193,400,0.483,45,125,0.36,148,275,0.538,79,102,0.775,28,161,189,110,38,72,109,510
316,2017-10-29,Los Angeles Lakers,6,1465,237,526,0.451,40,144,0.278,197,382,0.516,97,136,0.713,55,218,273,134,51,112,138,611
317,2017-10-29,Memphis Grizzlies,6,1440,207,467,0.443,61,173,0.353,146,294,0.497,130,168,0.774,45,202,247,113,46,81,140,605
318,2017-10-29,Boston Celtics,6,1440,214,497,0.431,60,171,0.351,154,326,0.472,115,153,0.752,56,215,271,125,56,80,127,603
319,2017-10-29,San Antonio Spurs,5,1200,191,437,0.437,28,94,0.298,163,343,0.475,89,115,0.774,69,181,250,103,34,72,89,499
320,2017-10-29,Dallas Mavericks,7,1680,244,583,0.419,90,238,0.378,154,345,0.446,119,161,0.739,63,218,281,148,53,95,128,697
321,2017-10-29,Charlotte Hornets,5,1200,170,406,0.419,51,152,0.336,119,254,0.469,105,149,0.705,46,200,246,83,23,75,84,496
322,2017-10-29,Denver Nuggets,5,1200,192,433,0.443,43,131,0.328,149,302,0.493,67,93,0.72,63,174,237,115,30,83,94,494
323,2017-10-29,Sacramento Kings,5,1200,191,440,0.434,42,110,0.382,149,330,0.452,69,90,0.767,55,154,209,98,39,65,101,493
324,2017-10-29,Atlanta Hawks,6,1440,221,529,0.418,55,153,0.359,166,376,0.441,94,108,0.87,60,200,260,119,54,84,133,591
325,2017-10-29,New York Knicks,4,960,149,343,0.434,25,93,0.269,124,250,0.496,64,92,0.696,53,125,178,78,29,62,80,387
326,2017-10-29,Utah Jazz,6,1440,219,470,0.466,53,159,0.333,166,311,0.534,76,96,0.792,49,200,249,131,54,114,122,567
327,2017-10-29,Chicago Bulls,5,1200,163,423,0.385,52,162,0.321,111,261,0.425,71,90,0.789,56,179,235,104,27,79,89,449
328,2017-10-30,Golden State Warriors,7,1680,304,590,0.515,93,238,0.391,211,352,0.599,126,148,0.851,69,247,316,210,47,127,148,827
329,2017-10-30,Orlando Magic,6,1440,258,533,0.484,73,168,0.435,185,365,0.507,114,144,0.792,53,215,268,150,52,87,140,703
330,2017-10-30,Brooklyn Nets,7,1680,281,633,0.444,83,226,0.367,198,407,0.486,158,208,0.76,85,235,320,156,61,114,156,803
331,2017-10-30,Washington Wizards,6,1465,241,533,0.452,59,162,0.364,182,371,0.491,129,166,0.777,65,197,262,148,60,82,120,670
332,2017-10-30,Portland Trail Blazers,6,1440,232,534,0.434,69,157,0.439,163,377,0.432,135,163,0.828,85,225,310,122,43,82,142,668
333,2017-10-30,Indiana Pacers,6,1440,251,520,0.483,50,144,0.347,201,376,0.535,115,152,0.757,61,197,258,127,52,91,124,667
334,2017-10-30,Toronto Raptors,5,1200,198,439,0.451,51,173,0.295,147,266,0.553,108,128,0.844,52,164,216,123,48,72,118,555
335,2017-10-30,New Orleans Pelicans,6,1440,243,517,0.47,68,188,0.362,175,329,0.532,106,143,0.741,62,218,280,139,46,95,140,660
336,2017-10-30,Minnesota Timberwolves,6,1440,237,509,0.466,51,137,0.372,186,372,0.5,116,150,0.773,64,175,239,134,42,88,104,641
337,2017-10-30,Los Angeles Clippers,5,1200,193,439,0.44,58,154,0.377,135,285,0.474,87,122,0.713,67,185,252,100,45,68,105,531
338,2017-10-30,Detroit Pistons,7,1680,288,632,0.456,70,198,0.354,218,434,0.502,96,121,0.793,84,212,296,148,70,92,150,742
339,2017-10-30,Oklahoma City Thunder,6,1440,242,527,0.459,64,191,0.335,178,336,0.53,88,122,0.721,68,183,251,140,69,91,133,636
340,2017-10-30,Cleveland Cavaliers,7,1680,264,573,0.461,73,211,0.346,191,362,0.528,132,167,0.79,58,244,302,147,38,113,122,733
341,2017-10-30,Milwaukee Bucks,6,1440,237,481,0.493,58,151,0.384,179,330,0.542,95,123,0.772,33,199,232,140,47,86,136,627
342,2017-10-30,Houston Rockets,7,1680,254,576,0.441,95,305,0.311,159,271,0.587,124,151,0.821,61,253,314,150,53,106,147,727
343,2017-10-30,Denver Nuggets,6,1440,239,527,0.454,54,151,0.358,185,376,0.492,86,115,0.748,67,216,283,138,37,89,116,618
344,2017-10-30,Miami Heat,5,1200,199,432,0.461,52,158,0.329,147,274,0.536,65,83,0.783,37,165,202,108,36,74,106,515
345,2017-10-30,Charlotte Hornets,6,1440,223,503,0.443,57,170,0.335,166,333,0.498,113,166,0.681,58,247,305,114,29,92,108,616
346,2017-10-30,Phoenix Suns,6,1440,221,512,0.432,52,155,0.335,169,357,0.473,121,160,0.756,58,207,265,105,51,107,147,615
347,2017-10-30,Philadelphia 76ers,6,1440,231,526,0.439,70,186,0.376,161,340,0.474,82,119,0.689,64,206,270,142,53,101,148,614
348,2017-10-30,Los Angeles Lakers,6,1465,237,526,0.451,40,144,0.278,197,382,0.516,97,136,0.713,55,218,273,134,51,112,138,611
349,2017-10-30,Memphis Grizzlies,6,1440,207,467,0.443,61,173,0.353,146,294,0.497,130,168,0.774,45,202,247,113,46,81,140,605
350,2017-10-30,Boston Celtics,6,1440,214,497,0.431,60,171,0.351,154,326,0.472,115,153,0.752,56,215,271,125,56,80,127,603
351,2017-10-30,New York Knicks,5,1200,191,432,0.442,38,121,0.314,153,311,0.492,81,113,0.717,64,165,229,105,38,76,106,501
352,2017-10-30,Atlanta Hawks,7,1680,257,606,0.424,68,182,0.374,189,424,0.446,115,134,0.858,63,228,291,146,63,100,154,697
353,2017-10-30,Dallas Mavericks,7,1680,244,583,0.419,90,238,0.378,154,345,0.446,119,161,0.739,63,218,281,148,53,95,128,697
354,2017-10-30,San Antonio Spurs,6,1440,227,527,0.431,37,122,0.303,190,405,0.469,102,133,0.767,81,213,294,122,46,87,100,593
355,2017-10-30,Sacramento Kings,6,1440,223,522,0.427,48,132,0.364,175,390,0.449,82,106,0.774,66,186,252,111,47,82,121,576
356,2017-10-30,Utah Jazz,6,1440,219,470,0.466,53,159,0.333,166,311,0.534,76,96,0.792,49,200,249,131,54,114,122,567
357,2017-10-30,Chicago Bulls,5,1200,163,423,0.385,52,162,0.321,111,261,0.425,71,90,0.789,56,179,235,104,27,79,89,449
358,2017-11-1,Golden State Warriors,8,1920,356,679,0.524,107,267,0.401,249,412,0.604,149,178,0.837,83,279,362,247,55,139,171,968
359,2017-11-1,Orlando Magic,7,1680,301,618,0.487,89,202,0.441,212,416,0.51,127,162,0.784,59,252,311,177,62,103,159,818
360,2017-11-1,Brooklyn Nets,8,1920,323,735,0.439,92,257,0.358,231,478,0.483,179,238,0.752,92,272,364,171,70,121,178,917
361,2017-11-1,Washington Wizards,6,1465,241,533,0.452,59,162,0.364,182,371,0.491,129,166,0.777,65,197,262,148,60,82,120,670
362,2017-11-1,Indiana Pacers,7,1680,287,605,0.474,62,173,0.358,225,432,0.521,132,174,0.759,75,236,311,152,60,105,141,768
363,2017-11-1,Minnesota Timberwolves,7,1705,278,600,0.463,62,160,0.388,216,440,0.491,148,185,0.8,74,205,279,154,58,104,129,766
364,2017-11-1,Toronto Raptors,6,1440,237,526,0.451,59,197,0.299,178,329,0.541,121,145,0.834,60,203,263,140,58,81,132,654
365,2017-11-1,New Orleans Pelicans,7,1680,282,602,0.468,75,216,0.347,207,386,0.536,120,161,0.745,71,252,323,169,55,114,162,759
366,2017-11-1,Portland Trail Blazers,7,1680,263,614,0.428,77,183,0.421,186,431,0.432,150,182,0.824,91,257,348,135,48,95,157,753
367,2017-11-1,Los Angeles Clippers,6,1440,232,525,0.442,68,179,0.38,164,346,0.474,112,152,0.737,76,211,287,121,49,80,125,644
368,2017-11-1,Oklahoma City Thunder,7,1680,282,608,0.464,76,219,0.347,206,389,0.53,106,143,0.741,77,220,297,164,75,106,153,746
369,2017-11-1,Miami Heat,6,1465,248,525,0.472,59,185,0.319,189,340,0.556,82,108,0.759,52,199,251,125,44,98,134,637
370,2017-11-1,Phoenix Suns,7,1680,266,608,0.438,62,177,0.35,204,431,0.473,143,184,0.777,68,263,331,123,56,125,173,737
371,2017-11-1,Cleveland Cavaliers,7,1680,264,573,0.461,73,211,0.346,191,362,0.528,132,167,0.79,58,244,302,147,38,113,122,733
372,2017-11-1,Detroit Pistons,8,1920,329,726,0.453,80,231,0.346,249,495,0.503,97,124,0.782,94,246,340,169,77,104,161,835
373,2017-11-1,Houston Rockets,8,1920,287,659,0.436,108,352,0.307,179,307,0.583,152,189,0.804,71,278,349,167,65,121,170,834
374,2017-11-1,Philadelphia 76ers,7,1680,275,606,0.454,80,210,0.381,195,396,0.492,99,143,0.692,71,247,318,169,63,120,179,729
375,2017-11-1,Denver Nuggets,7,1680,274,612,0.448,72,192,0.375,202,420,0.481,108,146,0.74,80,239,319,158,50,102,138,728
376,2017-11-1,Los Angeles Lakers,7,1705,282,617,0.457,52,170,0.306,230,447,0.515,108,150,0.72,66,260,326,164,60,126,152,724
377,2017-11-1,Charlotte Hornets,7,1680,260,592,0.439,64,187,0.342,196,405,0.484,136,195,0.697,68,293,361,129,32,103,130,720
378,2017-11-1,New York Knicks,6,1440,232,514,0.451,51,153,0.333,181,361,0.501,102,136,0.75,75,203,278,132,46,98,133,617
379,2017-11-1,Milwaukee Bucks,7,1680,269,558,0.482,67,182,0.368,202,376,0.537,113,145,0.779,37,226,263,164,55,100,158,718
380,2017-11-1,Boston Celtics,7,1680,256,585,0.438,71,202,0.351,185,383,0.483,128,169,0.757,71,254,325,149,66,93,149,711
381,2017-11-1,Memphis Grizzlies,7,1680,239,560,0.427,69,208,0.332,170,352,0.483,157,201,0.781,56,239,295,130,53,88,162,704
382,2017-11-1,Atlanta Hawks,7,1680,257,606,0.424,68,182,0.374,189,424,0.446,115,134,0.858,63,228,291,146,63,100,154,697
383,2017-11-1,Dallas Mavericks,8,1920,278,659,0.422,102,262,0.389,176,397,0.443,128,172,0.744,72,251,323,165,57,119,144,786
384,2017-11-1,San Antonio Spurs,7,1680,263,614,0.428,49,148,0.331,214,466,0.459,112,153,0.732,93,241,334,146,54,98,114,687
385,2017-11-1,Utah Jazz,7,1680,257,551,0.466,69,194,0.356,188,357,0.527,88,111,0.793,55,229,284,156,70,128,139,671
386,2017-11-1,Sacramento Kings,7,1680,260,610,0.426,50,146,0.342,210,464,0.453,89,120,0.742,75,222,297,126,55,96,139,659
387,2017-11-1,Chicago Bulls,5,1200,163,423,0.385,52,162,0.321,111,261,0.425,71,90,0.789,56,179,235,104,27,79,89,449
388,2017-11-2,Golden State Warriors,8,1920,356,679,0.524,107,267,0.401,249,412,0.604,149,178,0.837,83,279,362,247,55,139,171,968
389,2017-11-2,Orlando Magic,8,1920,339,693,0.489,102,231,0.442,237,462,0.513,139,176,0.79,65,284,349,202,68,127,181,919
390,2017-11-2,Brooklyn Nets,8,1920,323,735,0.439,92,257,0.358,231,478,0.483,179,238,0.752,92,272,364,171,70,121,178,917
391,2017-11-2,Washington Wizards,7,1705,282,625,0.451,69,192,0.359,213,433,0.492,153,196,0.781,80,227,307,168,65,94,148,786
392,2017-11-2,Indiana Pacers,8,1920,336,695,0.483,78,199,0.392,258,496,0.52,142,187,0.759,83,271,354,187,69,116,164,892
393,2017-11-2,Toronto Raptors,7,1680,279,611,0.457,70,228,0.307,209,383,0.546,137,170,0.806,69,232,301,160,65,94,157,765
394,2017-11-2,Los Angeles Clippers,7,1680,273,603,0.453,81,207,0.391,192,396,0.485,136,181,0.751,83,253,336,148,58,96,145,763
395,2017-11-2,Minnesota Timberwolves,8,1945,319,683,0.467,68,182,0.374,251,501,0.501,164,209,0.785,85,241,326,174,71,125,150,870
396,2017-11-2,Phoenix Suns,8,1920,307,691,0.444,71,201,0.353,236,490,0.482,174,222,0.784,79,297,376,146,61,134,197,859
397,2017-11-2,New Orleans Pelicans,8,1920,318,686,0.464,83,247,0.336,235,439,0.535,138,182,0.758,80,281,361,196,68,133,186,857
398,2017-11-2,Denver Nuggets,8,1920,321,700,0.459,88,224,0.393,233,476,0.489,127,175,0.726,89,273,362,193,59,114,158,857
399,2017-11-2,Portland Trail Blazers,8,1945,300,707,0.424,86,217,0.396,214,490,0.437,170,209,0.813,102,299,401,152,56,112,182,856
400,2017-11-2,Oklahoma City Thunder,7,1680,282,608,0.464,76,219,0.347,206,389,0.53,106,143,0.741,77,220,297,164,75,106,153,746
401,2017-11-2,Philadelphia 76ers,8,1920,321,705,0.455,93,245,0.38,228,460,0.496,113,168,0.673,86,285,371,205,73,136,205,848
402,2017-11-2,Houston Rockets,9,2160,329,747,0.44,127,404,0.314,202,343,0.589,168,210,0.8,80,315,395,188,71,135,190,953
403,2017-11-2,Charlotte Hornets,8,1920,305,676,0.451,78,212,0.368,227,464,0.489,158,224,0.705,75,327,402,150,37,114,148,846
404,2017-11-2,Cleveland Cavaliers,8,1920,307,659,0.466,80,242,0.331,227,417,0.544,146,187,0.781,66,277,343,172,44,129,141,840
405,2017-11-2,Milwaukee Bucks,8,1920,314,649,0.484,86,218,0.394,228,431,0.529,125,160,0.781,46,257,303,193,58,114,183,839
406,2017-11-2,Miami Heat,7,1705,282,608,0.464,71,216,0.329,211,392,0.538,99,127,0.78,55,244,299,146,52,109,153,734
407,2017-11-2,Detroit Pistons,8,1920,329,726,0.453,80,231,0.346,249,495,0.503,97,124,0.782,94,246,340,169,77,104,161,835
408,2017-11-2,Los Angeles Lakers,7,1705,282,617,0.457,52,170,0.306,230,447,0.515,108,150,0.72,66,260,326,164,60,126,152,724
409,2017-11-2,Boston Celtics,8,1920,296,667,0.444,88,243,0.362,208,424,0.491,144,188,0.766,87,290,377,179,76,109,168,824
410,2017-11-2,New York Knicks,7,1680,271,604,0.449,59,179,0.33,212,425,0.499,113,149,0.758,81,239,320,155,54,117,151,714
411,2017-11-2,Atlanta Hawks,8,1920,298,700,0.426,76,205,0.371,222,495,0.448,134,161,0.832,75,265,340,168,74,118,182,806
412,2017-11-2,Memphis Grizzlies,8,1920,278,642,0.433,79,238,0.332,199,404,0.493,168,217,0.774,61,265,326,151,65,101,178,803
413,2017-11-2,Dallas Mavericks,9,2160,313,748,0.418,114,298,0.383,199,450,0.442,144,192,0.75,81,280,361,185,65,133,166,884
414,2017-11-2,San Antonio Spurs,7,1680,263,614,0.428,49,148,0.331,214,466,0.459,112,153,0.732,93,241,334,146,54,98,114,687
415,2017-11-2,Utah Jazz,8,1945,291,641,0.454,82,223,0.368,209,418,0.5,119,147,0.81,65,274,339,172,79,142,160,783
416,2017-11-2,Sacramento Kings,8,1920,295,691,0.427,56,166,0.337,239,525,0.455,99,132,0.75,82,241,323,150,65,111,157,745
417,2017-11-2,Chicago Bulls,6,1440,199,512,0.389,59,190,0.311,140,322,0.435,83,109,0.761,63,226,289,124,34,91,108,540
418,2017-11-3,Golden State Warriors,9,2160,399,762,0.524,121,295,0.41,278,467,0.595,161,194,0.83,88,315,403,277,66,153,191,1080
419,2017-11-3,Orlando Magic,8,1920,339,693,0.489,102,231,0.442,237,462,0.513,139,176,0.79,65,284,349,202,68,127,181,919
420,2017-11-3,Brooklyn Nets,8,1920,323,735,0.439,92,257,0.358,231,478,0.483,179,238,0.752,92,272,364,171,70,121,178,917
421,2017-11-3,Washington Wizards,7,1705,282,625,0.451,69,192,0.359,213,433,0.492,153,196,0.781,80,227,307,168,65,94,148,786
422,2017-11-3,Indiana Pacers,8,1920,336,695,0.483,78,199,0.392,258,496,0.52,142,187,0.759,83,271,354,187,69,116,164,892
423,2017-11-3,Toronto Raptors,7,1680,279,611,0.457,70,228,0.307,209,383,0.546,137,170,0.806,69,232,301,160,65,94,157,765
424,2017-11-3,Los Angeles Clippers,7,1680,273,603,0.453,81,207,0.391,192,396,0.485,136,181,0.751,83,253,336,148,58,96,145,763
425,2017-11-3,Minnesota Timberwolves,8,1945,319,683,0.467,68,182,0.374,251,501,0.501,164,209,0.785,85,241,326,174,71,125,150,870
426,2017-11-3,Portland Trail Blazers,9,2185,340,793,0.429,95,239,0.397,245,554,0.442,194,236,0.822,112,330,442,174,63,124,203,969
427,2017-11-3,Phoenix Suns,8,1920,307,691,0.444,71,201,0.353,236,490,0.482,174,222,0.784,79,297,376,146,61,134,197,859
428,2017-11-3,New Orleans Pelicans,8,1920,318,686,0.464,83,247,0.336,235,439,0.535,138,182,0.758,80,281,361,196,68,133,186,857
429,2017-11-3,Denver Nuggets,8,1920,321,700,0.459,88,224,0.393,233,476,0.489,127,175,0.726,89,273,362,193,59,114,158,857
430,2017-11-3,Oklahoma City Thunder,7,1680,282,608,0.464,76,219,0.347,206,389,0.53,106,143,0.741,77,220,297,164,75,106,153,746
431,2017-11-3,Philadelphia 76ers,8,1920,321,705,0.455,93,245,0.38,228,460,0.496,113,168,0.673,86,285,371,205,73,136,205,848
432,2017-11-3,Houston Rockets,9,2160,329,747,0.44,127,404,0.314,202,343,0.589,168,210,0.8,80,315,395,188,71,135,190,953
433,2017-11-3,Charlotte Hornets,8,1920,305,676,0.451,78,212,0.368,227,464,0.489,158,224,0.705,75,327,402,150,37,114,148,846
434,2017-11-3,Cleveland Cavaliers,8,1920,307,659,0.466,80,242,0.331,227,417,0.544,146,187,0.781,66,277,343,172,44,129,141,840
435,2017-11-3,Milwaukee Bucks,8,1920,314,649,0.484,86,218,0.394,228,431,0.529,125,160,0.781,46,257,303,193,58,114,183,839
436,2017-11-3,Miami Heat,7,1705,282,608,0.464,71,216,0.329,211,392,0.538,99,127,0.78,55,244,299,146,52,109,153,734
437,2017-11-3,Detroit Pistons,8,1920,329,726,0.453,80,231,0.346,249,495,0.503,97,124,0.782,94,246,340,169,77,104,161,835
438,2017-11-3,Los Angeles Lakers,8,1945,325,696,0.467,56,188,0.298,269,508,0.53,128,177,0.723,68,290,358,180,68,137,172,834
439,2017-11-3,Boston Celtics,8,1920,296,667,0.444,88,243,0.362,208,424,0.491,144,188,0.766,87,290,377,179,76,109,168,824
440,2017-11-3,New York Knicks,7,1680,271,604,0.449,59,179,0.33,212,425,0.499,113,149,0.758,81,239,320,155,54,117,151,714
441,2017-11-3,Atlanta Hawks,8,1920,298,700,0.426,76,205,0.371,222,495,0.448,134,161,0.832,75,265,340,168,74,118,182,806
442,2017-11-3,Memphis Grizzlies,8,1920,278,642,0.433,79,238,0.332,199,404,0.493,168,217,0.774,61,265,326,151,65,101,178,803
443,2017-11-3,Dallas Mavericks,9,2160,313,748,0.418,114,298,0.383,199,450,0.442,144,192,0.75,81,280,361,185,65,133,166,884
444,2017-11-3,Utah Jazz,8,1945,291,641,0.454,82,223,0.368,209,418,0.5,119,147,0.81,65,274,339,172,79,142,160,783
445,2017-11-3,San Antonio Spurs,8,1920,297,701,0.424,56,172,0.326,241,529,0.456,129,176,0.733,107,273,380,165,60,114,124,779
446,2017-11-3,Sacramento Kings,8,1920,295,691,0.427,56,166,0.337,239,525,0.455,99,132,0.75,82,241,323,150,65,111,157,745
447,2017-11-3,Chicago Bulls,6,1440,199,512,0.389,59,190,0.311,140,322,0.435,83,109,0.761,63,226,289,124,34,91,108,540
448,2017-11-4,Golden State Warriors,9,2160,399,762,0.524,121,295,0.41,278,467,0.595,161,194,0.83,88,315,403,277,66,153,191,1080
449,2017-11-4,Brooklyn Nets,9,2160,360,826,0.436,101,295,0.342,259,531,0.488,208,276,0.754,100,307,407,194,78,137,200,1029
450,2017-11-4,Washington Wizards,8,1945,327,709,0.461,80,220,0.364,247,489,0.505,174,227,0.767,89,255,344,193,70,110,172,908
451,2017-11-4,Orlando Magic,9,2160,374,779,0.48,112,266,0.421,262,513,0.511,142,181,0.785,72,315,387,225,74,143,192,1002
452,2017-11-4,Indiana Pacers,9,2160,381,792,0.481,86,227,0.379,295,565,0.522,154,206,0.748,91,303,394,212,75,127,182,1002
453,2017-11-4,Toronto Raptors,8,1920,317,682,0.465,81,258,0.314,236,424,0.557,159,198,0.803,74,266,340,180,74,110,184,874
454,2017-11-4,Los Angeles Clippers,7,1680,273,603,0.453,81,207,0.391,192,396,0.485,136,181,0.751,83,253,336,148,58,96,145,763
455,2017-11-4,Minnesota Timberwolves,8,1945,319,683,0.467,68,182,0.374,251,501,0.501,164,209,0.785,85,241,326,174,71,125,150,870
456,2017-11-4,Cleveland Cavaliers,9,2160,353,741,0.476,92,269,0.342,261,472,0.553,172,215,0.8,74,303,377,192,55,143,168,970
457,2017-11-4,Portland Trail Blazers,9,2185,340,793,0.429,95,239,0.397,245,554,0.442,194,236,0.822,112,330,442,174,63,124,203,969
458,2017-11-4,Philadelphia 76ers,9,2160,367,797,0.46,111,281,0.395,256,516,0.496,124,182,0.681,98,323,421,239,80,154,225,969
459,2017-11-4,Phoenix Suns,9,2160,341,788,0.433,80,233,0.343,261,555,0.47,204,259,0.788,99,324,423,163,68,144,222,966
460,2017-11-4,Houston Rockets,10,2400,371,836,0.444,143,451,0.317,228,385,0.592,187,233,0.803,89,350,439,216,85,147,206,1072
461,2017-11-4,Los Angeles Lakers,9,2185,373,790,0.472,65,209,0.311,308,581,0.53,147,204,0.721,75,340,415,206,78,153,201,958
462,2017-11-4,New Orleans Pelicans,9,2160,354,775,0.457,90,276,0.326,264,499,0.529,158,208,0.76,89,325,414,219,77,145,208,956
463,2017-11-4,Denver Nuggets,9,2160,357,780,0.458,97,247,0.393,260,533,0.488,141,200,0.705,102,301,403,210,68,131,174,952
464,2017-11-4,Charlotte Hornets,9,2160,338,756,0.447,86,236,0.364,252,520,0.485,185,266,0.695,86,362,448,166,48,126,168,947
465,2017-11-4,Oklahoma City Thunder,8,1920,317,695,0.456,89,254,0.35,228,441,0.517,117,157,0.745,88,257,345,184,79,118,171,840
466,2017-11-4,Detroit Pistons,9,2160,366,804,0.455,88,257,0.342,278,547,0.508,120,152,0.789,101,278,379,190,87,116,172,940
467,2017-11-4,New York Knicks,8,1920,316,691,0.457,67,205,0.327,249,486,0.512,135,174,0.776,90,279,369,179,59,129,175,834
468,2017-11-4,Milwaukee Bucks,9,2160,353,732,0.482,96,243,0.395,257,489,0.526,133,169,0.787,53,286,339,220,64,127,207,935
469,2017-11-4,Miami Heat,8,1945,318,685,0.464,86,253,0.34,232,432,0.537,106,138,0.768,63,277,340,169,61,132,177,828
470,2017-11-4,Boston Celtics,9,2160,332,751,0.442,101,271,0.373,231,480,0.481,160,212,0.755,98,328,426,202,82,119,182,925
471,2017-11-4,Atlanta Hawks,9,2160,337,781,0.431,87,238,0.366,250,543,0.46,149,179,0.832,80,301,381,184,82,136,198,910
472,2017-11-4,Memphis Grizzlies,8,1920,278,642,0.433,79,238,0.332,199,404,0.493,168,217,0.774,61,265,326,151,65,101,178,803
473,2017-11-4,San Antonio Spurs,9,2160,336,784,0.429,65,199,0.327,271,585,0.463,150,202,0.743,114,311,425,196,67,129,150,887
474,2017-11-4,Utah Jazz,9,2185,326,721,0.452,90,246,0.366,236,475,0.497,141,171,0.825,75,297,372,183,88,155,185,883
475,2017-11-4,Dallas Mavericks,10,2400,347,836,0.415,123,332,0.37,224,504,0.444,161,214,0.752,90,318,408,204,69,148,190,978
476,2017-11-4,Sacramento Kings,8,1920,295,691,0.427,56,166,0.337,239,525,0.455,99,132,0.75,82,241,323,150,65,111,157,745
477,2017-11-4,Chicago Bulls,7,1680,239,597,0.4,73,219,0.333,166,378,0.439,94,121,0.777,72,265,337,147,40,105,121,645
478,2017-11-5,Golden State Warriors,10,2400,449,853,0.526,139,335,0.415,310,518,0.598,170,211,0.806,95,349,444,315,79,166,214,1207
479,2017-11-5,Brooklyn Nets,9,2160,360,826,0.436,101,295,0.342,259,531,0.488,208,276,0.754,100,307,407,194,78,137,200,1029
480,2017-11-5,Washington Wizards,8,1945,327,709,0.461,80,220,0.364,247,489,0.505,174,227,0.767,89,255,344,193,70,110,172,908
481,2017-11-5,Orlando Magic,9,2160,374,779,0.48,112,266,0.421,262,513,0.511,142,181,0.785,72,315,387,225,74,143,192,1002
482,2017-11-5,Indiana Pacers,9,2160,381,792,0.481,86,227,0.379,295,565,0.522,154,206,0.748,91,303,394,212,75,127,182,1002
483,2017-11-5,Toronto Raptors,8,1920,317,682,0.465,81,258,0.314,236,424,0.557,159,198,0.803,74,266,340,180,74,110,184,874
484,2017-11-5,Minnesota Timberwolves,9,2185,362,762,0.475,78,206,0.379,284,556,0.511,180,229,0.786,95,279,374,207,78,143,170,982
485,2017-11-5,Los Angeles Clippers,8,1920,311,686,0.453,85,233,0.365,226,453,0.499,160,212,0.755,98,281,379,166,65,109,167,867
486,2017-11-5,Cleveland Cavaliers,9,2160,353,741,0.476,92,269,0.342,261,472,0.553,172,215,0.8,74,303,377,192,55,143,168,970
487,2017-11-5,Portland Trail Blazers,9,2185,340,793,0.429,95,239,0.397,245,554,0.442,194,236,0.822,112,330,442,174,63,124,203,969
488,2017-11-5,Philadelphia 76ers,9,2160,367,797,0.46,111,281,0.395,256,516,0.496,124,182,0.681,98,323,421,239,80,154,225,969
489,2017-11-5,Phoenix Suns,9,2160,341,788,0.433,80,233,0.343,261,555,0.47,204,259,0.788,99,324,423,163,68,144,222,966
490,2017-11-5,Houston Rockets,10,2400,371,836,0.444,143,451,0.317,228,385,0.592,187,233,0.803,89,350,439,216,85,147,206,1072
491,2017-11-5,Los Angeles Lakers,9,2185,373,790,0.472,65,209,0.311,308,581,0.53,147,204,0.721,75,340,415,206,78,153,201,958
492,2017-11-5,Denver Nuggets,10,2400,397,867,0.458,103,271,0.38,294,596,0.493,163,227,0.718,111,338,449,236,77,148,192,1060
493,2017-11-5,New Orleans Pelicans,10,2425,389,862,0.451,99,307,0.322,290,555,0.523,175,230,0.761,94,372,466,242,86,158,217,1052
494,2017-11-5,Charlotte Hornets,9,2160,338,756,0.447,86,236,0.364,252,520,0.485,185,266,0.695,86,362,448,166,48,126,168,947
495,2017-11-5,Oklahoma City Thunder,8,1920,317,695,0.456,89,254,0.35,228,441,0.517,117,157,0.745,88,257,345,184,79,118,171,840
496,2017-11-5,Detroit Pistons,10,2400,406,883,0.46,101,281,0.359,305,602,0.507,135,174,0.776,109,305,414,218,97,130,191,1048
497,2017-11-5,New York Knicks,8,1920,316,691,0.457,67,205,0.327,249,486,0.512,135,174,0.776,90,279,369,179,59,129,175,834
498,2017-11-5,Milwaukee Bucks,9,2160,353,732,0.482,96,243,0.395,257,489,0.526,133,169,0.787,53,286,339,220,64,127,207,935
499,2017-11-5,Miami Heat,8,1945,318,685,0.464,86,253,0.34,232,432,0.537,106,138,0.768,63,277,340,169,61,132,177,828
500,2017-11-5,Boston Celtics,9,2160,332,751,0.442,101,271,0.373,231,480,0.481,160,212,0.755,98,328,426,202,82,119,182,925
501,2017-11-5,Memphis Grizzlies,9,2160,318,726,0.438,92,269,0.342,226,457,0.495,188,241,0.78,70,295,365,172,73,112,206,916
502,2017-11-5,Atlanta Hawks,9,2160,337,781,0.431,87,238,0.366,250,543,0.46,149,179,0.832,80,301,381,184,82,136,198,910
503,2017-11-5,San Antonio Spurs,9,2160,336,784,0.429,65,199,0.327,271,585,0.463,150,202,0.743,114,311,425,196,67,129,150,887
504,2017-11-5,Utah Jazz,9,2185,326,721,0.452,90,246,0.366,236,475,0.497,141,171,0.825,75,297,372,183,88,155,185,883
505,2017-11-5,Dallas Mavericks,11,2640,387,922,0.42,133,359,0.37,254,563,0.451,170,226,0.752,97,342,439,222,76,164,209,1077
506,2017-11-5,Sacramento Kings,9,2160,335,767,0.437,66,187,0.353,269,580,0.464,108,145,0.745,85,270,355,174,71,128,180,844
507,2017-11-5,Chicago Bulls,8,1945,274,696,0.394,84,261,0.322,190,435,0.437,103,133,0.774,88,307,395,170,50,122,140,735
508,2017-11-6,Golden State Warriors,10,2400,449,853,0.526,139,335,0.415,310,518,0.598,170,211,0.806,95,349,444,315,79,166,214,1207
509,2017-11-6,Brooklyn Nets,9,2160,360,826,0.436,101,295,0.342,259,531,0.488,208,276,0.754,100,307,407,194,78,137,200,1029
510,2017-11-6,Washington Wizards,9,2185,367,794,0.462,91,243,0.374,276,551,0.501,190,250,0.76,100,290,390,212,79,127,198,1015
511,2017-11-6,Indiana Pacers,10,2400,418,871,0.48,98,252,0.389,320,619,0.517,169,223,0.758,95,333,428,236,81,139,199,1103
512,2017-11-6,Houston Rockets,11,2640,419,917,0.457,166,490,0.339,253,427,0.593,205,254,0.807,94,387,481,242,94,167,230,1209
513,2017-11-6,Minnesota Timberwolves,10,2425,400,845,0.473,88,230,0.383,312,615,0.507,206,259,0.795,107,321,428,227,82,159,189,1094
514,2017-11-6,Orlando Magic,10,2400,407,870,0.468,118,295,0.4,289,575,0.503,158,199,0.794,82,350,432,243,78,156,211,1090
515,2017-11-6,Cleveland Cavaliers,10,2400,395,837,0.472,102,305,0.334,293,532,0.551,193,238,0.811,89,335,424,219,61,156,197,1085
516,2017-11-6,Toronto Raptors,9,2160,354,762,0.465,86,282,0.305,268,480,0.558,176,225,0.782,83,293,376,197,81,123,208,970
517,2017-11-6,Philadelphia 76ers,9,2160,367,797,0.46,111,281,0.395,256,516,0.496,124,182,0.681,98,323,421,239,80,154,225,969
518,2017-11-6,Los Angeles Clippers,9,2160,345,773,0.446,94,264,0.356,251,509,0.493,184,242,0.76,116,313,429,182,76,124,189,968
519,2017-11-6,Portland Trail Blazers,10,2425,377,867,0.435,102,259,0.394,275,608,0.452,216,264,0.818,119,367,486,194,69,145,223,1072
520,2017-11-6,Los Angeles Lakers,10,2425,413,875,0.472,74,236,0.314,339,639,0.531,165,227,0.727,83,378,461,231,83,169,217,1065
521,2017-11-6,Phoenix Suns,10,2400,378,869,0.435,88,256,0.344,290,613,0.473,217,281,0.772,110,358,468,186,73,162,238,1061
522,2017-11-6,Denver Nuggets,10,2400,397,867,0.458,103,271,0.38,294,596,0.493,163,227,0.718,111,338,449,236,77,148,192,1060
523,2017-11-6,New Orleans Pelicans,10,2425,389,862,0.451,99,307,0.322,290,555,0.523,175,230,0.761,94,372,466,242,86,158,217,1052
524,2017-11-6,Detroit Pistons,10,2400,406,883,0.46,101,281,0.359,305,602,0.507,135,174,0.776,109,305,414,218,97,130,191,1048
525,2017-11-6,New York Knicks,9,2160,360,779,0.462,73,228,0.32,287,551,0.521,149,193,0.772,102,313,415,203,67,141,196,942
526,2017-11-6,Oklahoma City Thunder,9,2160,357,784,0.455,100,287,0.348,257,497,0.517,125,172,0.727,94,283,377,201,90,129,198,939
527,2017-11-6,Charlotte Hornets,10,2400,375,845,0.444,95,264,0.36,280,581,0.482,196,287,0.683,96,392,488,190,56,137,192,1041
528,2017-11-6,Milwaukee Bucks,9,2160,353,732,0.482,96,243,0.395,257,489,0.526,133,169,0.787,53,286,339,220,64,127,207,935
529,2017-11-6,Miami Heat,9,2185,355,769,0.462,100,289,0.346,255,480,0.531,122,157,0.777,73,304,377,192,73,148,203,932
530,2017-11-6,Boston Celtics,10,2400,371,840,0.442,112,304,0.368,259,536,0.483,175,232,0.754,107,373,480,228,92,132,203,1029
531,2017-11-6,Atlanta Hawks,10,2400,378,867,0.436,98,263,0.373,280,604,0.464,173,213,0.812,91,334,425,208,86,153,218,1027
532,2017-11-6,Memphis Grizzlies,10,2400,358,813,0.44,103,306,0.337,255,507,0.503,199,255,0.78,76,328,404,195,79,124,228,1018
533,2017-11-6,San Antonio Spurs,10,2400,380,872,0.436,76,221,0.344,304,651,0.467,163,220,0.741,122,346,468,217,76,138,169,999
534,2017-11-6,Utah Jazz,10,2425,364,809,0.45,103,280,0.368,261,529,0.493,162,195,0.831,83,322,405,205,95,168,203,993
535,2017-11-6,Dallas Mavericks,11,2640,387,922,0.42,133,359,0.37,254,563,0.451,170,226,0.752,97,342,439,222,76,164,209,1077
536,2017-11-6,Sacramento Kings,9,2160,335,767,0.437,66,187,0.353,269,580,0.464,108,145,0.745,85,270,355,174,71,128,180,844
537,2017-11-6,Chicago Bulls,8,1945,274,696,0.394,84,261,0.322,190,435,0.437,103,133,0.774,88,307,395,170,50,122,140,735
538,2017-11-7,Golden State Warriors,11,2640,481,940,0.512,150,367,0.409,331,573,0.578,192,235,0.817,108,387,495,335,91,180,235,1304
539,2017-11-7,Washington Wizards,9,2185,367,794,0.462,91,243,0.374,276,551,0.501,190,250,0.76,100,290,390,212,79,127,198,1015
540,2017-11-7,Brooklyn Nets,10,2400,395,913,0.433,109,327,0.333,286,586,0.488,228,305,0.748,111,344,455,214,88,153,230,1127
541,2017-11-7,Indiana Pacers,10,2400,418,871,0.48,98,252,0.389,320,619,0.517,169,223,0.758,95,333,428,236,81,139,199,1103
542,2017-11-7,Houston Rockets,11,2640,419,917,0.457,166,490,0.339,253,427,0.593,205,254,0.807,94,387,481,242,94,167,230,1209
543,2017-11-7,Minnesota Timberwolves,10,2425,400,845,0.473,88,230,0.383,312,615,0.507,206,259,0.795,107,321,428,227,82,159,189,1094
544,2017-11-7,Orlando Magic,10,2400,407,870,0.468,118,295,0.4,289,575,0.503,158,199,0.794,82,350,432,243,78,156,211,1090
545,2017-11-7,Cleveland Cavaliers,10,2400,395,837,0.472,102,305,0.334,293,532,0.551,193,238,0.811,89,335,424,219,61,156,197,1085
546,2017-11-7,Toronto Raptors,9,2160,354,762,0.465,86,282,0.305,268,480,0.558,176,225,0.782,83,293,376,197,81,123,208,970
547,2017-11-7,Philadelphia 76ers,9,2160,367,797,0.46,111,281,0.395,256,516,0.496,124,182,0.681,98,323,421,239,80,154,225,969
548,2017-11-7,Los Angeles Clippers,9,2160,345,773,0.446,94,264,0.356,251,509,0.493,184,242,0.76,116,313,429,182,76,124,189,968
549,2017-11-7,Portland Trail Blazers,10,2425,377,867,0.435,102,259,0.394,275,608,0.452,216,264,0.818,119,367,486,194,69,145,223,1072
550,2017-11-7,Los Angeles Lakers,10,2425,413,875,0.472,74,236,0.314,339,639,0.531,165,227,0.727,83,378,461,231,83,169,217,1065
551,2017-11-7,Denver Nuggets,10,2400,397,867,0.458,103,271,0.38,294,596,0.493,163,227,0.718,111,338,449,236,77,148,192,1060
552,2017-11-7,New Orleans Pelicans,10,2425,389,862,0.451,99,307,0.322,290,555,0.523,175,230,0.761,94,372,466,242,86,158,217,1052
553,2017-11-7,Detroit Pistons,10,2400,406,883,0.46,101,281,0.359,305,602,0.507,135,174,0.776,109,305,414,218,97,130,191,1048
554,2017-11-7,Phoenix Suns,11,2640,408,955,0.427,94,281,0.335,314,674,0.466,243,316,0.769,124,396,520,199,81,179,267,1153
555,2017-11-7,New York Knicks,9,2160,360,779,0.462,73,228,0.32,287,551,0.521,149,193,0.772,102,313,415,203,67,141,196,942
556,2017-11-7,Oklahoma City Thunder,9,2160,357,784,0.455,100,287,0.348,257,497,0.517,125,172,0.727,94,283,377,201,90,129,198,939
557,2017-11-7,Charlotte Hornets,10,2400,375,845,0.444,95,264,0.36,280,581,0.482,196,287,0.683,96,392,488,190,56,137,192,1041
558,2017-11-7,Milwaukee Bucks,9,2160,353,732,0.482,96,243,0.395,257,489,0.526,133,169,0.787,53,286,339,220,64,127,207,935
559,2017-11-7,Boston Celtics,11,2640,410,921,0.445,126,340,0.371,284,581,0.489,193,254,0.76,114,408,522,256,95,145,224,1139
560,2017-11-7,Atlanta Hawks,11,2640,417,948,0.44,111,289,0.384,306,659,0.464,189,233,0.811,96,365,461,232,94,167,240,1134
561,2017-11-7,Memphis Grizzlies,10,2400,358,813,0.44,103,306,0.337,255,507,0.503,199,255,0.78,76,328,404,195,79,124,228,1018
562,2017-11-7,Miami Heat,10,2425,385,852,0.452,108,315,0.343,277,537,0.516,134,174,0.77,80,341,421,211,83,168,223,1012
563,2017-11-7,San Antonio Spurs,10,2400,380,872,0.436,76,221,0.344,304,651,0.467,163,220,0.741,122,346,468,217,76,138,169,999
564,2017-11-7,Utah Jazz,10,2425,364,809,0.45,103,280,0.368,261,529,0.493,162,195,0.831,83,322,405,205,95,168,203,993
565,2017-11-7,Dallas Mavericks,11,2640,387,922,0.42,133,359,0.37,254,563,0.451,170,226,0.752,97,342,439,222,76,164,209,1077
566,2017-11-7,Sacramento Kings,9,2160,335,767,0.437,66,187,0.353,269,580,0.464,108,145,0.745,85,270,355,174,71,128,180,844
567,2017-11-7,Chicago Bulls,8,1945,274,696,0.394,84,261,0.322,190,435,0.437,103,133,0.774,88,307,395,170,50,122,140,735
568,2017-11-8,Golden State Warriors,11,2640,481,940,0.512,150,367,0.409,331,573,0.578,192,235,0.817,108,387,495,335,91,180,235,1304
569,2017-11-8,Brooklyn Nets,11,2640,433,1002,0.432,120,362,0.331,313,640,0.489,245,327,0.749,119,383,502,236,100,178,246,1231
570,2017-11-8,Washington Wizards,10,2425,399,869,0.459,101,268,0.377,298,601,0.496,215,282,0.762,103,326,429,233,84,142,217,1114
571,2017-11-8,Indiana Pacers,11,2640,462,964,0.479,107,276,0.388,355,688,0.516,184,241,0.763,106,363,469,255,85,149,220,1215
572,2017-11-8,Cleveland Cavaliers,11,2640,436,919,0.474,111,323,0.344,325,596,0.545,226,276,0.819,101,362,463,237,68,168,213,1209
573,2017-11-8,Houston Rockets,11,2640,419,917,0.457,166,490,0.339,253,427,0.593,205,254,0.807,94,387,481,242,94,167,230,1209
574,2017-11-8,Minnesota Timberwolves,10,2425,400,845,0.473,88,230,0.383,312,615,0.507,206,259,0.795,107,321,428,227,82,159,189,1094
575,2017-11-8,Orlando Magic,10,2400,407,870,0.468,118,295,0.4,289,575,0.503,158,199,0.794,82,350,432,243,78,156,211,1090
576,2017-11-8,Toronto Raptors,10,2400,398,843,0.472,99,307,0.322,299,536,0.558,194,249,0.779,90,323,413,219,86,138,230,1089
577,2017-11-8,Los Angeles Clippers,10,2400,387,855,0.453,105,294,0.357,282,561,0.503,196,259,0.757,126,342,468,202,82,141,208,1075
578,2017-11-8,Philadelphia 76ers,10,2400,401,878,0.457,123,308,0.399,278,570,0.488,148,212,0.698,106,371,477,262,85,176,259,1073
579,2017-11-8,Los Angeles Lakers,10,2425,413,875,0.472,74,236,0.314,339,639,0.531,165,227,0.727,83,378,461,231,83,169,217,1065
580,2017-11-8,Denver Nuggets,11,2640,441,960,0.459,112,305,0.367,329,655,0.502,178,247,0.721,120,376,496,262,93,167,213,1172
581,2017-11-8,Portland Trail Blazers,11,2665,413,948,0.436,108,278,0.388,305,670,0.455,235,284,0.827,129,399,528,205,78,161,241,1169
582,2017-11-8,New Orleans Pelicans,11,2665,433,949,0.456,113,342,0.33,320,607,0.527,190,252,0.754,105,404,509,265,92,170,235,1169
583,2017-11-8,New York Knicks,10,2400,405,854,0.474,85,253,0.336,320,601,0.532,165,214,0.771,108,342,450,232,72,157,215,1060
584,2017-11-8,Milwaukee Bucks,10,2400,400,815,0.491,109,273,0.399,291,542,0.537,145,185,0.784,61,314,375,249,70,143,238,1054
585,2017-11-8,Charlotte Hornets,11,2640,417,936,0.446,110,301,0.365,307,635,0.483,210,304,0.691,113,415,528,214,64,150,214,1154
586,2017-11-8,Detroit Pistons,10,2400,406,883,0.46,101,281,0.359,305,602,0.507,135,174,0.776,109,305,414,218,97,130,191,1048
587,2017-11-8,Phoenix Suns,11,2640,408,955,0.427,94,281,0.335,314,674,0.466,243,316,0.769,124,396,520,199,81,179,267,1153
588,2017-11-8,Boston Celtics,11,2640,410,921,0.445,126,340,0.371,284,581,0.489,193,254,0.76,114,408,522,256,95,145,224,1139
589,2017-11-8,Atlanta Hawks,11,2640,417,948,0.44,111,289,0.384,306,659,0.464,189,233,0.811,96,365,461,232,94,167,240,1134
590,2017-11-8,Oklahoma City Thunder,10,2400,386,870,0.444,110,324,0.34,276,546,0.505,143,195,0.733,103,318,421,216,106,143,215,1025
591,2017-11-8,San Antonio Spurs,11,2640,425,956,0.445,91,249,0.365,334,707,0.472,178,239,0.745,133,374,507,250,89,151,190,1119
592,2017-11-8,Memphis Grizzlies,11,2640,393,886,0.444,110,325,0.338,283,561,0.504,220,280,0.786,81,357,438,213,87,138,249,1116
593,2017-11-8,Miami Heat,10,2425,385,852,0.452,108,315,0.343,277,537,0.516,134,174,0.77,80,341,421,211,83,168,223,1012
594,2017-11-8,Dallas Mavericks,12,2880,430,1013,0.424,144,389,0.37,286,624,0.458,186,246,0.756,108,384,492,248,82,175,232,1190
595,2017-11-8,Utah Jazz,11,2665,394,908,0.434,112,319,0.351,282,589,0.479,190,230,0.826,97,353,450,220,109,180,226,1090
596,2017-11-8,Chicago Bulls,9,2185,314,776,0.405,95,290,0.328,219,486,0.451,126,161,0.783,96,336,432,196,60,135,163,849
597,2017-11-8,Sacramento Kings,10,2400,372,846,0.44,75,211,0.355,297,635,0.468,119,157,0.758,90,312,402,195,77,151,204,938
598,2017-11-9,Golden State Warriors,12,2880,529,1025,0.516,165,403,0.409,364,622,0.585,206,253,0.814,111,429,540,372,101,199,258,1429
599,2017-11-9,Brooklyn Nets,11,2640,433,1002,0.432,120,362,0.331,313,640,0.489,245,327,0.749,119,383,502,236,100,178,246,1231
600,2017-11-9,Washington Wizards,10,2425,399,869,0.459,101,268,0.377,298,601,0.496,215,282,0.762,103,326,429,233,84,142,217,1114
601,2017-11-9,Cleveland Cavaliers,11,2640,436,919,0.474,111,323,0.344,325,596,0.545,226,276,0.819,101,362,463,237,68,168,213,1209
602,2017-11-9,Houston Rockets,11,2640,419,917,0.457,166,490,0.339,253,427,0.593,205,254,0.807,94,387,481,242,94,167,230,1209
603,2017-11-9,Orlando Magic,11,2640,450,950,0.474,131,323,0.406,319,627,0.509,171,221,0.774,88,373,461,274,94,168,226,1202
604,2017-11-9,Indiana Pacers,12,2880,500,1052,0.475,114,300,0.38,386,752,0.513,198,259,0.764,113,394,507,277,93,164,244,1312
605,2017-11-9,Toronto Raptors,10,2400,398,843,0.472,99,307,0.322,299,536,0.558,194,249,0.779,90,323,413,219,86,138,230,1089
606,2017-11-9,Minnesota Timberwolves,11,2665,438,937,0.467,93,254,0.366,345,683,0.505,226,286,0.79,116,353,469,248,97,172,203,1195
607,2017-11-9,Los Angeles Clippers,10,2400,387,855,0.453,105,294,0.357,282,561,0.503,196,259,0.757,126,342,468,202,82,141,208,1075
608,2017-11-9,Philadelphia 76ers,10,2400,401,878,0.457,123,308,0.399,278,570,0.488,148,212,0.698,106,371,477,262,85,176,259,1073
609,2017-11-9,Denver Nuggets,11,2640,441,960,0.459,112,305,0.367,329,655,0.502,178,247,0.721,120,376,496,262,93,167,213,1172
610,2017-11-9,Portland Trail Blazers,11,2665,413,948,0.436,108,278,0.388,305,670,0.455,235,284,0.827,129,399,528,205,78,161,241,1169
611,2017-11-9,New Orleans Pelicans,11,2665,433,949,0.456,113,342,0.33,320,607,0.527,190,252,0.754,105,404,509,265,92,170,235,1169
612,2017-11-9,Phoenix Suns,12,2880,448,1043,0.43,106,310,0.342,342,733,0.467,266,346,0.769,130,424,554,219,85,190,296,1268
613,2017-11-9,Detroit Pistons,11,2640,449,966,0.465,113,308,0.367,336,658,0.511,151,199,0.759,117,347,464,243,100,145,213,1162
614,2017-11-9,Los Angeles Lakers,11,2665,450,960,0.469,79,260,0.304,371,700,0.53,182,250,0.728,95,414,509,247,91,189,247,1161
615,2017-11-9,Milwaukee Bucks,10,2400,400,815,0.491,109,273,0.399,291,542,0.537,145,185,0.784,61,314,375,249,70,143,238,1054
616,2017-11-9,New York Knicks,11,2640,447,934,0.479,90,265,0.34,357,669,0.534,175,227,0.771,120,372,492,258,79,180,236,1159
617,2017-11-9,Charlotte Hornets,11,2640,417,936,0.446,110,301,0.365,307,635,0.483,210,304,0.691,113,415,528,214,64,150,214,1154
618,2017-11-9,Boston Celtics,12,2880,448,1019,0.44,133,369,0.36,315,650,0.485,217,285,0.761,130,440,570,276,103,158,244,1246
619,2017-11-9,Miami Heat,11,2665,428,933,0.459,120,345,0.348,308,588,0.524,162,209,0.775,91,383,474,232,88,182,248,1138
620,2017-11-9,Atlanta Hawks,11,2640,417,948,0.44,111,289,0.384,306,659,0.464,189,233,0.811,96,365,461,232,94,167,240,1134
621,2017-11-9,Oklahoma City Thunder,10,2400,386,870,0.444,110,324,0.34,276,546,0.505,143,195,0.733,103,318,421,216,106,143,215,1025
622,2017-11-9,San Antonio Spurs,11,2640,425,956,0.445,91,249,0.365,334,707,0.472,178,239,0.745,133,374,507,250,89,151,190,1119
623,2017-11-9,Memphis Grizzlies,11,2640,393,886,0.444,110,325,0.338,283,561,0.504,220,280,0.786,81,357,438,213,87,138,249,1116
624,2017-11-9,Dallas Mavericks,12,2880,430,1013,0.424,144,389,0.37,286,624,0.458,186,246,0.756,108,384,492,248,82,175,232,1190
625,2017-11-9,Utah Jazz,11,2665,394,908,0.434,112,319,0.351,282,589,0.479,190,230,0.826,97,353,450,220,109,180,226,1090
626,2017-11-9,Chicago Bulls,9,2185,314,776,0.405,95,290,0.328,219,486,0.451,126,161,0.783,96,336,432,196,60,135,163,849
627,2017-11-9,Sacramento Kings,10,2400,372,846,0.44,75,211,0.355,297,635,0.468,119,157,0.758,90,312,402,195,77,151,204,938
628,2017-11-10,Golden State Warriors,12,2880,529,1025,0.516,165,403,0.409,364,622,0.585,206,253,0.814,111,429,540,372,101,199,258,1429
629,2017-11-10,Brooklyn Nets,11,2640,433,1002,0.432,120,362,0.331,313,640,0.489,245,327,0.749,119,383,502,236,100,178,246,1231
630,2017-11-10,Washington Wizards,11,2665,442,952,0.464,108,289,0.374,334,663,0.504,233,302,0.772,110,364,474,253,91,161,248,1225
631,2017-11-10,Houston Rockets,12,2880,455,994,0.458,182,536,0.34,273,458,0.596,234,290,0.807,111,415,526,263,105,189,257,1326
632,2017-11-10,Cleveland Cavaliers,12,2880,481,1000,0.481,123,350,0.351,358,650,0.551,237,290,0.817,105,384,489,261,77,186,243,1322
633,2017-11-10,Toronto Raptors,11,2640,443,941,0.471,115,349,0.33,328,592,0.554,210,272,0.772,100,361,461,246,94,150,254,1211
634,2017-11-10,Orlando Magic,11,2640,450,950,0.474,131,323,0.406,319,627,0.509,171,221,0.774,88,373,461,274,94,168,226,1202
635,2017-11-10,Indiana Pacers,12,2880,500,1052,0.475,114,300,0.38,386,752,0.513,198,259,0.764,113,394,507,277,93,164,244,1312
636,2017-11-10,Minnesota Timberwolves,11,2665,438,937,0.467,93,254,0.366,345,683,0.505,226,286,0.79,116,353,469,248,97,172,203,1195
637,2017-11-10,Los Angeles Clippers,10,2400,387,855,0.453,105,294,0.357,282,561,0.503,196,259,0.757,126,342,468,202,82,141,208,1075
638,2017-11-10,Philadelphia 76ers,11,2640,438,965,0.454,138,345,0.4,300,620,0.484,167,239,0.699,119,414,533,285,91,193,287,1181
639,2017-11-10,New Orleans Pelicans,12,2905,477,1031,0.463,126,373,0.338,351,658,0.533,207,277,0.747,109,438,547,296,99,183,255,1287
640,2017-11-10,Portland Trail Blazers,11,2665,413,948,0.436,108,278,0.388,305,670,0.455,235,284,0.827,129,399,528,205,78,161,241,1169
641,2017-11-10,Denver Nuggets,12,2880,479,1042,0.46,121,332,0.364,358,710,0.504,195,269,0.725,134,407,541,289,100,185,228,1274
642,2017-11-10,Phoenix Suns,12,2880,448,1043,0.43,106,310,0.342,342,733,0.467,266,346,0.769,130,424,554,219,85,190,296,1268
643,2017-11-10,Detroit Pistons,11,2640,449,966,0.465,113,308,0.367,336,658,0.511,151,199,0.759,117,347,464,243,100,145,213,1162
644,2017-11-10,Milwaukee Bucks,10,2400,400,815,0.491,109,273,0.399,291,542,0.537,145,185,0.784,61,314,375,249,70,143,238,1054
645,2017-11-10,New York Knicks,11,2640,447,934,0.479,90,265,0.34,357,669,0.534,175,227,0.771,120,372,492,258,79,180,236,1159
646,2017-11-10,Charlotte Hornets,11,2640,417,936,0.446,110,301,0.365,307,635,0.483,210,304,0.691,113,415,528,214,64,150,214,1154
647,2017-11-10,Los Angeles Lakers,12,2905,481,1046,0.46,82,283,0.29,399,763,0.523,212,291,0.729,112,443,555,264,100,208,266,1256
648,2017-11-10,Boston Celtics,12,2880,448,1019,0.44,133,369,0.36,315,650,0.485,217,285,0.761,130,440,570,276,103,158,244,1246
649,2017-11-10,Miami Heat,11,2665,428,933,0.459,120,345,0.348,308,588,0.524,162,209,0.775,91,383,474,232,88,182,248,1138
650,2017-11-10,Atlanta Hawks,11,2640,417,948,0.44,111,289,0.384,306,659,0.464,189,233,0.811,96,365,461,232,94,167,240,1134
651,2017-11-10,San Antonio Spurs,11,2640,425,956,0.445,91,249,0.365,334,707,0.472,178,239,0.745,133,374,507,250,89,151,190,1119
652,2017-11-10,Oklahoma City Thunder,11,2640,424,960,0.442,121,354,0.342,303,606,0.5,150,209,0.718,121,344,465,232,121,159,238,1119
653,2017-11-10,Memphis Grizzlies,11,2640,393,886,0.444,110,325,0.338,283,561,0.504,220,280,0.786,81,357,438,213,87,138,249,1116
654,2017-11-10,Dallas Mavericks,12,2880,430,1013,0.424,144,389,0.37,286,624,0.458,186,246,0.756,108,384,492,248,82,175,232,1190
655,2017-11-10,Utah Jazz,11,2665,394,908,0.434,112,319,0.351,282,589,0.479,190,230,0.826,97,353,450,220,109,180,226,1090
656,2017-11-10,Sacramento Kings,11,2640,412,939,0.439,87,238,0.366,325,701,0.464,136,185,0.735,98,349,447,224,83,160,223,1047
657,2017-11-10,Chicago Bulls,9,2185,314,776,0.405,95,290,0.328,219,486,0.451,126,161,0.783,96,336,432,196,60,135,163,849
658,2017-11-11,Golden State Warriors,12,2880,529,1025,0.516,165,403,0.409,364,622,0.585,206,253,0.814,111,429,540,372,101,199,258,1429
659,2017-11-11,Washington Wizards,11,2665,442,952,0.464,108,289,0.374,334,663,0.504,233,302,0.772,110,364,474,253,91,161,248,1225
660,2017-11-11,Brooklyn Nets,12,2880,472,1093,0.432,132,400,0.33,340,693,0.491,256,346,0.74,130,421,551,261,107,188,259,1332
661,2017-11-11,Orlando Magic,12,2880,493,1032,0.478,144,351,0.41,349,681,0.512,200,264,0.758,95,410,505,303,102,186,246,1330
662,2017-11-11,Houston Rockets,12,2880,455,994,0.458,182,536,0.34,273,458,0.596,234,290,0.807,111,415,526,263,105,189,257,1326
663,2017-11-11,Cleveland Cavaliers,12,2880,481,1000,0.481,123,350,0.351,358,650,0.551,237,290,0.817,105,384,489,261,77,186,243,1322
664,2017-11-11,Toronto Raptors,11,2640,443,941,0.471,115,349,0.33,328,592,0.554,210,272,0.772,100,361,461,246,94,150,254,1211
665,2017-11-11,Indiana Pacers,13,3120,543,1136,0.478,126,329,0.383,417,807,0.517,205,271,0.756,120,438,558,304,101,182,261,1417
666,2017-11-11,Minnesota Timberwolves,11,2665,438,937,0.467,93,254,0.366,345,683,0.505,226,286,0.79,116,353,469,248,97,172,203,1195
667,2017-11-11,Los Angeles Clippers,11,2640,426,939,0.454,117,324,0.361,309,615,0.502,217,289,0.751,142,372,514,215,86,159,238,1186
668,2017-11-11,Philadelphia 76ers,11,2640,438,965,0.454,138,345,0.4,300,620,0.484,167,239,0.699,119,414,533,285,91,193,287,1181
669,2017-11-11,New Orleans Pelicans,12,2905,477,1031,0.463,126,373,0.338,351,658,0.533,207,277,0.747,109,438,547,296,99,183,255,1287
670,2017-11-11,Denver Nuggets,12,2880,479,1042,0.46,121,332,0.364,358,710,0.504,195,269,0.725,134,407,541,289,100,185,228,1274
671,2017-11-11,Phoenix Suns,13,3120,492,1137,0.433,111,334,0.332,381,803,0.474,285,371,0.768,142,452,594,232,93,205,325,1380
672,2017-11-11,Detroit Pistons,12,2880,488,1055,0.463,125,338,0.37,363,717,0.506,172,226,0.761,137,378,515,266,107,162,231,1273
673,2017-11-11,Portland Trail Blazers,12,2905,453,1043,0.434,116,301,0.385,337,742,0.454,244,295,0.827,141,438,579,222,82,171,258,1266
674,2017-11-11,New York Knicks,11,2640,447,934,0.479,90,265,0.34,357,669,0.534,175,227,0.771,120,372,492,258,79,180,236,1159
675,2017-11-11,Los Angeles Lakers,12,2905,481,1046,0.46,82,283,0.29,399,763,0.523,212,291,0.729,112,443,555,264,100,208,266,1256
676,2017-11-11,Milwaukee Bucks,11,2640,441,904,0.488,114,291,0.392,327,613,0.533,152,199,0.764,72,350,422,276,80,156,251,1148
677,2017-11-11,Charlotte Hornets,12,2880,448,1016,0.441,116,323,0.359,332,693,0.479,229,337,0.68,120,455,575,234,69,164,235,1241
678,2017-11-11,Oklahoma City Thunder,12,2880,464,1038,0.447,132,380,0.347,332,658,0.505,179,249,0.719,132,373,505,255,129,170,267,1239
679,2017-11-11,Atlanta Hawks,12,2880,461,1037,0.445,119,313,0.38,342,724,0.472,197,244,0.807,107,399,506,260,105,182,261,1238
680,2017-11-11,Boston Celtics,13,3120,478,1103,0.433,142,400,0.355,336,703,0.478,238,310,0.768,139,480,619,291,109,171,270,1336
681,2017-11-11,Miami Heat,12,2905,458,1010,0.453,130,370,0.351,328,640,0.513,176,227,0.775,98,424,522,242,97,201,268,1222
682,2017-11-11,Memphis Grizzlies,11,2640,393,886,0.444,110,325,0.338,283,561,0.504,220,280,0.786,81,357,438,213,87,138,249,1116
683,2017-11-11,San Antonio Spurs,12,2880,459,1036,0.443,100,278,0.36,359,758,0.474,188,250,0.752,142,408,550,273,97,169,205,1206
684,2017-11-11,Dallas Mavericks,12,2880,430,1013,0.424,144,389,0.37,286,624,0.458,186,246,0.756,108,384,492,248,82,175,232,1190
685,2017-11-11,Utah Jazz,12,2905,419,982,0.427,117,340,0.344,302,642,0.47,209,252,0.829,101,389,490,232,119,197,246,1164
686,2017-11-11,Sacramento Kings,11,2640,412,939,0.439,87,238,0.366,325,701,0.464,136,185,0.735,98,349,447,224,83,160,223,1047
687,2017-11-11,Chicago Bulls,10,2425,351,869,0.404,102,317,0.322,249,552,0.451,132,170,0.776,107,368,475,220,70,147,176,936
688,2017-11-12,Golden State Warriors,13,3120,577,1107,0.521,179,430,0.416,398,677,0.588,231,279,0.828,115,464,579,403,116,221,281,1564
689,2017-11-12,Washington Wizards,12,2905,484,1030,0.47,115,313,0.367,369,717,0.515,255,330,0.773,121,395,516,275,105,184,270,1338
690,2017-11-12,Brooklyn Nets,13,3120,507,1169,0.434,139,423,0.329,368,746,0.493,285,385,0.74,140,452,592,274,114,205,281,1438
691,2017-11-12,Orlando Magic,13,3120,534,1119,0.477,155,382,0.406,379,737,0.514,214,284,0.754,103,438,541,327,109,198,265,1437
692,2017-11-12,Houston Rockets,13,3120,492,1077,0.457,198,581,0.341,294,496,0.593,255,318,0.802,122,450,572,281,119,204,276,1437
693,2017-11-12,Cleveland Cavaliers,13,3120,516,1081,0.477,135,381,0.354,381,700,0.544,266,325,0.818,115,427,542,279,85,203,261,1433
694,2017-11-12,Toronto Raptors,11,2640,443,941,0.471,115,349,0.33,328,592,0.554,210,272,0.772,100,361,461,246,94,150,254,1211
695,2017-11-12,Indiana Pacers,13,3120,543,1136,0.478,126,329,0.383,417,807,0.517,205,271,0.756,120,438,558,304,101,182,261,1417
696,2017-11-12,Minnesota Timberwolves,12,2905,477,1033,0.462,97,274,0.354,380,759,0.501,254,321,0.791,135,381,516,264,109,183,224,1305
697,2017-11-12,Philadelphia 76ers,12,2880,482,1059,0.455,150,373,0.402,332,686,0.484,181,259,0.699,132,439,571,315,101,212,306,1295
698,2017-11-12,Denver Nuggets,13,3120,525,1129,0.465,133,361,0.368,392,768,0.51,216,296,0.73,147,444,591,318,109,197,244,1399
699,2017-11-12,New Orleans Pelicans,13,3145,520,1111,0.468,132,389,0.339,388,722,0.537,226,301,0.751,117,481,598,322,106,206,274,1398
700,2017-11-12,Los Angeles Clippers,12,2880,461,1025,0.45,127,350,0.363,334,675,0.495,240,316,0.759,150,401,551,231,98,170,262,1289
701,2017-11-12,Phoenix Suns,14,3360,538,1223,0.44,121,360,0.336,417,863,0.483,301,395,0.762,149,491,640,253,97,223,350,1498
702,2017-11-12,New York Knicks,12,2880,494,1024,0.482,102,292,0.349,392,732,0.536,187,242,0.773,128,404,532,287,85,191,258,1277
703,2017-11-12,Detroit Pistons,12,2880,488,1055,0.463,125,338,0.37,363,717,0.506,172,226,0.761,137,378,515,266,107,162,231,1273
704,2017-11-12,Portland Trail Blazers,12,2905,453,1043,0.434,116,301,0.385,337,742,0.454,244,295,0.827,141,438,579,222,82,171,258,1266
705,2017-11-12,Milwaukee Bucks,12,2880,476,989,0.481,120,314,0.382,356,675,0.527,174,225,0.773,81,383,464,292,91,168,278,1246
706,2017-11-12,Los Angeles Lakers,13,3145,512,1120,0.457,88,305,0.289,424,815,0.52,234,328,0.713,120,483,603,285,107,229,288,1346
707,2017-11-12,Charlotte Hornets,12,2880,448,1016,0.441,116,323,0.359,332,693,0.479,229,337,0.68,120,455,575,234,69,164,235,1241
708,2017-11-12,Oklahoma City Thunder,12,2880,464,1038,0.447,132,380,0.347,332,658,0.505,179,249,0.719,132,373,505,255,129,170,267,1239
709,2017-11-12,San Antonio Spurs,13,3120,510,1121,0.455,118,305,0.387,392,816,0.48,201,266,0.756,150,444,594,306,102,182,221,1339
710,2017-11-12,Boston Celtics,13,3120,478,1103,0.433,142,400,0.355,336,703,0.478,238,310,0.768,139,480,619,291,109,171,270,1336
711,2017-11-12,Atlanta Hawks,13,3120,495,1120,0.442,133,346,0.384,362,774,0.468,209,261,0.801,117,421,538,279,116,206,284,1332
712,2017-11-12,Miami Heat,12,2905,458,1010,0.453,130,370,0.351,328,640,0.513,176,227,0.775,98,424,522,242,97,201,268,1222
713,2017-11-12,Memphis Grizzlies,12,2880,431,965,0.447,116,345,0.336,315,620,0.508,234,298,0.785,86,393,479,236,96,157,269,1212
714,2017-11-12,Dallas Mavericks,13,3120,469,1105,0.424,154,423,0.364,315,682,0.462,202,267,0.757,117,417,534,269,89,185,258,1294
715,2017-11-12,Utah Jazz,13,3145,460,1067,0.431,128,369,0.347,332,698,0.476,230,277,0.83,113,421,534,251,131,213,275,1278
716,2017-11-12,Sacramento Kings,12,2880,442,1019,0.434,94,260,0.362,348,759,0.458,160,215,0.744,109,380,489,243,89,173,241,1138
717,2017-11-12,Chicago Bulls,11,2665,391,955,0.409,108,340,0.318,283,615,0.46,140,183,0.765,112,391,503,242,79,160,191,1030
718,2017-11-13,Golden State Warriors,13,3120,577,1107,0.521,179,430,0.416,398,677,0.588,231,279,0.828,115,464,579,403,116,221,281,1564
719,2017-11-13,Washington Wizards,12,2905,484,1030,0.47,115,313,0.367,369,717,0.515,255,330,0.773,121,395,516,275,105,184,270,1338
720,2017-11-13,Houston Rockets,14,3360,535,1167,0.458,215,628,0.342,320,539,0.594,270,336,0.804,132,487,619,305,129,217,296,1555
721,2017-11-13,Brooklyn Nets,13,3120,507,1169,0.434,139,423,0.329,368,746,0.493,285,385,0.74,140,452,592,274,114,205,281,1438
722,2017-11-13,Orlando Magic,13,3120,534,1119,0.477,155,382,0.406,379,737,0.514,214,284,0.754,103,438,541,327,109,198,265,1437
723,2017-11-13,Cleveland Cavaliers,13,3120,516,1081,0.477,135,381,0.354,381,700,0.544,266,325,0.818,115,427,542,279,85,203,261,1433
724,2017-11-13,Minnesota Timberwolves,12,2905,477,1033,0.462,97,274,0.354,380,759,0.501,254,321,0.791,135,381,516,264,109,183,224,1305
725,2017-11-13,Toronto Raptors,12,2880,475,1010,0.47,125,373,0.335,350,637,0.549,230,295,0.78,106,391,497,264,102,167,274,1305
726,2017-11-13,Indiana Pacers,14,3360,580,1219,0.476,134,351,0.382,446,868,0.514,218,292,0.747,127,472,599,322,106,195,276,1512
727,2017-11-13,Philadelphia 76ers,12,2880,482,1059,0.455,150,373,0.402,332,686,0.484,181,259,0.699,132,439,571,315,101,212,306,1295
728,2017-11-13,Denver Nuggets,13,3120,525,1129,0.465,133,361,0.368,392,768,0.51,216,296,0.73,147,444,591,318,109,197,244,1399
729,2017-11-13,New Orleans Pelicans,13,3145,520,1111,0.468,132,389,0.339,388,722,0.537,226,301,0.751,117,481,598,322,106,206,274,1398
730,2017-11-13,Los Angeles Clippers,12,2880,461,1025,0.45,127,350,0.363,334,675,0.495,240,316,0.759,150,401,551,231,98,170,262,1289
731,2017-11-13,Phoenix Suns,14,3360,538,1223,0.44,121,360,0.336,417,863,0.483,301,395,0.762,149,491,640,253,97,223,350,1498
732,2017-11-13,Detroit Pistons,13,3120,530,1142,0.464,139,366,0.38,391,776,0.504,186,246,0.756,148,421,569,290,109,175,248,1385
733,2017-11-13,New York Knicks,12,2880,494,1024,0.482,102,292,0.349,392,732,0.536,187,242,0.773,128,404,532,287,85,191,258,1277
734,2017-11-13,Portland Trail Blazers,12,2905,453,1043,0.434,116,301,0.385,337,742,0.454,244,295,0.827,141,438,579,222,82,171,258,1266
735,2017-11-13,Oklahoma City Thunder,13,3120,500,1110,0.45,147,412,0.357,353,698,0.506,204,282,0.723,135,407,542,276,139,185,290,1351
736,2017-11-13,Milwaukee Bucks,12,2880,476,989,0.481,120,314,0.382,356,675,0.527,174,225,0.773,81,383,464,292,91,168,278,1246
737,2017-11-13,Los Angeles Lakers,13,3145,512,1120,0.457,88,305,0.289,424,815,0.52,234,328,0.713,120,483,603,285,107,229,288,1346
738,2017-11-13,Charlotte Hornets,12,2880,448,1016,0.441,116,323,0.359,332,693,0.479,229,337,0.68,120,455,575,234,69,164,235,1241
739,2017-11-13,San Antonio Spurs,13,3120,510,1121,0.455,118,305,0.387,392,816,0.48,201,266,0.756,150,444,594,306,102,182,221,1339
740,2017-11-13,Atlanta Hawks,13,3120,495,1120,0.442,133,346,0.384,362,774,0.468,209,261,0.801,117,421,538,279,116,206,284,1332
741,2017-11-13,Boston Celtics,14,3360,513,1190,0.431,152,426,0.357,361,764,0.473,253,329,0.769,154,511,665,315,118,185,288,1431
742,2017-11-13,Miami Heat,13,3145,497,1100,0.452,143,407,0.351,354,693,0.511,188,243,0.774,105,456,561,267,105,210,290,1325
743,2017-11-13,Memphis Grizzlies,12,2880,431,965,0.447,116,345,0.336,315,620,0.508,234,298,0.785,86,393,479,236,96,157,269,1212
744,2017-11-13,Dallas Mavericks,14,3360,506,1192,0.424,165,460,0.359,341,732,0.466,216,285,0.758,128,447,575,287,98,205,278,1393
745,2017-11-13,Utah Jazz,13,3145,460,1067,0.431,128,369,0.347,332,698,0.476,230,277,0.83,113,421,534,251,131,213,275,1278
746,2017-11-13,Sacramento Kings,12,2880,442,1019,0.434,94,260,0.362,348,759,0.458,160,215,0.744,109,380,489,243,89,173,241,1138
747,2017-11-13,Chicago Bulls,11,2665,391,955,0.409,108,340,0.318,283,615,0.46,140,183,0.765,112,391,503,242,79,160,191,1030
748,2017-11-14,Golden State Warriors,14,3360,621,1195,0.52,187,453,0.413,434,742,0.585,245,295,0.831,127,502,629,438,120,237,302,1674
749,2017-11-14,Washington Wizards,13,3145,528,1116,0.473,126,347,0.363,402,769,0.523,266,342,0.778,131,435,566,305,112,195,291,1448
750,2017-11-14,Houston Rockets,14,3360,535,1167,0.458,215,628,0.342,320,539,0.594,270,336,0.804,132,487,619,305,129,217,296,1555
751,2017-11-14,Brooklyn Nets,13,3120,507,1169,0.434,139,423,0.329,368,746,0.493,285,385,0.74,140,452,592,274,114,205,281,1438
752,2017-11-14,Cleveland Cavaliers,14,3360,551,1169,0.471,151,426,0.354,400,743,0.538,284,347,0.818,129,461,590,300,92,223,282,1537
753,2017-11-14,Orlando Magic,14,3360,571,1207,0.473,165,414,0.399,406,793,0.512,230,302,0.762,107,469,576,353,119,209,283,1537
754,2017-11-14,Minnesota Timberwolves,13,3145,514,1104,0.466,107,294,0.364,407,810,0.502,279,350,0.797,140,416,556,286,118,198,237,1414
755,2017-11-14,Toronto Raptors,12,2880,475,1010,0.47,125,373,0.335,350,637,0.549,230,295,0.78,106,391,497,264,102,167,274,1305
756,2017-11-14,Philadelphia 76ers,13,3120,520,1136,0.458,157,405,0.388,363,731,0.497,207,294,0.704,142,480,622,342,110,232,332,1404
757,2017-11-14,Indiana Pacers,14,3360,580,1219,0.476,134,351,0.382,446,868,0.514,218,292,0.747,127,472,599,322,106,195,276,1512
758,2017-11-14,New Orleans Pelicans,14,3385,561,1186,0.473,145,422,0.344,416,764,0.545,237,318,0.745,124,512,636,353,116,225,287,1504
759,2017-11-14,Los Angeles Clippers,13,3120,497,1107,0.449,139,382,0.364,358,725,0.494,261,348,0.75,159,426,585,247,106,185,288,1394
760,2017-11-14,Detroit Pistons,13,3120,530,1142,0.464,139,366,0.38,391,776,0.504,186,246,0.756,148,421,569,290,109,175,248,1385
761,2017-11-14,Phoenix Suns,15,3600,575,1318,0.436,128,386,0.332,447,932,0.48,313,415,0.754,160,534,694,268,103,238,367,1591
762,2017-11-14,New York Knicks,13,3120,532,1112,0.478,110,317,0.347,422,795,0.531,204,264,0.773,141,440,581,306,98,208,279,1378
763,2017-11-14,Denver Nuggets,14,3360,555,1213,0.458,142,393,0.361,413,820,0.504,229,311,0.736,159,467,626,331,118,217,260,1481
764,2017-11-14,Portland Trail Blazers,13,3145,491,1116,0.44,123,322,0.382,368,794,0.463,260,313,0.831,149,473,622,244,94,192,276,1365
765,2017-11-14,Milwaukee Bucks,13,3120,516,1071,0.482,132,336,0.393,384,735,0.522,192,250,0.768,91,409,500,315,97,177,297,1356
766,2017-11-14,Oklahoma City Thunder,13,3120,500,1110,0.45,147,412,0.357,353,698,0.506,204,282,0.723,135,407,542,276,139,185,290,1351
767,2017-11-14,Charlotte Hornets,12,2880,448,1016,0.441,116,323,0.359,332,693,0.479,229,337,0.68,120,455,575,234,69,164,235,1241
768,2017-11-14,Los Angeles Lakers,14,3385,551,1212,0.455,102,338,0.302,449,874,0.514,242,341,0.71,129,527,656,302,113,245,308,1446
769,2017-11-14,San Antonio Spurs,13,3120,510,1121,0.455,118,305,0.387,392,816,0.48,201,266,0.756,150,444,594,306,102,182,221,1339
770,2017-11-14,Atlanta Hawks,14,3360,535,1207,0.443,150,382,0.393,385,825,0.467,217,270,0.804,127,447,574,304,130,222,302,1437
771,2017-11-14,Boston Celtics,14,3360,513,1190,0.431,152,426,0.357,361,764,0.473,253,329,0.769,154,511,665,315,118,185,288,1431
772,2017-11-14,Miami Heat,13,3145,497,1100,0.452,143,407,0.351,354,693,0.511,188,243,0.774,105,456,561,267,105,210,290,1325
773,2017-11-14,Memphis Grizzlies,13,3120,468,1041,0.45,127,371,0.342,341,670,0.509,252,319,0.79,94,422,516,257,101,171,294,1315
774,2017-11-14,Dallas Mavericks,14,3360,506,1192,0.424,165,460,0.359,341,732,0.466,216,285,0.758,128,447,575,287,98,205,278,1393
775,2017-11-14,Utah Jazz,14,3385,497,1151,0.432,142,409,0.347,355,742,0.478,240,288,0.833,121,444,565,274,139,228,298,1376
776,2017-11-14,Sacramento Kings,13,3120,476,1103,0.432,106,283,0.375,370,820,0.451,172,233,0.738,119,405,524,262,97,183,256,1230
777,2017-11-14,Chicago Bulls,11,2665,391,955,0.409,108,340,0.318,283,615,0.46,140,183,0.765,112,391,503,242,79,160,191,1030
778,2017-11-15,Golden State Warriors,14,3360,621,1195,0.52,187,453,0.413,434,742,0.585,245,295,0.831,127,502,629,438,120,237,302,1674
779,2017-11-15,Washington Wizards,13,3145,528,1116,0.473,126,347,0.363,402,769,0.523,266,342,0.778,131,435,566,305,112,195,291,1448
780,2017-11-15,Houston Rockets,15,3600,568,1246,0.456,227,667,0.34,341,579,0.589,305,377,0.809,146,521,667,326,133,236,323,1668
781,2017-11-15,Toronto Raptors,13,3120,516,1088,0.474,139,403,0.345,377,685,0.55,263,337,0.78,111,422,533,292,113,179,304,1434
782,2017-11-15,Brooklyn Nets,14,3360,546,1257,0.434,153,458,0.334,393,799,0.492,295,401,0.736,149,486,635,300,118,219,305,1540
783,2017-11-15,Cleveland Cavaliers,14,3360,551,1169,0.471,151,426,0.354,400,743,0.538,284,347,0.818,129,461,590,300,92,223,282,1537
784,2017-11-15,Orlando Magic,14,3360,571,1207,0.473,165,414,0.399,406,793,0.512,230,302,0.762,107,469,576,353,119,209,283,1537
785,2017-11-15,Minnesota Timberwolves,13,3145,514,1104,0.466,107,294,0.364,407,810,0.502,279,350,0.797,140,416,556,286,118,198,237,1414
786,2017-11-15,Philadelphia 76ers,13,3120,520,1136,0.458,157,405,0.388,363,731,0.497,207,294,0.704,142,480,622,342,110,232,332,1404
787,2017-11-15,Indiana Pacers,14,3360,580,1219,0.476,134,351,0.382,446,868,0.514,218,292,0.747,127,472,599,322,106,195,276,1512
788,2017-11-15,New Orleans Pelicans,14,3385,561,1186,0.473,145,422,0.344,416,764,0.545,237,318,0.745,124,512,636,353,116,225,287,1504
789,2017-11-15,Los Angeles Clippers,13,3120,497,1107,0.449,139,382,0.364,358,725,0.494,261,348,0.75,159,426,585,247,106,185,288,1394
790,2017-11-15,Detroit Pistons,13,3120,530,1142,0.464,139,366,0.38,391,776,0.504,186,246,0.756,148,421,569,290,109,175,248,1385
791,2017-11-15,Phoenix Suns,15,3600,575,1318,0.436,128,386,0.332,447,932,0.48,313,415,0.754,160,534,694,268,103,238,367,1591
792,2017-11-15,New York Knicks,13,3120,532,1112,0.478,110,317,0.347,422,795,0.531,204,264,0.773,141,440,581,306,98,208,279,1378
793,2017-11-15,Denver Nuggets,14,3360,555,1213,0.458,142,393,0.361,413,820,0.504,229,311,0.736,159,467,626,331,118,217,260,1481
794,2017-11-15,Portland Trail Blazers,13,3145,491,1116,0.44,123,322,0.382,368,794,0.463,260,313,0.831,149,473,622,244,94,192,276,1365
795,2017-11-15,Milwaukee Bucks,13,3120,516,1071,0.482,132,336,0.393,384,735,0.522,192,250,0.768,91,409,500,315,97,177,297,1356
796,2017-11-15,Oklahoma City Thunder,13,3120,500,1110,0.45,147,412,0.357,353,698,0.506,204,282,0.723,135,407,542,276,139,185,290,1351
797,2017-11-15,Charlotte Hornets,12,2880,448,1016,0.441,116,323,0.359,332,693,0.479,229,337,0.68,120,455,575,234,69,164,235,1241
798,2017-11-15,Los Angeles Lakers,14,3385,551,1212,0.455,102,338,0.302,449,874,0.514,242,341,0.71,129,527,656,302,113,245,308,1446
799,2017-11-15,Boston Celtics,15,3600,552,1276,0.433,161,453,0.355,391,823,0.475,275,356,0.772,163,551,714,330,126,199,302,1540
800,2017-11-15,Atlanta Hawks,14,3360,535,1207,0.443,150,382,0.393,385,825,0.467,217,270,0.804,127,447,574,304,130,222,302,1437
801,2017-11-15,San Antonio Spurs,14,3360,545,1200,0.454,124,331,0.375,421,869,0.484,222,293,0.758,158,483,641,324,111,194,237,1436
802,2017-11-15,Miami Heat,13,3145,497,1100,0.452,143,407,0.351,354,693,0.511,188,243,0.774,105,456,561,267,105,210,290,1325
803,2017-11-15,Memphis Grizzlies,13,3120,468,1041,0.45,127,371,0.342,341,670,0.509,252,319,0.79,94,422,516,257,101,171,294,1315
804,2017-11-15,Dallas Mavericks,15,3600,539,1273,0.423,175,494,0.354,364,779,0.467,231,303,0.762,133,482,615,305,105,220,301,1484
805,2017-11-15,Utah Jazz,14,3385,497,1151,0.432,142,409,0.347,355,742,0.478,240,288,0.833,121,444,565,274,139,228,298,1376
806,2017-11-15,Sacramento Kings,13,3120,476,1103,0.432,106,283,0.375,370,820,0.451,172,233,0.738,119,405,524,262,97,183,256,1230
807,2017-11-15,Chicago Bulls,11,2665,391,955,0.409,108,340,0.318,283,615,0.46,140,183,0.765,112,391,503,242,79,160,191,1030
808,2017-11-16,Golden State Warriors,14,3360,621,1195,0.52,187,453,0.413,434,742,0.585,245,295,0.831,127,502,629,438,120,237,302,1674
809,2017-11-16,Toronto Raptors,14,3360,561,1164,0.482,155,437,0.355,406,727,0.558,282,357,0.79,117,453,570,319,121,200,324,1559
810,2017-11-16,Houston Rockets,15,3600,568,1246,0.456,227,667,0.34,341,579,0.589,305,377,0.809,146,521,667,326,133,236,323,1668
811,2017-11-16,Washington Wizards,14,3385,560,1194,0.469,135,366,0.369,425,828,0.513,295,373,0.791,142,464,606,314,120,207,310,1550
812,2017-11-16,Cleveland Cavaliers,15,3600,593,1264,0.469,164,464,0.353,429,800,0.536,302,367,0.823,145,496,641,325,101,236,306,1652
813,2017-11-16,Brooklyn Nets,14,3360,546,1257,0.434,153,458,0.334,393,799,0.492,295,401,0.736,149,486,635,300,118,219,305,1540
814,2017-11-16,Orlando Magic,15,3600,608,1286,0.473,176,443,0.397,432,843,0.512,239,311,0.768,114,503,617,372,125,224,299,1631
815,2017-11-16,Philadelphia 76ers,14,3360,562,1222,0.46,164,437,0.375,398,785,0.507,231,324,0.713,150,524,674,369,117,248,351,1519
816,2017-11-16,Indiana Pacers,15,3600,623,1304,0.478,146,375,0.389,477,929,0.513,236,312,0.756,132,503,635,351,112,207,293,1628
817,2017-11-16,New Orleans Pelicans,15,3625,607,1277,0.475,155,449,0.345,452,828,0.546,251,332,0.756,134,534,668,384,129,239,308,1620
818,2017-11-16,Minnesota Timberwolves,14,3385,553,1191,0.464,116,312,0.372,437,879,0.497,290,366,0.792,151,446,597,313,127,204,253,1512
819,2017-11-16,Los Angeles Clippers,13,3120,497,1107,0.449,139,382,0.364,358,725,0.494,261,348,0.75,159,426,585,247,106,185,288,1394
820,2017-11-16,Phoenix Suns,15,3600,575,1318,0.436,128,386,0.332,447,932,0.48,313,415,0.754,160,534,694,268,103,238,367,1591
821,2017-11-16,New York Knicks,14,3360,570,1193,0.478,119,338,0.352,451,855,0.527,225,289,0.779,153,473,626,324,102,219,298,1484
822,2017-11-16,Denver Nuggets,14,3360,555,1213,0.458,142,393,0.361,413,820,0.504,229,311,0.736,159,467,626,331,118,217,260,1481
823,2017-11-16,Detroit Pistons,14,3360,560,1227,0.456,154,403,0.382,406,824,0.493,206,269,0.766,165,449,614,313,116,191,268,1480
824,2017-11-16,Portland Trail Blazers,14,3385,529,1203,0.44,137,349,0.393,392,854,0.459,269,326,0.825,159,504,663,265,101,204,286,1464
825,2017-11-16,Atlanta Hawks,15,3600,585,1286,0.455,166,414,0.401,419,872,0.481,227,286,0.794,136,491,627,344,139,240,325,1563
826,2017-11-16,Milwaukee Bucks,14,3360,554,1149,0.482,140,358,0.391,414,791,0.523,207,271,0.764,102,441,543,339,107,192,316,1455
827,2017-11-16,Los Angeles Lakers,15,3625,593,1321,0.449,105,365,0.288,488,956,0.51,264,368,0.717,151,562,713,320,120,254,331,1555
828,2017-11-16,Charlotte Hornets,13,3120,489,1102,0.444,122,349,0.35,367,753,0.487,248,365,0.679,128,488,616,255,76,177,254,1348
829,2017-11-16,Oklahoma City Thunder,14,3360,526,1182,0.445,155,442,0.351,371,740,0.501,236,319,0.74,146,444,590,291,146,198,309,1443
830,2017-11-16,Boston Celtics,15,3600,552,1276,0.433,161,453,0.355,391,823,0.475,275,356,0.772,163,551,714,330,126,199,302,1540
831,2017-11-16,Memphis Grizzlies,14,3360,512,1127,0.454,135,403,0.335,377,724,0.521,269,341,0.789,105,454,559,286,106,185,313,1428
832,2017-11-16,San Antonio Spurs,15,3600,578,1279,0.452,131,355,0.369,447,924,0.484,235,308,0.763,171,515,686,344,115,210,255,1522
833,2017-11-16,Miami Heat,14,3385,529,1178,0.449,156,437,0.357,373,741,0.503,204,262,0.779,117,486,603,282,108,227,310,1418
834,2017-11-16,Dallas Mavericks,15,3600,539,1273,0.423,175,494,0.354,364,779,0.467,231,303,0.762,133,482,615,305,105,220,301,1484
835,2017-11-16,Utah Jazz,15,3625,531,1230,0.432,159,444,0.358,372,786,0.473,256,305,0.839,130,472,602,293,144,241,321,1477
836,2017-11-16,Sacramento Kings,14,3360,507,1191,0.426,112,311,0.36,395,880,0.449,184,253,0.727,130,423,553,280,109,195,275,1310
837,2017-11-16,Chicago Bulls,12,2905,417,1030,0.405,119,369,0.322,298,661,0.451,156,203,0.768,118,423,541,258,86,173,218,1109
838,2017-11-17,Golden State Warriors,15,3600,654,1277,0.512,197,485,0.406,457,792,0.577,257,314,0.818,134,542,676,460,129,252,326,1762
839,2017-11-17,Houston Rockets,16,3840,611,1336,0.457,248,711,0.349,363,625,0.581,340,415,0.819,158,560,718,353,142,250,343,1810
840,2017-11-17,Toronto Raptors,14,3360,561,1164,0.482,155,437,0.355,406,727,0.558,282,357,0.79,117,453,570,319,121,200,324,1559
841,2017-11-17,Washington Wizards,14,3385,560,1194,0.469,135,366,0.369,425,828,0.513,295,373,0.791,142,464,606,314,120,207,310,1550
842,2017-11-17,Cleveland Cavaliers,15,3600,593,1264,0.469,164,464,0.353,429,800,0.536,302,367,0.823,145,496,641,325,101,236,306,1652
843,2017-11-17,Brooklyn Nets,14,3360,546,1257,0.434,153,458,0.334,393,799,0.492,295,401,0.736,149,486,635,300,118,219,305,1540
844,2017-11-17,Orlando Magic,15,3600,608,1286,0.473,176,443,0.397,432,843,0.512,239,311,0.768,114,503,617,372,125,224,299,1631
845,2017-11-17,Philadelphia 76ers,14,3360,562,1222,0.46,164,437,0.375,398,785,0.507,231,324,0.713,150,524,674,369,117,248,351,1519
846,2017-11-17,Indiana Pacers,15,3600,623,1304,0.478,146,375,0.389,477,929,0.513,236,312,0.756,132,503,635,351,112,207,293,1628
847,2017-11-17,New Orleans Pelicans,15,3625,607,1277,0.475,155,449,0.345,452,828,0.546,251,332,0.756,134,534,668,384,129,239,308,1620
848,2017-11-17,Minnesota Timberwolves,14,3385,553,1191,0.464,116,312,0.372,437,879,0.497,290,366,0.792,151,446,597,313,127,204,253,1512
849,2017-11-17,Los Angeles Clippers,13,3120,497,1107,0.449,139,382,0.364,358,725,0.494,261,348,0.75,159,426,585,247,106,185,288,1394
850,2017-11-17,Phoenix Suns,16,3840,622,1422,0.437,138,416,0.332,484,1006,0.481,325,436,0.745,176,565,741,296,112,252,389,1707
851,2017-11-17,New York Knicks,14,3360,570,1193,0.478,119,338,0.352,451,855,0.527,225,289,0.779,153,473,626,324,102,219,298,1484
852,2017-11-17,Denver Nuggets,14,3360,555,1213,0.458,142,393,0.361,413,820,0.504,229,311,0.736,159,467,626,331,118,217,260,1481
853,2017-11-17,Detroit Pistons,14,3360,560,1227,0.456,154,403,0.382,406,824,0.493,206,269,0.766,165,449,614,313,116,191,268,1480
854,2017-11-17,Portland Trail Blazers,14,3385,529,1203,0.44,137,349,0.393,392,854,0.459,269,326,0.825,159,504,663,265,101,204,286,1464
855,2017-11-17,Atlanta Hawks,15,3600,585,1286,0.455,166,414,0.401,419,872,0.481,227,286,0.794,136,491,627,344,139,240,325,1563
856,2017-11-17,Milwaukee Bucks,14,3360,554,1149,0.482,140,358,0.391,414,791,0.523,207,271,0.764,102,441,543,339,107,192,316,1455
857,2017-11-17,Los Angeles Lakers,15,3625,593,1321,0.449,105,365,0.288,488,956,0.51,264,368,0.717,151,562,713,320,120,254,331,1555
858,2017-11-17,Charlotte Hornets,13,3120,489,1102,0.444,122,349,0.35,367,753,0.487,248,365,0.679,128,488,616,255,76,177,254,1348
859,2017-11-17,Oklahoma City Thunder,14,3360,526,1182,0.445,155,442,0.351,371,740,0.501,236,319,0.74,146,444,590,291,146,198,309,1443
860,2017-11-17,Boston Celtics,16,3840,578,1355,0.427,168,485,0.346,410,870,0.471,308,394,0.782,170,596,766,345,134,214,317,1632
861,2017-11-17,Memphis Grizzlies,14,3360,512,1127,0.454,135,403,0.335,377,724,0.521,269,341,0.789,105,454,559,286,106,185,313,1428
862,2017-11-17,San Antonio Spurs,15,3600,578,1279,0.452,131,355,0.369,447,924,0.484,235,308,0.763,171,515,686,344,115,210,255,1522
863,2017-11-17,Miami Heat,14,3385,529,1178,0.449,156,437,0.357,373,741,0.503,204,262,0.779,117,486,603,282,108,227,310,1418
864,2017-11-17,Dallas Mavericks,15,3600,539,1273,0.423,175,494,0.354,364,779,0.467,231,303,0.762,133,482,615,305,105,220,301,1484
865,2017-11-17,Utah Jazz,15,3625,531,1230,0.432,159,444,0.358,372,786,0.473,256,305,0.839,130,472,602,293,144,241,321,1477
866,2017-11-17,Sacramento Kings,14,3360,507,1191,0.426,112,311,0.36,395,880,0.449,184,253,0.727,130,423,553,280,109,195,275,1310
867,2017-11-17,Chicago Bulls,12,2905,417,1030,0.405,119,369,0.322,298,661,0.451,156,203,0.768,118,423,541,258,86,173,218,1109
868,2017-11-18,Golden State Warriors,15,3600,654,1277,0.512,197,485,0.406,457,792,0.577,257,314,0.818,134,542,676,460,129,252,326,1762
869,2017-11-18,Houston Rockets,16,3840,611,1336,0.457,248,711,0.349,363,625,0.581,340,415,0.819,158,560,718,353,142,250,343,1810
870,2017-11-18,Toronto Raptors,15,3600,605,1242,0.487,164,463,0.354,441,779,0.566,292,368,0.793,120,490,610,348,125,212,343,1666
871,2017-11-18,Cleveland Cavaliers,16,3865,635,1354,0.469,175,497,0.352,460,857,0.537,325,396,0.821,153,539,692,349,110,251,326,1770
872,2017-11-18,Brooklyn Nets,15,3600,589,1341,0.439,170,495,0.343,419,846,0.495,310,421,0.736,153,518,671,327,126,231,326,1658
873,2017-11-18,Washington Wizards,15,3625,592,1278,0.463,145,401,0.362,447,877,0.51,309,389,0.794,149,503,652,332,124,219,327,1638
874,2017-11-18,Orlando Magic,15,3600,608,1286,0.473,176,443,0.397,432,843,0.512,239,311,0.768,114,503,617,372,125,224,299,1631
875,2017-11-18,Denver Nuggets,15,3600,611,1302,0.469,160,428,0.374,451,874,0.516,245,332,0.738,172,502,674,368,123,231,275,1627
876,2017-11-18,Philadelphia 76ers,14,3360,562,1222,0.46,164,437,0.375,398,785,0.507,231,324,0.713,150,524,674,369,117,248,351,1519
877,2017-11-18,New Orleans Pelicans,16,3865,655,1368,0.479,167,482,0.346,488,886,0.551,257,342,0.751,142,555,697,416,131,252,327,1734
878,2017-11-18,Indiana Pacers,16,3840,662,1393,0.475,161,403,0.4,501,990,0.506,250,333,0.751,145,541,686,373,116,217,306,1735
879,2017-11-18,Minnesota Timberwolves,15,3625,592,1275,0.464,129,342,0.377,463,933,0.496,310,389,0.797,162,483,645,340,134,214,271,1623
880,2017-11-18,Phoenix Suns,17,4080,670,1525,0.439,151,448,0.337,519,1077,0.482,338,455,0.743,185,600,785,324,122,265,411,1829
881,2017-11-18,Los Angeles Clippers,14,3385,543,1210,0.449,149,417,0.357,394,793,0.497,272,362,0.751,172,468,640,276,113,200,314,1507
882,2017-11-18,Detroit Pistons,15,3600,599,1320,0.454,168,436,0.385,431,884,0.488,214,279,0.767,176,481,657,333,120,202,286,1580
883,2017-11-18,Charlotte Hornets,14,3360,531,1183,0.449,132,370,0.357,399,813,0.491,274,399,0.687,133,525,658,274,79,189,269,1468
884,2017-11-18,New York Knicks,15,3600,600,1284,0.467,128,361,0.355,472,923,0.511,240,306,0.784,167,502,669,341,109,228,310,1568
885,2017-11-18,Los Angeles Lakers,16,3865,638,1412,0.452,112,390,0.287,526,1022,0.515,280,392,0.714,160,602,762,346,127,273,351,1668
886,2017-11-18,Atlanta Hawks,15,3600,585,1286,0.455,166,414,0.401,419,872,0.481,227,286,0.794,136,491,627,344,139,240,325,1563
887,2017-11-18,Milwaukee Bucks,14,3360,554,1149,0.482,140,358,0.391,414,791,0.523,207,271,0.764,102,441,543,339,107,192,316,1455
888,2017-11-18,Portland Trail Blazers,15,3625,559,1284,0.435,144,374,0.385,415,910,0.456,284,342,0.83,170,537,707,278,109,221,306,1546
889,2017-11-18,Oklahoma City Thunder,15,3600,565,1271,0.445,164,465,0.353,401,806,0.498,250,340,0.735,159,472,631,315,153,206,331,1544
890,2017-11-18,Boston Celtics,16,3840,578,1355,0.427,168,485,0.346,410,870,0.471,308,394,0.782,170,596,766,345,134,214,317,1632
891,2017-11-18,Memphis Grizzlies,14,3360,512,1127,0.454,135,403,0.335,377,724,0.521,269,341,0.789,105,454,559,286,106,185,313,1428
892,2017-11-18,San Antonio Spurs,16,3840,612,1356,0.451,145,390,0.372,467,966,0.483,257,336,0.765,183,547,730,367,121,223,273,1626
893,2017-11-18,Miami Heat,15,3625,563,1261,0.446,166,472,0.352,397,789,0.503,217,280,0.775,127,528,655,303,114,242,329,1509
894,2017-11-18,Utah Jazz,16,3865,570,1309,0.435,171,470,0.364,399,839,0.476,273,329,0.83,140,501,641,314,150,257,340,1584
895,2017-11-18,Dallas Mavericks,16,3840,571,1359,0.42,183,532,0.344,388,827,0.469,246,320,0.769,144,512,656,323,108,231,321,1571
896,2017-11-18,Chicago Bulls,13,3145,464,1121,0.414,136,403,0.337,328,718,0.457,168,216,0.778,122,454,576,284,95,184,241,1232
897,2017-11-18,Sacramento Kings,15,3600,543,1276,0.426,116,325,0.357,427,951,0.449,194,268,0.724,142,454,596,300,120,208,297,1396
898,2017-11-19,Golden State Warriors,16,3840,704,1368,0.515,204,508,0.402,500,860,0.581,274,334,0.82,145,579,724,485,134,264,344,1886
899,2017-11-19,Houston Rockets,17,4080,646,1414,0.457,266,754,0.353,380,660,0.576,357,436,0.819,167,596,763,374,150,266,367,1915
900,2017-11-19,Toronto Raptors,15,3600,605,1242,0.487,164,463,0.354,441,779,0.566,292,368,0.793,120,490,610,348,125,212,343,1666
901,2017-11-19,Cleveland Cavaliers,16,3865,635,1354,0.469,175,497,0.352,460,857,0.537,325,396,0.821,153,539,692,349,110,251,326,1770
902,2017-11-19,Brooklyn Nets,15,3600,589,1341,0.439,170,495,0.343,419,846,0.495,310,421,0.736,153,518,671,327,126,231,326,1658
903,2017-11-19,Washington Wizards,15,3625,592,1278,0.463,145,401,0.362,447,877,0.51,309,389,0.794,149,503,652,332,124,219,327,1638
904,2017-11-19,Philadelphia 76ers,15,3600,609,1319,0.462,174,466,0.373,435,853,0.51,243,340,0.715,161,553,714,397,125,259,373,1635
905,2017-11-19,Denver Nuggets,15,3600,611,1302,0.469,160,428,0.374,451,874,0.516,245,332,0.738,172,502,674,368,123,231,275,1627
906,2017-11-19,New Orleans Pelicans,16,3865,655,1368,0.479,167,482,0.346,488,886,0.551,257,342,0.751,142,555,697,416,131,252,327,1734
907,2017-11-19,Indiana Pacers,16,3840,662,1393,0.475,161,403,0.4,501,990,0.506,250,333,0.751,145,541,686,373,116,217,306,1735
908,2017-11-19,Minnesota Timberwolves,15,3625,592,1275,0.464,129,342,0.377,463,933,0.496,310,389,0.797,162,483,645,340,134,214,271,1623
909,2017-11-19,Phoenix Suns,17,4080,670,1525,0.439,151,448,0.337,519,1077,0.482,338,455,0.743,185,600,785,324,122,265,411,1829
910,2017-11-19,Orlando Magic,16,3840,639,1367,0.467,184,472,0.39,455,895,0.508,254,334,0.76,125,538,663,385,135,240,319,1716
911,2017-11-19,Los Angeles Clippers,15,3625,576,1293,0.445,157,446,0.352,419,847,0.495,285,381,0.748,179,505,684,294,118,214,336,1594
912,2017-11-19,Detroit Pistons,15,3600,599,1320,0.454,168,436,0.385,431,884,0.488,214,279,0.767,176,481,657,333,120,202,286,1580
913,2017-11-19,Charlotte Hornets,15,3600,565,1270,0.445,143,396,0.361,422,874,0.483,297,428,0.694,141,566,707,294,86,197,285,1570
914,2017-11-19,New York Knicks,15,3600,600,1284,0.467,128,361,0.355,472,923,0.511,240,306,0.784,167,502,669,341,109,228,310,1568
915,2017-11-19,Los Angeles Lakers,16,3865,638,1412,0.452,112,390,0.287,526,1022,0.515,280,392,0.714,160,602,762,346,127,273,351,1668
916,2017-11-19,Atlanta Hawks,16,3840,622,1364,0.456,175,438,0.4,447,926,0.483,243,306,0.794,142,520,662,368,146,253,344,1662
917,2017-11-19,Portland Trail Blazers,16,3865,597,1354,0.441,154,395,0.39,443,959,0.462,300,363,0.826,175,576,751,297,115,238,328,1648
918,2017-11-19,Oklahoma City Thunder,15,3600,565,1271,0.445,164,465,0.353,401,806,0.498,250,340,0.735,159,472,631,315,153,206,331,1544
919,2017-11-19,Boston Celtics,17,4080,617,1437,0.429,184,519,0.355,433,918,0.472,324,414,0.783,179,628,807,366,143,229,339,1742
920,2017-11-19,Milwaukee Bucks,15,3600,582,1223,0.476,146,383,0.381,436,840,0.519,224,302,0.742,110,471,581,352,115,204,341,1534
921,2017-11-19,San Antonio Spurs,16,3840,612,1356,0.451,145,390,0.372,467,966,0.483,257,336,0.765,183,547,730,367,121,223,273,1626
922,2017-11-19,Memphis Grizzlies,15,3600,543,1213,0.448,142,430,0.33,401,783,0.512,283,360,0.786,120,487,607,304,112,197,331,1511
923,2017-11-19,Miami Heat,15,3625,563,1261,0.446,166,472,0.352,397,789,0.503,217,280,0.775,127,528,655,303,114,242,329,1509
924,2017-11-19,Utah Jazz,17,4105,617,1407,0.439,185,504,0.367,432,903,0.478,290,347,0.836,154,541,695,345,160,267,359,1709
925,2017-11-19,Dallas Mavericks,17,4080,609,1438,0.424,202,570,0.354,407,868,0.469,262,339,0.773,151,554,705,350,115,247,347,1682
926,2017-11-19,Chicago Bulls,13,3145,464,1121,0.414,136,403,0.337,328,718,0.457,168,216,0.778,122,454,576,284,95,184,241,1232
927,2017-11-19,Sacramento Kings,16,3840,577,1365,0.423,124,342,0.363,453,1023,0.443,208,286,0.727,151,481,632,314,129,219,321,1486
928,2017-11-20,Golden State Warriors,17,4080,750,1458,0.514,214,532,0.402,536,926,0.579,290,357,0.812,151,630,781,514,142,279,371,2004
929,2017-11-20,Houston Rockets,17,4080,646,1414,0.457,266,754,0.353,380,660,0.576,357,436,0.819,167,596,763,374,150,266,367,1915
930,2017-11-20,Cleveland Cavaliers,16,3865,635,1354,0.469,175,497,0.352,460,857,0.537,325,396,0.821,153,539,692,349,110,251,326,1770
931,2017-11-20,Brooklyn Nets,16,3840,623,1436,0.434,186,543,0.343,437,893,0.489,337,460,0.733,166,557,723,351,133,244,347,1769
932,2017-11-20,Toronto Raptors,16,3840,645,1332,0.484,174,502,0.347,471,830,0.567,302,382,0.791,131,527,658,368,133,219,362,1766
933,2017-11-20,Indiana Pacers,17,4080,713,1478,0.482,172,426,0.404,541,1052,0.514,257,341,0.754,154,574,728,406,125,229,320,1855
934,2017-11-20,Philadelphia 76ers,15,3600,609,1319,0.462,174,466,0.373,435,853,0.51,243,340,0.715,161,553,714,397,125,259,373,1635
935,2017-11-20,Denver Nuggets,16,3840,647,1386,0.467,173,459,0.377,474,927,0.511,269,367,0.733,189,532,721,386,131,251,290,1736
936,2017-11-20,New Orleans Pelicans,16,3865,655,1368,0.479,167,482,0.346,488,886,0.551,257,342,0.751,142,555,697,416,131,252,327,1734
937,2017-11-20,Washington Wizards,16,3865,626,1359,0.461,156,420,0.371,470,939,0.501,321,410,0.783,157,538,695,352,129,233,339,1729
938,2017-11-20,Phoenix Suns,18,4320,715,1614,0.443,158,475,0.333,557,1139,0.489,354,477,0.742,194,639,833,356,127,277,427,1942
939,2017-11-20,Minnesota Timberwolves,16,3865,632,1353,0.467,134,364,0.368,498,989,0.504,322,407,0.791,168,515,683,363,145,234,291,1720
940,2017-11-20,Orlando Magic,16,3840,639,1367,0.467,184,472,0.39,455,895,0.508,254,334,0.76,125,538,663,385,135,240,319,1716
941,2017-11-20,Los Angeles Clippers,15,3625,576,1293,0.445,157,446,0.352,419,847,0.495,285,381,0.748,179,505,684,294,118,214,336,1594
942,2017-11-20,Los Angeles Lakers,17,4105,691,1512,0.457,124,422,0.294,567,1090,0.52,289,408,0.708,173,635,808,382,138,288,378,1795
943,2017-11-20,Detroit Pistons,16,3840,638,1403,0.455,176,461,0.382,462,942,0.49,228,299,0.763,187,507,694,358,130,221,307,1680
944,2017-11-20,Charlotte Hornets,15,3600,565,1270,0.445,143,396,0.361,422,874,0.483,297,428,0.694,141,566,707,294,86,197,285,1570
945,2017-11-20,New York Knicks,15,3600,600,1284,0.467,128,361,0.355,472,923,0.511,240,306,0.784,167,502,669,341,109,228,310,1568
946,2017-11-20,Atlanta Hawks,16,3840,622,1364,0.456,175,438,0.4,447,926,0.483,243,306,0.794,142,520,662,368,146,253,344,1662
947,2017-11-20,Portland Trail Blazers,16,3865,597,1354,0.441,154,395,0.39,443,959,0.462,300,363,0.826,175,576,751,297,115,238,328,1648
948,2017-11-20,Oklahoma City Thunder,15,3600,565,1271,0.445,164,465,0.353,401,806,0.498,250,340,0.735,159,472,631,315,153,206,331,1544
949,2017-11-20,Boston Celtics,17,4080,617,1437,0.429,184,519,0.355,433,918,0.472,324,414,0.783,179,628,807,366,143,229,339,1742
950,2017-11-20,Milwaukee Bucks,15,3600,582,1223,0.476,146,383,0.381,436,840,0.519,224,302,0.742,110,471,581,352,115,204,341,1534
951,2017-11-20,San Antonio Spurs,16,3840,612,1356,0.451,145,390,0.372,467,966,0.483,257,336,0.765,183,547,730,367,121,223,273,1626
952,2017-11-20,Memphis Grizzlies,15,3600,543,1213,0.448,142,430,0.33,401,783,0.512,283,360,0.786,120,487,607,304,112,197,331,1511
953,2017-11-20,Utah Jazz,17,4105,617,1407,0.439,185,504,0.367,432,903,0.478,290,347,0.836,154,541,695,345,160,267,359,1709
954,2017-11-20,Miami Heat,16,3865,598,1344,0.445,179,509,0.352,419,835,0.502,229,294,0.779,137,553,690,324,122,256,340,1604
955,2017-11-20,Dallas Mavericks,17,4080,609,1438,0.424,202,570,0.354,407,868,0.469,262,339,0.773,151,554,705,350,115,247,347,1682
956,2017-11-20,Chicago Bulls,14,3385,506,1222,0.414,148,439,0.337,358,783,0.457,177,230,0.77,134,489,623,304,100,195,262,1337
957,2017-11-20,Sacramento Kings,16,3840,577,1365,0.423,124,342,0.363,453,1023,0.443,208,286,0.727,151,481,632,314,129,219,321,1486
958,2017-11-21,Golden State Warriors,17,4080,750,1458,0.514,214,532,0.402,536,926,0.579,290,357,0.812,151,630,781,514,142,279,371,2004
959,2017-11-21,Houston Rockets,17,4080,646,1414,0.457,266,754,0.353,380,660,0.576,357,436,0.819,167,596,763,374,150,266,367,1915
960,2017-11-21,Cleveland Cavaliers,17,4105,677,1434,0.472,191,530,0.36,486,904,0.538,341,413,0.826,160,574,734,377,114,262,340,1886
961,2017-11-21,Brooklyn Nets,16,3840,623,1436,0.434,186,543,0.343,437,893,0.489,337,460,0.733,166,557,723,351,133,244,347,1769
962,2017-11-21,Toronto Raptors,16,3840,645,1332,0.484,174,502,0.347,471,830,0.567,302,382,0.791,131,527,658,368,133,219,362,1766
963,2017-11-21,Philadelphia 76ers,16,3840,653,1404,0.465,178,481,0.37,475,923,0.515,258,362,0.713,170,599,769,417,136,278,391,1742
964,2017-11-21,Indiana Pacers,18,4320,750,1567,0.479,180,446,0.404,570,1121,0.508,280,370,0.757,162,614,776,431,142,241,345,1960
965,2017-11-21,Denver Nuggets,17,4080,689,1472,0.468,188,491,0.383,501,981,0.511,284,387,0.734,203,567,770,404,137,264,303,1850
966,2017-11-21,New Orleans Pelicans,17,4105,696,1448,0.481,174,507,0.343,522,941,0.555,282,374,0.754,149,597,746,442,139,271,349,1848
967,2017-11-21,Phoenix Suns,18,4320,715,1614,0.443,158,475,0.333,557,1139,0.489,354,477,0.742,194,639,833,356,127,277,427,1942
968,2017-11-21,Washington Wizards,17,4105,665,1433,0.464,165,444,0.372,500,989,0.506,333,427,0.78,165,576,741,375,133,249,357,1828
969,2017-11-21,Minnesota Timberwolves,17,4105,669,1443,0.464,140,391,0.358,529,1052,0.503,344,433,0.794,178,543,721,376,153,244,312,1822
970,2017-11-21,Orlando Magic,17,4080,674,1451,0.465,197,510,0.386,477,941,0.507,268,357,0.751,136,577,713,408,141,262,339,1813
971,2017-11-21,Los Angeles Lakers,17,4105,691,1512,0.457,124,422,0.294,567,1090,0.52,289,408,0.708,173,635,808,382,138,288,378,1795
972,2017-11-21,Charlotte Hornets,16,3840,607,1355,0.448,154,422,0.365,453,933,0.486,320,457,0.7,152,607,759,316,91,214,303,1688
973,2017-11-21,Los Angeles Clippers,16,3865,606,1373,0.441,167,478,0.349,439,895,0.491,300,402,0.746,189,531,720,314,130,235,359,1679
974,2017-11-21,New York Knicks,16,3840,635,1365,0.465,141,395,0.357,494,970,0.509,264,331,0.798,181,539,720,365,120,250,336,1675
975,2017-11-21,Detroit Pistons,17,4080,672,1480,0.454,189,491,0.385,483,989,0.488,235,312,0.753,194,534,728,381,137,235,326,1768
976,2017-11-21,Oklahoma City Thunder,16,3840,603,1360,0.443,175,500,0.35,428,860,0.498,270,366,0.738,168,503,671,337,167,220,356,1651
977,2017-11-21,Boston Celtics,18,4345,655,1521,0.431,197,555,0.355,458,966,0.474,345,440,0.784,184,676,860,390,151,246,363,1852
978,2017-11-21,Atlanta Hawks,17,4080,659,1449,0.455,183,468,0.391,476,981,0.485,246,314,0.783,151,549,700,389,153,268,359,1747
979,2017-11-21,Portland Trail Blazers,17,4105,630,1437,0.438,160,410,0.39,470,1027,0.458,328,395,0.83,190,621,811,308,116,253,351,1748
980,2017-11-21,Milwaukee Bucks,16,3840,617,1302,0.474,150,405,0.37,467,897,0.521,238,321,0.741,116,498,614,369,125,213,360,1622
981,2017-11-21,San Antonio Spurs,17,4080,652,1445,0.451,155,421,0.368,497,1024,0.485,263,342,0.769,197,585,782,396,128,241,290,1722
982,2017-11-21,Miami Heat,16,3865,598,1344,0.445,179,509,0.352,419,835,0.502,229,294,0.779,137,553,690,324,122,256,340,1604
983,2017-11-21,Memphis Grizzlies,16,3840,576,1299,0.443,150,460,0.326,426,839,0.508,301,383,0.786,125,517,642,327,118,205,357,1603
984,2017-11-21,Utah Jazz,18,4345,647,1492,0.434,194,532,0.365,453,960,0.472,307,366,0.839,161,568,729,363,176,281,378,1795
985,2017-11-21,Dallas Mavericks,18,4345,648,1534,0.422,209,603,0.347,439,931,0.472,279,359,0.777,159,591,750,368,122,258,369,1784
986,2017-11-21,Chicago Bulls,14,3385,506,1222,0.414,148,439,0.337,358,783,0.457,177,230,0.77,134,489,623,304,100,195,262,1337
987,2017-11-21,Sacramento Kings,17,4080,618,1451,0.426,132,362,0.365,486,1089,0.446,216,295,0.732,156,510,666,332,140,231,340,1584
988,2017-11-22,Golden State Warriors,17,4080,750,1458,0.514,214,532,0.402,536,926,0.579,290,357,0.812,151,630,781,514,142,279,371,2004
989,2017-11-22,Houston Rockets,17,4080,646,1414,0.457,266,754,0.353,380,660,0.576,357,436,0.819,167,596,763,374,150,266,367,1915
990,2017-11-22,Cleveland Cavaliers,17,4105,677,1434,0.472,191,530,0.36,486,904,0.538,341,413,0.826,160,574,734,377,114,262,340,1886
991,2017-11-22,Brooklyn Nets,16,3840,623,1436,0.434,186,543,0.343,437,893,0.489,337,460,0.733,166,557,723,351,133,244,347,1769
992,2017-11-22,Toronto Raptors,16,3840,645,1332,0.484,174,502,0.347,471,830,0.567,302,382,0.791,131,527,658,368,133,219,362,1766
993,2017-11-22,Philadelphia 76ers,16,3840,653,1404,0.465,178,481,0.37,475,923,0.515,258,362,0.713,170,599,769,417,136,278,391,1742
994,2017-11-22,Indiana Pacers,18,4320,750,1567,0.479,180,446,0.404,570,1121,0.508,280,370,0.757,162,614,776,431,142,241,345,1960
995,2017-11-22,Denver Nuggets,17,4080,689,1472,0.468,188,491,0.383,501,981,0.511,284,387,0.734,203,567,770,404,137,264,303,1850
996,2017-11-22,New Orleans Pelicans,17,4105,696,1448,0.481,174,507,0.343,522,941,0.555,282,374,0.754,149,597,746,442,139,271,349,1848
997,2017-11-22,Phoenix Suns,18,4320,715,1614,0.443,158,475,0.333,557,1139,0.489,354,477,0.742,194,639,833,356,127,277,427,1942
998,2017-11-22,Washington Wizards,17,4105,665,1433,0.464,165,444,0.372,500,989,0.506,333,427,0.78,165,576,741,375,133,249,357,1828
999,2017-11-22,Minnesota Timberwolves,17,4105,669,1443,0.464,140,391,0.358,529,1052,0.503,344,433,0.794,178,543,721,376,153,244,312,1822
1000,2017-11-22,Orlando Magic,17,4080,674,1451,0.465,197,510,0.386,477,941,0.507,268,357,0.751,136,577,713,408,141,262,339,1813
1001,2017-11-22,Charlotte Hornets,16,3840,607,1355,0.448,154,422,0.365,453,933,0.486,320,457,0.7,152,607,759,316,91,214,303,1688
1002,2017-11-22,Los Angeles Lakers,18,4345,727,1602,0.454,137,462,0.297,590,1140,0.518,307,433,0.709,185,676,861,405,145,300,394,1898
1003,2017-11-22,Los Angeles Clippers,16,3865,606,1373,0.441,167,478,0.349,439,895,0.491,300,402,0.746,189,531,720,314,130,235,359,1679
1004,2017-11-22,New York Knicks,16,3840,635,1365,0.465,141,395,0.357,494,970,0.509,264,331,0.798,181,539,720,365,120,250,336,1675
1005,2017-11-22,Detroit Pistons,17,4080,672,1480,0.454,189,491,0.385,483,989,0.488,235,312,0.753,194,534,728,381,137,235,326,1768
1006,2017-11-22,Oklahoma City Thunder,16,3840,603,1360,0.443,175,500,0.35,428,860,0.498,270,366,0.738,168,503,671,337,167,220,356,1651
1007,2017-11-22,Boston Celtics,18,4345,655,1521,0.431,197,555,0.355,458,966,0.474,345,440,0.784,184,676,860,390,151,246,363,1852
1008,2017-11-22,Atlanta Hawks,17,4080,659,1449,0.455,183,468,0.391,476,981,0.485,246,314,0.783,151,549,700,389,153,268,359,1747
1009,2017-11-22,Portland Trail Blazers,17,4105,630,1437,0.438,160,410,0.39,470,1027,0.458,328,395,0.83,190,621,811,308,116,253,351,1748
1010,2017-11-22,Milwaukee Bucks,16,3840,617,1302,0.474,150,405,0.37,467,897,0.521,238,321,0.741,116,498,614,369,125,213,360,1622
1011,2017-11-22,San Antonio Spurs,17,4080,652,1445,0.451,155,421,0.368,497,1024,0.485,263,342,0.769,197,585,782,396,128,241,290,1722
1012,2017-11-22,Miami Heat,16,3865,598,1344,0.445,179,509,0.352,419,835,0.502,229,294,0.779,137,553,690,324,122,256,340,1604
1013,2017-11-22,Memphis Grizzlies,16,3840,576,1299,0.443,150,460,0.326,426,839,0.508,301,383,0.786,125,517,642,327,118,205,357,1603
1014,2017-11-22,Utah Jazz,18,4345,647,1492,0.434,194,532,0.365,453,960,0.472,307,366,0.839,161,568,729,363,176,281,378,1795
1015,2017-11-22,Dallas Mavericks,18,4345,648,1534,0.422,209,603,0.347,439,931,0.472,279,359,0.777,159,591,750,368,122,258,369,1784
1016,2017-11-22,Chicago Bulls,15,3625,542,1316,0.412,159,475,0.335,383,841,0.455,188,246,0.764,149,528,677,326,104,209,281,1431
1017,2017-11-22,Sacramento Kings,17,4080,618,1451,0.426,132,362,0.365,486,1089,0.446,216,295,0.732,156,510,666,332,140,231,340,1584
1018,2017-11-23,Golden State Warriors,18,4320,783,1538,0.509,224,563,0.398,559,975,0.573,305,375,0.813,158,662,820,536,153,301,391,2095
1019,2017-11-23,Houston Rockets,18,4320,691,1496,0.462,284,795,0.357,407,701,0.581,374,459,0.815,175,634,809,404,163,284,389,2040
1020,2017-11-23,Cleveland Cavaliers,18,4345,720,1516,0.475,205,564,0.363,515,952,0.541,360,440,0.818,164,603,767,398,122,272,359,2005
1021,2017-11-23,Brooklyn Nets,17,4080,665,1517,0.438,200,580,0.345,465,937,0.496,348,476,0.731,174,591,765,377,138,263,368,1878
1022,2017-11-23,Toronto Raptors,17,4080,682,1419,0.481,188,540,0.348,494,879,0.562,314,400,0.785,143,557,700,389,137,234,385,1866
1023,2017-11-23,Indiana Pacers,18,4320,750,1567,0.479,180,446,0.404,570,1121,0.508,280,370,0.757,162,614,776,431,142,241,345,1960
1024,2017-11-23,New Orleans Pelicans,18,4345,735,1529,0.481,181,531,0.341,554,998,0.555,304,398,0.764,156,635,791,465,146,286,367,1955
1025,2017-11-23,Washington Wizards,18,4370,713,1532,0.465,176,477,0.369,537,1055,0.509,350,449,0.78,174,610,784,400,137,261,386,1952
1026,2017-11-23,Philadelphia 76ers,17,4080,692,1494,0.463,189,513,0.368,503,981,0.513,270,379,0.712,181,645,826,440,148,296,412,1843
1027,2017-11-23,Denver Nuggets,18,4320,724,1559,0.464,198,524,0.378,526,1035,0.508,299,410,0.729,218,595,813,423,148,283,317,1945
1028,2017-11-23,Minnesota Timberwolves,18,4345,709,1530,0.463,148,414,0.357,561,1116,0.503,380,478,0.795,188,575,763,398,162,251,329,1946
1029,2017-11-23,Phoenix Suns,19,4585,752,1707,0.441,165,497,0.332,587,1210,0.485,380,510,0.745,216,677,893,371,134,306,453,2049
1030,2017-11-23,Orlando Magic,18,4320,720,1542,0.467,209,547,0.382,511,995,0.514,282,379,0.744,143,614,757,436,145,276,370,1931
1031,2017-11-23,Charlotte Hornets,17,4105,650,1446,0.45,164,450,0.364,486,996,0.488,353,497,0.71,166,641,807,339,96,225,323,1817
1032,2017-11-23,Los Angeles Clippers,17,4105,650,1449,0.449,182,508,0.358,468,941,0.497,313,421,0.743,195,558,753,344,137,250,374,1795
1033,2017-11-23,Los Angeles Lakers,19,4585,766,1680,0.456,152,491,0.31,614,1189,0.516,316,448,0.705,189,703,892,432,153,317,413,2000
1034,2017-11-23,New York Knicks,17,4080,678,1458,0.465,149,419,0.356,529,1039,0.509,278,348,0.799,194,573,767,394,128,261,355,1783
1035,2017-11-23,Detroit Pistons,17,4080,672,1480,0.454,189,491,0.385,483,989,0.488,235,312,0.753,194,534,728,381,137,235,326,1768
1036,2017-11-23,Oklahoma City Thunder,17,4080,644,1450,0.444,183,525,0.349,461,925,0.498,288,392,0.735,181,540,721,353,182,236,377,1759
1037,2017-11-23,Atlanta Hawks,18,4320,699,1532,0.456,193,497,0.388,506,1035,0.489,259,329,0.787,160,576,736,415,163,283,379,1850
1038,2017-11-23,Boston Celtics,19,4585,690,1605,0.43,206,581,0.355,484,1024,0.473,364,467,0.779,191,706,897,409,162,257,382,1950
1039,2017-11-23,Milwaukee Bucks,17,4105,659,1399,0.471,158,434,0.364,501,965,0.519,259,352,0.736,129,527,656,388,141,227,390,1735
1040,2017-11-23,Portland Trail Blazers,18,4345,660,1526,0.433,167,436,0.383,493,1090,0.452,342,419,0.816,201,658,859,322,124,270,368,1829
1041,2017-11-23,San Antonio Spurs,18,4320,687,1533,0.448,161,445,0.362,526,1088,0.483,277,357,0.776,205,616,821,418,138,256,313,1812
1042,2017-11-23,Miami Heat,17,4105,638,1425,0.448,189,537,0.352,449,888,0.506,243,310,0.784,144,594,738,344,125,272,362,1708
1043,2017-11-23,Utah Jazz,19,4585,687,1578,0.435,208,567,0.367,479,1011,0.474,323,385,0.839,169,605,774,386,186,288,393,1905
1044,2017-11-23,Memphis Grizzlies,17,4080,613,1380,0.444,157,489,0.321,456,891,0.512,314,397,0.791,131,563,694,352,125,222,382,1697
1045,2017-11-23,Dallas Mavericks,19,4585,687,1625,0.423,218,631,0.345,469,994,0.472,287,375,0.765,163,627,790,391,131,266,383,1879
1046,2017-11-23,Chicago Bulls,16,3865,571,1394,0.41,164,496,0.331,407,898,0.453,205,266,0.771,157,563,720,341,107,225,302,1511
1047,2017-11-23,Sacramento Kings,18,4320,665,1536,0.433,142,383,0.371,523,1153,0.454,225,309,0.728,166,544,710,358,149,248,360,1697
1048,2017-11-24,Golden State Warriors,18,4320,783,1538,0.509,224,563,0.398,559,975,0.573,305,375,0.813,158,662,820,536,153,301,391,2095
1049,2017-11-24,Houston Rockets,18,4320,691,1496,0.462,284,795,0.357,407,701,0.581,374,459,0.815,175,634,809,404,163,284,389,2040
1050,2017-11-24,Cleveland Cavaliers,18,4345,720,1516,0.475,205,564,0.363,515,952,0.541,360,440,0.818,164,603,767,398,122,272,359,2005
1051,2017-11-24,Brooklyn Nets,17,4080,665,1517,0.438,200,580,0.345,465,937,0.496,348,476,0.731,174,591,765,377,138,263,368,1878
1052,2017-11-24,Toronto Raptors,17,4080,682,1419,0.481,188,540,0.348,494,879,0.562,314,400,0.785,143,557,700,389,137,234,385,1866
1053,2017-11-24,Indiana Pacers,18,4320,750,1567,0.479,180,446,0.404,570,1121,0.508,280,370,0.757,162,614,776,431,142,241,345,1960
1054,2017-11-24,New Orleans Pelicans,18,4345,735,1529,0.481,181,531,0.341,554,998,0.555,304,398,0.764,156,635,791,465,146,286,367,1955
1055,2017-11-24,Washington Wizards,18,4370,713,1532,0.465,176,477,0.369,537,1055,0.509,350,449,0.78,174,610,784,400,137,261,386,1952
1056,2017-11-24,Philadelphia 76ers,17,4080,692,1494,0.463,189,513,0.368,503,981,0.513,270,379,0.712,181,645,826,440,148,296,412,1843
1057,2017-11-24,Denver Nuggets,18,4320,724,1559,0.464,198,524,0.378,526,1035,0.508,299,410,0.729,218,595,813,423,148,283,317,1945
1058,2017-11-24,Minnesota Timberwolves,18,4345,709,1530,0.463,148,414,0.357,561,1116,0.503,380,478,0.795,188,575,763,398,162,251,329,1946
1059,2017-11-24,Phoenix Suns,19,4585,752,1707,0.441,165,497,0.332,587,1210,0.485,380,510,0.745,216,677,893,371,134,306,453,2049
1060,2017-11-24,Orlando Magic,18,4320,720,1542,0.467,209,547,0.382,511,995,0.514,282,379,0.744,143,614,757,436,145,276,370,1931
1061,2017-11-24,Charlotte Hornets,17,4105,650,1446,0.45,164,450,0.364,486,996,0.488,353,497,0.71,166,641,807,339,96,225,323,1817
1062,2017-11-24,Los Angeles Clippers,17,4105,650,1449,0.449,182,508,0.358,468,941,0.497,313,421,0.743,195,558,753,344,137,250,374,1795
1063,2017-11-24,Los Angeles Lakers,19,4585,766,1680,0.456,152,491,0.31,614,1189,0.516,316,448,0.705,189,703,892,432,153,317,413,2000
1064,2017-11-24,New York Knicks,17,4080,678,1458,0.465,149,419,0.356,529,1039,0.509,278,348,0.799,194,573,767,394,128,261,355,1783
1065,2017-11-24,Detroit Pistons,17,4080,672,1480,0.454,189,491,0.385,483,989,0.488,235,312,0.753,194,534,728,381,137,235,326,1768
1066,2017-11-24,Oklahoma City Thunder,17,4080,644,1450,0.444,183,525,0.349,461,925,0.498,288,392,0.735,181,540,721,353,182,236,377,1759
1067,2017-11-24,Atlanta Hawks,18,4320,699,1532,0.456,193,497,0.388,506,1035,0.489,259,329,0.787,160,576,736,415,163,283,379,1850
1068,2017-11-24,Boston Celtics,19,4585,690,1605,0.43,206,581,0.355,484,1024,0.473,364,467,0.779,191,706,897,409,162,257,382,1950
1069,2017-11-24,Milwaukee Bucks,17,4105,659,1399,0.471,158,434,0.364,501,965,0.519,259,352,0.736,129,527,656,388,141,227,390,1735
1070,2017-11-24,Portland Trail Blazers,18,4345,660,1526,0.433,167,436,0.383,493,1090,0.452,342,419,0.816,201,658,859,322,124,270,368,1829
1071,2017-11-24,San Antonio Spurs,18,4320,687,1533,0.448,161,445,0.362,526,1088,0.483,277,357,0.776,205,616,821,418,138,256,313,1812
1072,2017-11-24,Miami Heat,17,4105,638,1425,0.448,189,537,0.352,449,888,0.506,243,310,0.784,144,594,738,344,125,272,362,1708
1073,2017-11-24,Utah Jazz,19,4585,687,1578,0.435,208,567,0.367,479,1011,0.474,323,385,0.839,169,605,774,386,186,288,393,1905
1074,2017-11-24,Memphis Grizzlies,17,4080,613,1380,0.444,157,489,0.321,456,891,0.512,314,397,0.791,131,563,694,352,125,222,382,1697
1075,2017-11-24,Dallas Mavericks,19,4585,687,1625,0.423,218,631,0.345,469,994,0.472,287,375,0.765,163,627,790,391,131,266,383,1879
1076,2017-11-24,Chicago Bulls,16,3865,571,1394,0.41,164,496,0.331,407,898,0.453,205,266,0.771,157,563,720,341,107,225,302,1511
1077,2017-11-24,Sacramento Kings,18,4320,665,1536,0.433,142,383,0.371,523,1153,0.454,225,309,0.728,166,544,710,358,149,248,360,1697
1078,2017-11-25,Golden State Warriors,19,4560,836,1629,0.513,240,599,0.401,596,1030,0.579,326,396,0.823,164,705,869,572,164,312,406,2238
1079,2017-11-25,Houston Rockets,18,4320,691,1496,0.462,284,795,0.357,407,701,0.581,374,459,0.815,175,634,809,404,163,284,389,2040
1080,2017-11-25,Brooklyn Nets,18,4320,715,1617,0.442,210,605,0.347,505,1012,0.499,363,497,0.73,187,625,812,402,142,272,390,2003
1081,2017-11-25,Cleveland Cavaliers,19,4585,758,1599,0.474,218,603,0.362,540,996,0.542,371,455,0.815,167,645,812,423,126,284,383,2105
1082,2017-11-25,Toronto Raptors,18,4320,722,1500,0.481,197,570,0.346,525,930,0.565,329,420,0.783,150,592,742,406,151,252,405,1970
1083,2017-11-25,New Orleans Pelicans,19,4585,780,1620,0.481,190,558,0.341,590,1062,0.556,320,420,0.762,169,671,840,494,156,301,385,2070
1084,2017-11-25,Indiana Pacers,19,4560,788,1650,0.478,191,472,0.405,597,1178,0.507,300,397,0.756,172,645,817,450,152,257,363,2067
1085,2017-11-25,Washington Wizards,18,4370,713,1532,0.465,176,477,0.369,537,1055,0.509,350,449,0.78,174,610,784,400,137,261,386,1952
1086,2017-11-25,Philadelphia 76ers,17,4080,692,1494,0.463,189,513,0.368,503,981,0.513,270,379,0.712,181,645,826,440,148,296,412,1843
1087,2017-11-25,Denver Nuggets,19,4560,764,1638,0.466,207,556,0.372,557,1082,0.515,314,436,0.72,233,630,863,447,157,304,335,2049
1088,2017-11-25,Minnesota Timberwolves,19,4585,746,1614,0.462,155,431,0.36,591,1183,0.5,396,504,0.786,201,606,807,419,171,261,345,2043
1089,2017-11-25,Orlando Magic,19,4560,761,1637,0.465,218,571,0.382,543,1066,0.509,294,398,0.739,159,649,808,457,151,288,386,2034
1090,2017-11-25,Phoenix Suns,20,4825,789,1801,0.438,167,517,0.323,622,1284,0.484,395,528,0.748,231,710,941,383,143,322,471,2140
1091,2017-11-25,Charlotte Hornets,18,4345,686,1540,0.445,175,479,0.365,511,1061,0.482,369,524,0.704,181,681,862,364,100,234,340,1916
1092,2017-11-25,Los Angeles Clippers,17,4105,650,1449,0.449,182,508,0.358,468,941,0.497,313,421,0.743,195,558,753,344,137,250,374,1795
1093,2017-11-25,Los Angeles Lakers,19,4585,766,1680,0.456,152,491,0.31,614,1189,0.516,316,448,0.705,189,703,892,432,153,317,413,2000
1094,2017-11-25,New York Knicks,18,4320,718,1537,0.467,161,449,0.359,557,1088,0.512,290,362,0.801,199,606,805,424,129,281,374,1887
1095,2017-11-25,Detroit Pistons,18,4320,711,1564,0.455,203,528,0.384,508,1036,0.49,242,321,0.754,202,569,771,403,143,255,343,1867
1096,2017-11-25,Atlanta Hawks,19,4560,746,1631,0.457,206,528,0.39,540,1103,0.49,268,341,0.786,173,603,776,445,170,292,395,1966
1097,2017-11-25,Boston Celtics,20,4825,732,1696,0.432,223,623,0.358,509,1073,0.474,381,492,0.774,204,739,943,436,168,265,402,2068
1098,2017-11-25,Oklahoma City Thunder,18,4320,686,1548,0.443,191,557,0.343,495,991,0.499,294,400,0.735,194,572,766,375,195,250,389,1857
1099,2017-11-25,Portland Trail Blazers,19,4585,708,1622,0.436,173,451,0.384,535,1171,0.457,367,454,0.808,213,691,904,346,129,277,384,1956
1100,2017-11-25,Milwaukee Bucks,17,4105,659,1399,0.471,158,434,0.364,501,965,0.519,259,352,0.736,129,527,656,388,141,227,390,1735
1101,2017-11-25,Miami Heat,18,4345,676,1505,0.449,208,576,0.361,468,929,0.504,257,326,0.788,153,627,780,373,129,285,386,1817
1102,2017-11-25,San Antonio Spurs,18,4320,687,1533,0.448,161,445,0.362,526,1088,0.483,277,357,0.776,205,616,821,418,138,256,313,1812
1103,2017-11-25,Utah Jazz,19,4585,687,1578,0.435,208,567,0.367,479,1011,0.474,323,385,0.839,169,605,774,386,186,288,393,1905
1104,2017-11-25,Memphis Grizzlies,18,4320,649,1453,0.447,166,513,0.324,483,940,0.514,325,413,0.787,134,583,717,380,135,240,403,1789
1105,2017-11-25,Dallas Mavericks,19,4585,687,1625,0.423,218,631,0.345,469,994,0.472,287,375,0.765,163,627,790,391,131,266,383,1879
1106,2017-11-25,Chicago Bulls,17,4105,606,1493,0.406,177,532,0.333,429,961,0.446,216,281,0.769,170,590,760,359,114,240,319,1605
1107,2017-11-25,Sacramento Kings,18,4320,665,1536,0.433,142,383,0.371,523,1153,0.454,225,309,0.728,166,544,710,358,149,248,360,1697
1108,2017-11-26,Golden State Warriors,20,4800,875,1723,0.508,250,632,0.396,625,1091,0.573,348,423,0.823,175,738,913,602,175,321,430,2348
1109,2017-11-26,Houston Rockets,19,4560,732,1590,0.46,302,842,0.359,430,748,0.575,391,481,0.813,184,667,851,434,175,291,404,2157
1110,2017-11-26,Brooklyn Nets,18,4320,715,1617,0.442,210,605,0.347,505,1012,0.499,363,497,0.73,187,625,812,402,142,272,390,2003
1111,2017-11-26,Cleveland Cavaliers,19,4585,758,1599,0.474,218,603,0.362,540,996,0.542,371,455,0.815,167,645,812,423,126,284,383,2105
1112,2017-11-26,Philadelphia 76ers,18,4320,740,1589,0.466,205,547,0.375,535,1042,0.513,288,399,0.722,192,687,879,475,155,307,434,1973
1113,2017-11-26,Toronto Raptors,19,4560,768,1584,0.485,210,602,0.349,558,982,0.568,336,429,0.783,161,627,788,437,161,268,427,2082
1114,2017-11-26,Washington Wizards,19,4610,754,1621,0.465,184,500,0.368,570,1121,0.508,365,465,0.785,181,640,821,420,146,272,403,2057
1115,2017-11-26,New Orleans Pelicans,20,4825,814,1704,0.478,201,589,0.341,613,1115,0.55,336,443,0.758,178,707,885,518,158,318,409,2165
1116,2017-11-26,Indiana Pacers,20,4800,826,1728,0.478,198,495,0.4,628,1233,0.509,315,412,0.765,182,671,853,470,161,275,377,2165
1117,2017-11-26,Denver Nuggets,19,4560,764,1638,0.466,207,556,0.372,557,1082,0.515,314,436,0.72,233,630,863,447,157,304,335,2049
1118,2017-11-26,Minnesota Timberwolves,19,4585,746,1614,0.462,155,431,0.36,591,1183,0.5,396,504,0.786,201,606,807,419,171,261,345,2043
1119,2017-11-26,Orlando Magic,20,4800,800,1723,0.464,230,602,0.382,570,1121,0.508,315,429,0.734,166,683,849,479,159,297,403,2145
1120,2017-11-26,Phoenix Suns,20,4825,789,1801,0.438,167,517,0.323,622,1284,0.484,395,528,0.748,231,710,941,383,143,322,471,2140
1121,2017-11-26,Charlotte Hornets,19,4585,717,1624,0.442,179,504,0.355,538,1120,0.48,389,550,0.707,195,709,904,384,107,248,359,2002
1122,2017-11-26,Los Angeles Lakers,19,4585,766,1680,0.456,152,491,0.31,614,1189,0.516,316,448,0.705,189,703,892,432,153,317,413,2000
1123,2017-11-26,Los Angeles Clippers,18,4345,688,1529,0.45,191,536,0.356,497,993,0.501,325,434,0.749,201,589,790,367,148,266,387,1892
1124,2017-11-26,New York Knicks,19,4560,760,1622,0.469,165,466,0.354,595,1156,0.515,304,381,0.798,205,640,845,453,133,299,394,1989
1125,2017-11-26,Detroit Pistons,18,4320,711,1564,0.455,203,528,0.384,508,1036,0.49,242,321,0.754,202,569,771,403,143,255,343,1867
1126,2017-11-26,Boston Celtics,21,5065,777,1776,0.438,233,648,0.36,544,1128,0.482,389,501,0.776,208,765,973,458,176,279,415,2176
1127,2017-11-26,Portland Trail Blazers,20,4825,749,1702,0.44,182,475,0.383,567,1227,0.462,384,476,0.807,219,726,945,364,132,293,400,2064
1128,2017-11-26,Milwaukee Bucks,18,4345,700,1476,0.474,166,455,0.365,534,1021,0.523,277,375,0.739,137,559,696,407,146,243,411,1843
1129,2017-11-26,Atlanta Hawks,20,4800,772,1706,0.453,212,555,0.382,560,1151,0.487,288,364,0.791,180,628,808,463,179,310,410,2044
1130,2017-11-26,Oklahoma City Thunder,19,4560,715,1628,0.439,204,592,0.345,511,1036,0.493,304,413,0.736,202,603,805,399,207,267,405,1938
1131,2017-11-26,Utah Jazz,20,4825,733,1659,0.442,226,599,0.377,507,1060,0.478,334,404,0.827,174,630,804,417,194,298,412,2026
1132,2017-11-26,San Antonio Spurs,19,4560,726,1614,0.45,167,470,0.355,559,1144,0.489,299,382,0.783,213,653,866,440,146,267,332,1918
1133,2017-11-26,Miami Heat,18,4345,676,1505,0.449,208,576,0.361,468,929,0.504,257,326,0.788,153,627,780,373,129,285,386,1817
1134,2017-11-26,Memphis Grizzlies,18,4320,649,1453,0.447,166,513,0.324,483,940,0.514,325,413,0.787,134,583,717,380,135,240,403,1789
1135,2017-11-26,Dallas Mavericks,20,4825,724,1700,0.426,233,666,0.35,491,1034,0.475,295,386,0.764,171,662,833,416,142,283,401,1976
1136,2017-11-26,Chicago Bulls,17,4105,606,1493,0.406,177,532,0.333,429,961,0.446,216,281,0.769,170,590,760,359,114,240,319,1605
1137,2017-11-26,Sacramento Kings,19,4560,703,1619,0.434,153,404,0.379,550,1215,0.453,233,318,0.733,174,573,747,377,158,266,377,1792
1138,2017-11-27,Golden State Warriors,20,4800,875,1723,0.508,250,632,0.396,625,1091,0.573,348,423,0.823,175,738,913,602,175,321,430,2348
1139,2017-11-27,Houston Rockets,19,4560,732,1590,0.46,302,842,0.359,430,748,0.575,391,481,0.813,184,667,851,434,175,291,404,2157
1140,2017-11-27,Cleveland Cavaliers,19,4585,758,1599,0.474,218,603,0.362,540,996,0.542,371,455,0.815,167,645,812,423,126,284,383,2105
1141,2017-11-27,Brooklyn Nets,19,4560,748,1691,0.442,223,634,0.352,525,1057,0.497,382,520,0.735,199,656,855,421,149,289,412,2101
1142,2017-11-27,Philadelphia 76ers,18,4320,740,1589,0.466,205,547,0.375,535,1042,0.513,288,399,0.722,192,687,879,475,155,307,434,1973
1143,2017-11-27,Toronto Raptors,19,4560,768,1584,0.485,210,602,0.349,558,982,0.568,336,429,0.783,161,627,788,437,161,268,427,2082
1144,2017-11-27,Washington Wizards,19,4610,754,1621,0.465,184,500,0.368,570,1121,0.508,365,465,0.785,181,640,821,420,146,272,403,2057
1145,2017-11-27,New Orleans Pelicans,20,4825,814,1704,0.478,201,589,0.341,613,1115,0.55,336,443,0.758,178,707,885,518,158,318,409,2165
1146,2017-11-27,Indiana Pacers,20,4800,826,1728,0.478,198,495,0.4,628,1233,0.509,315,412,0.765,182,671,853,470,161,275,377,2165
1147,2017-11-27,Minnesota Timberwolves,20,4825,795,1707,0.466,164,452,0.363,631,1255,0.503,408,521,0.783,220,635,855,443,183,271,359,2162
1148,2017-11-27,Denver Nuggets,19,4560,764,1638,0.466,207,556,0.372,557,1082,0.515,314,436,0.72,233,630,863,447,157,304,335,2049
1149,2017-11-27,Orlando Magic,20,4800,800,1723,0.464,230,602,0.382,570,1121,0.508,315,429,0.734,166,683,849,479,159,297,403,2145
1150,2017-11-27,Phoenix Suns,21,5065,832,1886,0.441,180,543,0.331,652,1343,0.485,404,540,0.748,242,736,978,408,149,337,491,2248
1151,2017-11-27,Charlotte Hornets,19,4585,717,1624,0.442,179,504,0.355,538,1120,0.48,389,550,0.707,195,709,904,384,107,248,359,2002
1152,2017-11-27,Los Angeles Lakers,19,4585,766,1680,0.456,152,491,0.31,614,1189,0.516,316,448,0.705,189,703,892,432,153,317,413,2000
1153,2017-11-27,Los Angeles Clippers,18,4345,688,1529,0.45,191,536,0.356,497,993,0.501,325,434,0.749,201,589,790,367,148,266,387,1892
1154,2017-11-27,New York Knicks,19,4560,760,1622,0.469,165,466,0.354,595,1156,0.515,304,381,0.798,205,640,845,453,133,299,394,1989
1155,2017-11-27,Detroit Pistons,18,4320,711,1564,0.455,203,528,0.384,508,1036,0.49,242,321,0.754,202,569,771,403,143,255,343,1867
1156,2017-11-27,Boston Celtics,21,5065,777,1776,0.438,233,648,0.36,544,1128,0.482,389,501,0.776,208,765,973,458,176,279,415,2176
1157,2017-11-27,Portland Trail Blazers,20,4825,749,1702,0.44,182,475,0.383,567,1227,0.462,384,476,0.807,219,726,945,364,132,293,400,2064
1158,2017-11-27,Milwaukee Bucks,18,4345,700,1476,0.474,166,455,0.365,534,1021,0.523,277,375,0.739,137,559,696,407,146,243,411,1843
1159,2017-11-27,Atlanta Hawks,20,4800,772,1706,0.453,212,555,0.382,560,1151,0.487,288,364,0.791,180,628,808,463,179,310,410,2044
1160,2017-11-27,Oklahoma City Thunder,19,4560,715,1628,0.439,204,592,0.345,511,1036,0.493,304,413,0.736,202,603,805,399,207,267,405,1938
1161,2017-11-27,Utah Jazz,20,4825,733,1659,0.442,226,599,0.377,507,1060,0.478,334,404,0.827,174,630,804,417,194,298,412,2026
1162,2017-11-27,San Antonio Spurs,19,4560,726,1614,0.45,167,470,0.355,559,1144,0.489,299,382,0.783,213,653,866,440,146,267,332,1918
1163,2017-11-27,Miami Heat,19,4585,710,1580,0.449,221,608,0.363,489,972,0.503,276,349,0.791,154,671,825,392,138,297,400,1917
1164,2017-11-27,Dallas Mavericks,20,4825,724,1700,0.426,233,666,0.35,491,1034,0.475,295,386,0.764,171,662,833,416,142,283,401,1976
1165,2017-11-27,Memphis Grizzlies,19,4560,681,1533,0.444,174,538,0.323,507,995,0.51,341,431,0.791,145,607,752,395,143,254,427,1877
1166,2017-11-27,Sacramento Kings,19,4560,703,1619,0.434,153,404,0.379,550,1215,0.453,233,318,0.733,174,573,747,377,158,266,377,1792
1167,2017-11-27,Chicago Bulls,18,4345,639,1582,0.404,191,565,0.338,448,1017,0.441,229,297,0.771,177,630,807,384,124,253,337,1698
1168,2017-11-28,Golden State Warriors,21,5040,915,1803,0.507,266,669,0.398,649,1134,0.572,358,437,0.819,184,765,949,633,184,335,445,2454
1169,2017-11-28,Houston Rockets,20,4800,774,1676,0.462,322,892,0.361,452,784,0.577,404,501,0.806,192,701,893,465,183,306,423,2274
1170,2017-11-28,Cleveland Cavaliers,20,4825,799,1685,0.474,233,640,0.364,566,1045,0.542,387,475,0.815,178,680,858,448,133,295,404,2218
1171,2017-11-28,Brooklyn Nets,20,4800,788,1777,0.443,233,673,0.346,555,1104,0.503,395,537,0.736,205,693,898,445,154,302,431,2204
1172,2017-11-28,Toronto Raptors,19,4560,768,1584,0.485,210,602,0.349,558,982,0.568,336,429,0.783,161,627,788,437,161,268,427,2082
1173,2017-11-28,Indiana Pacers,21,5040,868,1807,0.48,213,521,0.409,655,1286,0.509,337,438,0.769,190,706,896,495,168,289,395,2286
1174,2017-11-28,Philadelphia 76ers,19,4560,776,1685,0.461,208,575,0.362,568,1110,0.512,304,419,0.726,214,718,932,490,161,319,452,2064
1175,2017-11-28,Washington Wizards,19,4610,754,1621,0.465,184,500,0.368,570,1121,0.508,365,465,0.785,181,640,821,420,146,272,403,2057
1176,2017-11-28,New Orleans Pelicans,20,4825,814,1704,0.478,201,589,0.341,613,1115,0.55,336,443,0.758,178,707,885,518,158,318,409,2165
1177,2017-11-28,Minnesota Timberwolves,20,4825,795,1707,0.466,164,452,0.363,631,1255,0.503,408,521,0.783,220,635,855,443,183,271,359,2162
1178,2017-11-28,Denver Nuggets,19,4560,764,1638,0.466,207,556,0.372,557,1082,0.515,314,436,0.72,233,630,863,447,157,304,335,2049
1179,2017-11-28,Orlando Magic,21,5040,840,1815,0.463,246,643,0.383,594,1172,0.507,328,445,0.737,176,708,884,501,163,311,426,2254
1180,2017-11-28,Phoenix Suns,21,5065,832,1886,0.441,180,543,0.331,652,1343,0.485,404,540,0.748,242,736,978,408,149,337,491,2248
1181,2017-11-28,Los Angeles Clippers,19,4585,729,1614,0.452,201,564,0.356,528,1050,0.503,353,464,0.761,211,623,834,386,155,283,409,2012
1182,2017-11-28,Los Angeles Lakers,20,4825,810,1771,0.457,163,521,0.313,647,1250,0.518,332,472,0.703,201,734,935,455,163,333,442,2115
1183,2017-11-28,Charlotte Hornets,19,4585,717,1624,0.442,179,504,0.355,538,1120,0.48,389,550,0.707,195,709,904,384,107,248,359,2002
1184,2017-11-28,Detroit Pistons,19,4560,755,1649,0.458,214,553,0.387,541,1096,0.494,261,344,0.759,210,601,811,429,151,263,362,1985
1185,2017-11-28,New York Knicks,20,4800,795,1710,0.465,170,481,0.353,625,1229,0.509,320,403,0.794,219,677,896,466,136,312,414,2080
1186,2017-11-28,Boston Celtics,22,5305,817,1853,0.441,249,681,0.366,568,1172,0.485,401,522,0.768,213,796,1009,485,178,296,438,2284
1187,2017-11-28,Portland Trail Blazers,21,5065,786,1785,0.44,189,496,0.381,597,1289,0.463,406,502,0.809,224,766,990,382,142,302,422,2167
1188,2017-11-28,Milwaukee Bucks,18,4345,700,1476,0.474,166,455,0.365,534,1021,0.523,277,375,0.739,137,559,696,407,146,243,411,1843
1189,2017-11-28,Atlanta Hawks,20,4800,772,1706,0.453,212,555,0.382,560,1151,0.487,288,364,0.791,180,628,808,463,179,310,410,2044
1190,2017-11-28,Oklahoma City Thunder,19,4560,715,1628,0.439,204,592,0.345,511,1036,0.493,304,413,0.736,202,603,805,399,207,267,405,1938
1191,2017-11-28,San Antonio Spurs,20,4800,769,1696,0.453,177,494,0.358,592,1202,0.493,318,403,0.789,217,692,909,467,153,277,348,2033
1192,2017-11-28,Utah Jazz,20,4825,733,1659,0.442,226,599,0.377,507,1060,0.478,334,404,0.827,174,630,804,417,194,298,412,2026
1193,2017-11-28,Miami Heat,19,4585,710,1580,0.449,221,608,0.363,489,972,0.503,276,349,0.791,154,671,825,392,138,297,400,1917
1194,2017-11-28,Dallas Mavericks,21,5065,765,1785,0.429,247,698,0.354,518,1087,0.477,307,403,0.762,175,698,873,441,149,294,420,2084
1195,2017-11-28,Memphis Grizzlies,19,4560,681,1533,0.444,174,538,0.323,507,995,0.51,341,431,0.791,145,607,752,395,143,254,427,1877
1196,2017-11-28,Sacramento Kings,20,4800,745,1698,0.439,162,421,0.385,583,1277,0.457,250,339,0.737,185,598,783,404,165,279,392,1902
1197,2017-11-28,Chicago Bulls,18,4345,639,1582,0.404,191,565,0.338,448,1017,0.441,229,297,0.771,177,630,807,384,124,253,337,1698
1198,2017-11-29,Golden State Warriors,21,5040,915,1803,0.507,266,669,0.398,649,1134,0.572,358,437,0.819,184,765,949,633,184,335,445,2454
1199,2017-11-29,Houston Rockets,20,4800,774,1676,0.462,322,892,0.361,452,784,0.577,404,501,0.806,192,701,893,465,183,306,423,2274
1200,2017-11-29,Cleveland Cavaliers,21,5065,839,1766,0.475,244,673,0.363,595,1093,0.544,404,498,0.811,183,720,903,469,145,308,421,2326
1201,2017-11-29,Brooklyn Nets,20,4800,788,1777,0.443,233,673,0.346,555,1104,0.503,395,537,0.736,205,693,898,445,154,302,431,2204
1202,2017-11-29,Toronto Raptors,19,4560,768,1584,0.485,210,602,0.349,558,982,0.568,336,429,0.783,161,627,788,437,161,268,427,2082
1203,2017-11-29,Indiana Pacers,21,5040,868,1807,0.48,213,521,0.409,655,1286,0.509,337,438,0.769,190,706,896,495,168,289,395,2286
1204,2017-11-29,Philadelphia 76ers,19,4560,776,1685,0.461,208,575,0.362,568,1110,0.512,304,419,0.726,214,718,932,490,161,319,452,2064
1205,2017-11-29,New Orleans Pelicans,20,4825,814,1704,0.478,201,589,0.341,613,1115,0.55,336,443,0.758,178,707,885,518,158,318,409,2165
1206,2017-11-29,Washington Wizards,20,4850,790,1704,0.464,194,528,0.367,596,1176,0.507,375,482,0.778,190,675,865,443,151,279,419,2149
1207,2017-11-29,Orlando Magic,21,5040,840,1815,0.463,246,643,0.383,594,1172,0.507,328,445,0.737,176,708,884,501,163,311,426,2254
1208,2017-11-29,Minnesota Timberwolves,21,5065,830,1792,0.463,174,482,0.361,656,1310,0.501,417,535,0.779,233,671,904,470,186,281,376,2251
1209,2017-11-29,Phoenix Suns,22,5305,870,1973,0.441,191,573,0.333,679,1400,0.485,421,563,0.748,255,780,1035,433,153,352,503,2352
1210,2017-11-29,Denver Nuggets,20,4800,792,1716,0.462,214,590,0.363,578,1126,0.513,328,452,0.726,245,660,905,460,163,321,348,2126
1211,2017-11-29,Los Angeles Clippers,19,4585,729,1614,0.452,201,564,0.356,528,1050,0.503,353,464,0.761,211,623,834,386,155,283,409,2012
1212,2017-11-29,Los Angeles Lakers,20,4825,810,1771,0.457,163,521,0.313,647,1250,0.518,332,472,0.703,201,734,935,455,163,333,442,2115
1213,2017-11-29,Charlotte Hornets,19,4585,717,1624,0.442,179,504,0.355,538,1120,0.48,389,550,0.707,195,709,904,384,107,248,359,2002
1214,2017-11-29,Detroit Pistons,19,4560,755,1649,0.458,214,553,0.387,541,1096,0.494,261,344,0.759,210,601,811,429,151,263,362,1985
1215,2017-11-29,New York Knicks,20,4800,795,1710,0.465,170,481,0.353,625,1229,0.509,320,403,0.794,219,677,896,466,136,312,414,2080
1216,2017-11-29,Boston Celtics,22,5305,817,1853,0.441,249,681,0.366,568,1172,0.485,401,522,0.768,213,796,1009,485,178,296,438,2284
1217,2017-11-29,Portland Trail Blazers,21,5065,786,1785,0.44,189,496,0.381,597,1289,0.463,406,502,0.809,224,766,990,382,142,302,422,2167
1218,2017-11-29,Milwaukee Bucks,19,4585,742,1547,0.48,175,477,0.367,567,1070,0.53,296,406,0.729,138,596,734,434,159,255,433,1955
1219,2017-11-29,Atlanta Hawks,20,4800,772,1706,0.453,212,555,0.382,560,1151,0.487,288,364,0.791,180,628,808,463,179,310,410,2044
1220,2017-11-29,Oklahoma City Thunder,19,4560,715,1628,0.439,204,592,0.345,511,1036,0.493,304,413,0.736,202,603,805,399,207,267,405,1938
1221,2017-11-29,San Antonio Spurs,20,4800,769,1696,0.453,177,494,0.358,592,1202,0.493,318,403,0.789,217,692,909,467,153,277,348,2033
1222,2017-11-29,Utah Jazz,21,5065,775,1746,0.444,240,631,0.38,535,1115,0.48,342,413,0.828,183,664,847,441,201,309,432,2132
1223,2017-11-29,Miami Heat,20,4825,747,1664,0.449,231,639,0.362,516,1025,0.503,289,369,0.783,162,705,867,416,145,312,419,2014
1224,2017-11-29,Dallas Mavericks,21,5065,765,1785,0.429,247,698,0.354,518,1087,0.477,307,403,0.762,175,698,873,441,149,294,420,2084
1225,2017-11-29,Memphis Grizzlies,19,4560,681,1533,0.444,174,538,0.323,507,995,0.51,341,431,0.791,145,607,752,395,143,254,427,1877
1226,2017-11-29,Sacramento Kings,21,5040,776,1775,0.437,167,438,0.381,609,1337,0.455,270,368,0.734,194,629,823,419,170,295,413,1989
1227,2017-11-29,Chicago Bulls,19,4585,677,1676,0.404,207,605,0.342,470,1071,0.439,236,307,0.769,186,662,848,411,135,262,357,1797
1228,2017-11-30,Golden State Warriors,22,5305,962,1897,0.507,278,699,0.398,684,1198,0.571,379,465,0.815,196,802,998,663,194,357,464,2581
1229,2017-11-30,Houston Rockets,21,5040,816,1762,0.463,340,932,0.365,476,830,0.573,420,522,0.805,202,740,942,491,192,321,433,2392
1230,2017-11-30,Cleveland Cavaliers,21,5065,839,1766,0.475,244,673,0.363,595,1093,0.544,404,498,0.811,183,720,903,469,145,308,421,2326
1231,2017-11-30,Toronto Raptors,20,4800,820,1682,0.488,224,634,0.353,596,1048,0.569,344,440,0.782,172,655,827,461,167,277,450,2208
1232,2017-11-30,Brooklyn Nets,21,5040,830,1867,0.445,244,702,0.348,586,1165,0.503,409,562,0.728,219,731,950,470,159,316,452,2313
1233,2017-11-30,Philadelphia 76ers,20,4800,813,1766,0.46,211,593,0.356,602,1173,0.513,345,483,0.714,235,761,996,513,167,336,479,2182
1234,2017-11-30,Indiana Pacers,22,5280,910,1895,0.48,220,549,0.401,690,1346,0.513,343,444,0.773,196,736,932,513,177,303,412,2383
1235,2017-11-30,Orlando Magic,22,5280,885,1891,0.468,259,673,0.385,626,1218,0.514,346,471,0.735,178,743,921,529,172,324,448,2375
1236,2017-11-30,New Orleans Pelicans,21,5065,853,1788,0.477,215,624,0.345,638,1164,0.548,346,454,0.762,186,727,913,545,166,334,426,2267
1237,2017-11-30,Minnesota Timberwolves,22,5305,877,1873,0.468,183,505,0.362,694,1368,0.507,434,554,0.783,243,705,948,500,196,298,390,2371
1238,2017-11-30,Washington Wizards,21,5090,826,1793,0.461,203,550,0.369,623,1243,0.501,407,519,0.784,197,703,900,465,159,290,461,2262
1239,2017-11-30,Phoenix Suns,23,5545,909,2057,0.442,198,595,0.333,711,1462,0.486,443,591,0.75,263,809,1072,454,164,371,522,2459
1240,2017-11-30,Los Angeles Lakers,21,5090,857,1866,0.459,172,545,0.316,685,1321,0.519,352,497,0.708,208,761,969,485,175,350,465,2238
1241,2017-11-30,Denver Nuggets,20,4800,792,1716,0.462,214,590,0.363,578,1126,0.513,328,452,0.726,245,660,905,460,163,321,348,2126
1242,2017-11-30,Los Angeles Clippers,19,4585,729,1614,0.452,201,564,0.356,528,1050,0.503,353,464,0.761,211,623,834,386,155,283,409,2012
1243,2017-11-30,Detroit Pistons,20,4800,806,1738,0.464,227,581,0.391,579,1157,0.5,277,365,0.759,215,640,855,460,162,282,384,2116
1244,2017-11-30,Charlotte Hornets,20,4825,754,1703,0.443,188,523,0.359,566,1180,0.48,419,585,0.716,202,738,940,410,113,260,376,2115
1245,2017-11-30,New York Knicks,21,5040,839,1783,0.471,175,494,0.354,664,1289,0.515,342,429,0.797,227,721,948,492,146,332,434,2195
1246,2017-11-30,Boston Celtics,22,5305,817,1853,0.441,249,681,0.366,568,1172,0.485,401,522,0.768,213,796,1009,485,178,296,438,2284
1247,2017-11-30,Portland Trail Blazers,21,5065,786,1785,0.44,189,496,0.381,597,1289,0.463,406,502,0.809,224,766,990,382,142,302,422,2167
1248,2017-11-30,Milwaukee Bucks,19,4585,742,1547,0.48,175,477,0.367,567,1070,0.53,296,406,0.729,138,596,734,434,159,255,433,1955
1249,2017-11-30,Oklahoma City Thunder,20,4800,753,1724,0.437,216,624,0.346,537,1100,0.488,324,443,0.731,223,630,853,416,215,280,425,2046
1250,2017-11-30,Atlanta Hawks,20,4800,772,1706,0.453,212,555,0.382,560,1151,0.487,288,364,0.791,180,628,808,463,179,310,410,2044
1251,2017-11-30,San Antonio Spurs,21,5040,807,1771,0.456,185,514,0.36,622,1257,0.495,338,427,0.792,222,719,941,489,162,285,365,2137
1252,2017-11-30,Utah Jazz,21,5065,775,1746,0.444,240,631,0.38,535,1115,0.48,342,413,0.828,183,664,847,441,201,309,432,2132
1253,2017-11-30,Miami Heat,21,5065,779,1748,0.446,241,677,0.356,538,1071,0.502,301,389,0.774,171,727,898,437,158,327,439,2100
1254,2017-11-30,Dallas Mavericks,22,5305,804,1869,0.43,256,725,0.353,548,1144,0.479,324,424,0.764,182,735,917,467,154,305,443,2188
1255,2017-11-30,Memphis Grizzlies,20,4800,716,1610,0.445,185,560,0.33,531,1050,0.506,355,447,0.794,156,633,789,416,147,271,446,1972
1256,2017-11-30,Sacramento Kings,21,5040,776,1775,0.437,167,438,0.381,609,1337,0.455,270,368,0.734,194,629,823,419,170,295,413,1989
1257,2017-11-30,Chicago Bulls,19,4585,677,1676,0.404,207,605,0.342,470,1071,0.439,236,307,0.769,186,662,848,411,135,262,357,1797
1258,2017-12-1,Golden State Warriors,22,5305,962,1897,0.507,278,699,0.398,684,1198,0.571,379,465,0.815,196,802,998,663,194,357,464,2581
1259,2017-12-1,Houston Rockets,21,5040,816,1762,0.463,340,932,0.365,476,830,0.573,420,522,0.805,202,740,942,491,192,321,433,2392
1260,2017-12-1,Cleveland Cavaliers,22,5305,880,1845,0.477,262,712,0.368,618,1133,0.545,425,525,0.81,195,748,943,499,154,327,441,2447
1261,2017-12-1,Toronto Raptors,20,4800,820,1682,0.488,224,634,0.353,596,1048,0.569,344,440,0.782,172,655,827,461,167,277,450,2208
1262,2017-12-1,Brooklyn Nets,21,5040,830,1867,0.445,244,702,0.348,586,1165,0.503,409,562,0.728,219,731,950,470,159,316,452,2313
1263,2017-12-1,Philadelphia 76ers,21,5040,848,1850,0.458,227,625,0.363,621,1225,0.507,356,501,0.711,250,791,1041,537,178,355,501,2279
1264,2017-12-1,Indiana Pacers,22,5280,910,1895,0.48,220,549,0.401,690,1346,0.513,343,444,0.773,196,736,932,513,177,303,412,2383
1265,2017-12-1,Orlando Magic,22,5280,885,1891,0.468,259,673,0.385,626,1218,0.514,346,471,0.735,178,743,921,529,172,324,448,2375
1266,2017-12-1,New Orleans Pelicans,21,5065,853,1788,0.477,215,624,0.345,638,1164,0.548,346,454,0.762,186,727,913,545,166,334,426,2267
1267,2017-12-1,Minnesota Timberwolves,22,5305,877,1873,0.468,183,505,0.362,694,1368,0.507,434,554,0.783,243,705,948,500,196,298,390,2371
1268,2017-12-1,Washington Wizards,21,5090,826,1793,0.461,203,550,0.369,623,1243,0.501,407,519,0.784,197,703,900,465,159,290,461,2262
1269,2017-12-1,Phoenix Suns,23,5545,909,2057,0.442,198,595,0.333,711,1462,0.486,443,591,0.75,263,809,1072,454,164,371,522,2459
1270,2017-12-1,Los Angeles Lakers,21,5090,857,1866,0.459,172,545,0.316,685,1321,0.519,352,497,0.708,208,761,969,485,175,350,465,2238
1271,2017-12-1,Denver Nuggets,21,5040,830,1799,0.461,226,621,0.364,604,1178,0.513,351,483,0.727,256,693,949,482,170,333,367,2237
1272,2017-12-1,Los Angeles Clippers,20,4825,767,1684,0.455,211,593,0.356,556,1091,0.51,374,494,0.757,221,649,870,409,163,302,425,2119
1273,2017-12-1,Detroit Pistons,20,4800,806,1738,0.464,227,581,0.391,579,1157,0.5,277,365,0.759,215,640,855,460,162,282,384,2116
1274,2017-12-1,Charlotte Hornets,20,4825,754,1703,0.443,188,523,0.359,566,1180,0.48,419,585,0.716,202,738,940,410,113,260,376,2115
1275,2017-12-1,New York Knicks,21,5040,839,1783,0.471,175,494,0.354,664,1289,0.515,342,429,0.797,227,721,948,492,146,332,434,2195
1276,2017-12-1,Boston Celtics,23,5545,857,1932,0.444,261,710,0.368,596,1222,0.488,417,542,0.769,220,829,1049,510,185,312,458,2392
1277,2017-12-1,Milwaukee Bucks,20,4825,784,1634,0.48,181,497,0.364,603,1137,0.53,309,421,0.734,143,626,769,453,170,264,453,2058
1278,2017-12-1,Atlanta Hawks,21,5040,813,1785,0.455,224,586,0.382,589,1199,0.491,308,388,0.794,188,649,837,487,188,327,430,2158
1279,2017-12-1,Portland Trail Blazers,22,5305,821,1868,0.44,195,519,0.376,626,1349,0.464,421,519,0.811,234,806,1040,399,147,321,436,2258
1280,2017-12-1,Utah Jazz,22,5305,824,1831,0.45,257,666,0.386,567,1165,0.487,353,427,0.827,193,687,880,479,214,322,452,2258
1281,2017-12-1,Oklahoma City Thunder,20,4800,753,1724,0.437,216,624,0.346,537,1100,0.488,324,443,0.731,223,630,853,416,215,280,425,2046
1282,2017-12-1,San Antonio Spurs,21,5040,807,1771,0.456,185,514,0.36,622,1257,0.495,338,427,0.792,222,719,941,489,162,285,365,2137
1283,2017-12-1,Miami Heat,21,5065,779,1748,0.446,241,677,0.356,538,1071,0.502,301,389,0.774,171,727,898,437,158,327,439,2100
1284,2017-12-1,Dallas Mavericks,22,5305,804,1869,0.43,256,725,0.353,548,1144,0.479,324,424,0.764,182,735,917,467,154,305,443,2188
1285,2017-12-1,Memphis Grizzlies,20,4800,716,1610,0.445,185,560,0.33,531,1050,0.506,355,447,0.794,156,633,789,416,147,271,446,1972
1286,2017-12-1,Chicago Bulls,20,4825,721,1758,0.41,216,629,0.343,505,1129,0.447,249,328,0.759,192,696,888,436,139,273,384,1907
1287,2017-12-1,Sacramento Kings,21,5040,776,1775,0.437,167,438,0.381,609,1337,0.455,270,368,0.734,194,629,823,419,170,295,413,1989
1288,2017-12-2,Golden State Warriors,23,5545,1017,1985,0.512,290,723,0.401,727,1262,0.576,390,476,0.819,203,837,1040,709,203,376,480,2714
1289,2017-12-2,Houston Rockets,21,5040,816,1762,0.463,340,932,0.365,476,830,0.573,420,522,0.805,202,740,942,491,192,321,433,2392
1290,2017-12-2,Cleveland Cavaliers,22,5305,880,1845,0.477,262,712,0.368,618,1133,0.545,425,525,0.81,195,748,943,499,154,327,441,2447
1291,2017-12-2,Toronto Raptors,21,5040,868,1779,0.488,234,666,0.351,634,1113,0.57,358,461,0.777,184,690,874,490,173,289,468,2328
1292,2017-12-2,Brooklyn Nets,21,5040,830,1867,0.445,244,702,0.348,586,1165,0.503,409,562,0.728,219,731,950,470,159,316,452,2313
1293,2017-12-2,Indiana Pacers,23,5520,955,1997,0.478,228,575,0.397,727,1422,0.511,360,466,0.773,211,767,978,534,184,313,429,2498
1294,2017-12-2,Philadelphia 76ers,21,5040,848,1850,0.458,227,625,0.363,621,1225,0.507,356,501,0.711,250,791,1041,537,178,355,501,2279
1295,2017-12-2,Orlando Magic,23,5520,929,1987,0.468,270,701,0.385,659,1286,0.512,359,489,0.734,191,765,956,552,181,338,463,2487
1296,2017-12-2,New Orleans Pelicans,22,5305,895,1875,0.477,230,654,0.352,665,1221,0.545,355,469,0.757,192,763,955,573,170,344,446,2375
1297,2017-12-2,Washington Wizards,22,5330,869,1882,0.462,210,571,0.368,659,1311,0.503,423,538,0.786,213,736,949,493,171,301,481,2371
1298,2017-12-2,Minnesota Timberwolves,23,5545,916,1949,0.47,195,529,0.369,721,1420,0.508,451,575,0.784,249,725,974,526,203,314,410,2478
1299,2017-12-2,Phoenix Suns,23,5545,909,2057,0.442,198,595,0.333,711,1462,0.486,443,591,0.75,263,809,1072,454,164,371,522,2459
1300,2017-12-2,Los Angeles Lakers,21,5090,857,1866,0.459,172,545,0.316,685,1321,0.519,352,497,0.708,208,761,969,485,175,350,465,2238
1301,2017-12-2,Denver Nuggets,21,5040,830,1799,0.461,226,621,0.364,604,1178,0.513,351,483,0.727,256,693,949,482,170,333,367,2237
1302,2017-12-2,Los Angeles Clippers,20,4825,767,1684,0.455,211,593,0.356,556,1091,0.51,374,494,0.757,221,649,870,409,163,302,425,2119
1303,2017-12-2,Charlotte Hornets,21,5065,792,1782,0.444,193,543,0.355,599,1239,0.483,438,606,0.723,212,768,980,431,122,282,400,2215
1304,2017-12-2,Detroit Pistons,21,5040,841,1817,0.463,236,611,0.386,605,1206,0.502,289,384,0.753,219,668,887,480,169,297,405,2207
1305,2017-12-2,New York Knicks,21,5040,839,1783,0.471,175,494,0.354,664,1289,0.515,342,429,0.797,227,721,948,492,146,332,434,2195
1306,2017-12-2,Boston Celtics,23,5545,857,1932,0.444,261,710,0.368,596,1222,0.488,417,542,0.769,220,829,1049,510,185,312,458,2392
1307,2017-12-2,Utah Jazz,23,5545,866,1916,0.452,269,696,0.386,597,1220,0.489,371,452,0.821,201,725,926,504,221,329,467,2372
1308,2017-12-2,Milwaukee Bucks,20,4825,784,1634,0.48,181,497,0.364,603,1137,0.53,309,421,0.734,143,626,769,453,170,264,453,2058
1309,2017-12-2,Atlanta Hawks,21,5040,813,1785,0.455,224,586,0.382,589,1199,0.491,308,388,0.794,188,649,837,487,188,327,430,2158
1310,2017-12-2,Oklahoma City Thunder,21,5040,794,1803,0.44,224,650,0.345,570,1153,0.494,345,465,0.742,236,659,895,444,222,298,449,2157
1311,2017-12-2,Portland Trail Blazers,22,5305,821,1868,0.44,195,519,0.376,626,1349,0.464,421,519,0.811,234,806,1040,399,147,321,436,2258
1312,2017-12-2,San Antonio Spurs,22,5280,838,1841,0.455,196,541,0.362,642,1300,0.494,360,459,0.784,229,755,984,509,170,298,383,2232
1313,2017-12-2,Miami Heat,22,5305,818,1828,0.447,255,712,0.358,563,1116,0.504,314,410,0.766,180,757,937,462,166,348,463,2205
1314,2017-12-2,Dallas Mavericks,22,5305,804,1869,0.43,256,725,0.353,548,1144,0.479,324,424,0.764,182,735,917,467,154,305,443,2188
1315,2017-12-2,Memphis Grizzlies,21,5040,746,1684,0.443,190,575,0.33,556,1109,0.501,369,465,0.794,164,663,827,435,155,287,472,2051
1316,2017-12-2,Chicago Bulls,21,5065,763,1848,0.413,229,665,0.344,534,1183,0.451,258,341,0.757,200,726,926,466,147,281,400,2013
1317,2017-12-2,Sacramento Kings,22,5280,821,1860,0.441,173,456,0.379,648,1404,0.462,281,382,0.736,202,664,866,448,175,307,428,2096
1318,2017-12-3,Golden State Warriors,23,5545,1017,1985,0.512,290,723,0.401,727,1262,0.576,390,476,0.819,203,837,1040,709,203,376,480,2714
1319,2017-12-3,Houston Rockets,21,5040,816,1762,0.463,340,932,0.365,476,830,0.573,420,522,0.805,202,740,942,491,192,321,433,2392
1320,2017-12-3,Cleveland Cavaliers,23,5545,922,1920,0.48,273,736,0.371,649,1184,0.548,446,548,0.814,196,778,974,523,162,337,455,2563
1321,2017-12-3,Toronto Raptors,21,5040,868,1779,0.488,234,666,0.351,634,1113,0.57,358,461,0.777,184,690,874,490,173,289,468,2328
1322,2017-12-3,Brooklyn Nets,22,5280,864,1949,0.443,261,744,0.351,603,1205,0.5,426,583,0.731,231,765,996,496,160,335,470,2415
1323,2017-12-3,New Orleans Pelicans,23,5545,940,1961,0.479,245,685,0.358,695,1276,0.545,373,494,0.755,196,807,1003,595,172,354,462,2498
1324,2017-12-3,Indiana Pacers,23,5520,955,1997,0.478,228,575,0.397,727,1422,0.511,360,466,0.773,211,767,978,534,184,313,429,2498
1325,2017-12-3,Philadelphia 76ers,22,5280,883,1936,0.456,237,653,0.363,646,1283,0.504,384,533,0.72,267,821,1088,564,185,372,525,2387
1326,2017-12-3,Orlando Magic,23,5520,929,1987,0.468,270,701,0.385,659,1286,0.512,359,489,0.734,191,765,956,552,181,338,463,2487
1327,2017-12-3,Washington Wizards,22,5330,869,1882,0.462,210,571,0.368,659,1311,0.503,423,538,0.786,213,736,949,493,171,301,481,2371
1328,2017-12-3,Minnesota Timberwolves,23,5545,916,1949,0.47,195,529,0.369,721,1420,0.508,451,575,0.784,249,725,974,526,203,314,410,2478
1329,2017-12-3,Phoenix Suns,24,5785,957,2158,0.443,205,619,0.331,752,1539,0.489,451,602,0.749,279,840,1119,478,172,381,541,2570
1330,2017-12-3,Denver Nuggets,22,5280,870,1886,0.461,238,652,0.365,632,1234,0.512,374,511,0.732,265,723,988,508,178,345,386,2352
1331,2017-12-3,Los Angeles Lakers,22,5330,895,1952,0.459,181,575,0.315,714,1377,0.519,367,518,0.708,225,796,1021,506,180,371,489,2338
1332,2017-12-3,Charlotte Hornets,21,5065,792,1782,0.444,193,543,0.355,599,1239,0.483,438,606,0.723,212,768,980,431,122,282,400,2215
1333,2017-12-3,Detroit Pistons,22,5280,875,1895,0.462,245,642,0.382,630,1253,0.503,315,416,0.757,226,697,923,500,177,313,432,2310
1334,2017-12-3,Los Angeles Clippers,21,5065,797,1770,0.45,217,615,0.353,580,1155,0.502,390,517,0.754,232,676,908,425,171,312,445,2201
1335,2017-12-3,Boston Celtics,24,5785,899,2012,0.447,275,741,0.371,624,1271,0.491,435,565,0.77,224,856,1080,542,193,321,474,2508
1336,2017-12-3,New York Knicks,21,5040,839,1783,0.471,175,494,0.354,664,1289,0.515,342,429,0.797,227,721,948,492,146,332,434,2195
1337,2017-12-3,Atlanta Hawks,22,5280,860,1884,0.456,234,613,0.382,626,1271,0.493,318,402,0.791,201,683,884,505,200,335,449,2272
1338,2017-12-3,Milwaukee Bucks,21,5065,818,1703,0.48,187,516,0.362,631,1187,0.532,344,463,0.743,152,653,805,473,179,279,471,2167
1339,2017-12-3,Portland Trail Blazers,23,5545,868,1973,0.44,206,554,0.372,662,1419,0.467,432,530,0.815,243,841,1084,419,153,325,453,2374
1340,2017-12-3,Utah Jazz,23,5545,866,1916,0.452,269,696,0.386,597,1220,0.489,371,452,0.821,201,725,926,504,221,329,467,2372
1341,2017-12-3,Oklahoma City Thunder,21,5040,794,1803,0.44,224,650,0.345,570,1153,0.494,345,465,0.742,236,659,895,444,222,298,449,2157
1342,2017-12-3,San Antonio Spurs,22,5280,838,1841,0.455,196,541,0.362,642,1300,0.494,360,459,0.784,229,755,984,509,170,298,383,2232
1343,2017-12-3,Miami Heat,22,5305,818,1828,0.447,255,712,0.358,563,1116,0.504,314,410,0.766,180,757,937,462,166,348,463,2205
1344,2017-12-3,Dallas Mavericks,23,5545,840,1948,0.431,272,760,0.358,568,1188,0.478,344,450,0.764,197,774,971,491,158,320,463,2296
1345,2017-12-3,Memphis Grizzlies,22,5280,789,1768,0.446,203,598,0.339,586,1170,0.501,381,479,0.795,170,693,863,466,161,299,491,2162
1346,2017-12-3,Chicago Bulls,21,5065,763,1848,0.413,229,665,0.344,534,1183,0.451,258,341,0.757,200,726,926,466,147,281,400,2013
1347,2017-12-3,Sacramento Kings,23,5520,858,1937,0.443,184,480,0.383,674,1457,0.463,300,403,0.744,208,691,899,468,182,322,456,2200
1348,2017-12-4,Golden State Warriors,24,5785,1064,2069,0.514,301,753,0.4,763,1316,0.58,408,500,0.816,210,871,1081,741,207,385,494,2837
1349,2017-12-4,Houston Rockets,22,5280,861,1852,0.465,354,969,0.365,507,883,0.574,434,539,0.805,209,776,985,508,202,337,456,2510
1350,2017-12-4,Cleveland Cavaliers,23,5545,922,1920,0.48,273,736,0.371,649,1184,0.548,446,548,0.814,196,778,974,523,162,337,455,2563
1351,2017-12-4,Toronto Raptors,21,5040,868,1779,0.488,234,666,0.351,634,1113,0.57,358,461,0.777,184,690,874,490,173,289,468,2328
1352,2017-12-4,Brooklyn Nets,22,5280,864,1949,0.443,261,744,0.351,603,1205,0.5,426,583,0.731,231,765,996,496,160,335,470,2415
1353,2017-12-4,New Orleans Pelicans,23,5545,940,1961,0.479,245,685,0.358,695,1276,0.545,373,494,0.755,196,807,1003,595,172,354,462,2498
1354,2017-12-4,Indiana Pacers,23,5520,955,1997,0.478,228,575,0.397,727,1422,0.511,360,466,0.773,211,767,978,534,184,313,429,2498
1355,2017-12-4,Philadelphia 76ers,22,5280,883,1936,0.456,237,653,0.363,646,1283,0.504,384,533,0.72,267,821,1088,564,185,372,525,2387
1356,2017-12-4,Orlando Magic,24,5760,966,2069,0.467,276,729,0.379,690,1340,0.515,384,518,0.741,199,799,998,571,189,348,474,2592
1357,2017-12-4,Minnesota Timberwolves,24,5785,954,2037,0.468,203,555,0.366,751,1482,0.507,479,606,0.79,263,753,1016,548,212,321,426,2590
1358,2017-12-4,Washington Wizards,22,5330,869,1882,0.462,210,571,0.368,659,1311,0.503,423,538,0.786,213,736,949,493,171,301,481,2371
1359,2017-12-4,Phoenix Suns,24,5785,957,2158,0.443,205,619,0.331,752,1539,0.489,451,602,0.749,279,840,1119,478,172,381,541,2570
1360,2017-12-4,Denver Nuggets,22,5280,870,1886,0.461,238,652,0.365,632,1234,0.512,374,511,0.732,265,723,988,508,178,345,386,2352
1361,2017-12-4,Los Angeles Lakers,23,5570,927,2036,0.455,190,603,0.315,737,1433,0.514,389,548,0.71,236,830,1066,522,189,391,511,2433
1362,2017-12-4,Charlotte Hornets,21,5065,792,1782,0.444,193,543,0.355,599,1239,0.483,438,606,0.723,212,768,980,431,122,282,400,2215
1363,2017-12-4,Detroit Pistons,22,5280,875,1895,0.462,245,642,0.382,630,1253,0.503,315,416,0.757,226,697,923,500,177,313,432,2310
1364,2017-12-4,Los Angeles Clippers,22,5305,834,1843,0.453,232,649,0.357,602,1194,0.504,407,539,0.755,240,705,945,446,174,328,471,2307
1365,2017-12-4,Boston Celtics,24,5785,899,2012,0.447,275,741,0.371,624,1271,0.491,435,565,0.77,224,856,1080,542,193,321,474,2508
1366,2017-12-4,New York Knicks,22,5280,882,1876,0.47,180,509,0.354,702,1367,0.514,351,439,0.8,237,756,993,510,150,346,458,2295
1367,2017-12-4,Atlanta Hawks,22,5280,860,1884,0.456,234,613,0.382,626,1271,0.493,318,402,0.791,201,683,884,505,200,335,449,2272
1368,2017-12-4,Milwaukee Bucks,21,5065,818,1703,0.48,187,516,0.362,631,1187,0.532,344,463,0.743,152,653,805,473,179,279,471,2167
1369,2017-12-4,Portland Trail Blazers,23,5545,868,1973,0.44,206,554,0.372,662,1419,0.467,432,530,0.815,243,841,1084,419,153,325,453,2374
1370,2017-12-4,Utah Jazz,23,5545,866,1916,0.452,269,696,0.386,597,1220,0.489,371,452,0.821,201,725,926,504,221,329,467,2372
1371,2017-12-4,Oklahoma City Thunder,22,5280,831,1890,0.44,230,672,0.342,601,1218,0.493,355,486,0.73,251,691,942,465,230,318,468,2247
1372,2017-12-4,San Antonio Spurs,23,5520,869,1917,0.453,204,569,0.359,665,1348,0.493,377,482,0.782,237,786,1023,523,181,315,407,2319
1373,2017-12-4,Miami Heat,23,5545,851,1909,0.446,269,749,0.359,582,1160,0.502,329,427,0.77,185,780,965,479,171,359,478,2300
1374,2017-12-4,Dallas Mavericks,23,5545,840,1948,0.431,272,760,0.358,568,1188,0.478,344,450,0.764,197,774,971,491,158,320,463,2296
1375,2017-12-4,Memphis Grizzlies,22,5280,789,1768,0.446,203,598,0.339,586,1170,0.501,381,479,0.795,170,693,863,466,161,299,491,2162
1376,2017-12-4,Chicago Bulls,21,5065,763,1848,0.413,229,665,0.344,534,1183,0.451,258,341,0.757,200,726,926,466,147,281,400,2013
1377,2017-12-4,Sacramento Kings,23,5520,858,1937,0.443,184,480,0.383,674,1457,0.463,300,403,0.744,208,691,899,468,182,322,456,2200
1378,2017-12-5,Golden State Warriors,25,6025,1109,2156,0.514,317,786,0.403,792,1370,0.578,427,527,0.81,215,906,1121,777,221,401,510,2962
1379,2017-12-5,Houston Rockets,22,5280,861,1852,0.465,354,969,0.365,507,883,0.574,434,539,0.805,209,776,985,508,202,337,456,2510
1380,2017-12-5,Cleveland Cavaliers,24,5785,964,2001,0.482,286,772,0.37,678,1229,0.552,462,565,0.818,201,819,1020,545,168,344,468,2676
1381,2017-12-5,Toronto Raptors,21,5040,868,1779,0.488,234,666,0.351,634,1113,0.57,358,461,0.777,184,690,874,490,173,289,468,2328
1382,2017-12-5,Brooklyn Nets,23,5520,905,2034,0.445,276,780,0.354,629,1254,0.502,439,598,0.734,243,805,1048,525,167,357,498,2525
1383,2017-12-5,New Orleans Pelicans,24,5785,985,2052,0.48,261,724,0.36,724,1328,0.545,382,509,0.75,207,843,1050,628,183,375,488,2613
1384,2017-12-5,Indiana Pacers,24,5760,1001,2083,0.481,239,601,0.398,762,1482,0.514,372,481,0.773,218,804,1022,562,194,329,449,2613
1385,2017-12-5,Philadelphia 76ers,23,5520,922,2027,0.455,244,683,0.357,678,1344,0.504,400,549,0.729,280,855,1135,587,194,386,547,2488
1386,2017-12-5,Orlando Magic,25,6000,1002,2151,0.466,286,761,0.376,716,1390,0.515,396,532,0.744,204,834,1038,595,194,368,504,2686
1387,2017-12-5,Phoenix Suns,25,6025,1001,2249,0.445,215,641,0.335,786,1608,0.489,468,624,0.75,294,871,1165,503,182,392,555,2685
1388,2017-12-5,Minnesota Timberwolves,25,6025,989,2116,0.467,207,572,0.362,782,1544,0.506,497,625,0.795,270,780,1050,565,221,330,442,2682
1389,2017-12-5,Denver Nuggets,23,5520,908,1977,0.459,252,688,0.366,656,1289,0.509,389,534,0.728,280,757,1037,533,183,352,405,2457
1390,2017-12-5,Washington Wizards,23,5570,892,1962,0.455,214,591,0.362,678,1371,0.495,442,561,0.788,225,755,980,502,179,314,502,2440
1391,2017-12-5,Los Angeles Lakers,23,5570,927,2036,0.455,190,603,0.315,737,1433,0.514,389,548,0.71,236,830,1066,522,189,391,511,2433
1392,2017-12-5,Charlotte Hornets,22,5305,826,1866,0.443,196,560,0.35,630,1306,0.482,471,646,0.729,223,809,1032,448,135,296,418,2319
1393,2017-12-5,Los Angeles Clippers,22,5305,834,1843,0.453,232,649,0.357,602,1194,0.504,407,539,0.755,240,705,945,446,174,328,471,2307
1394,2017-12-5,Boston Celtics,25,6025,942,2090,0.451,285,763,0.374,657,1327,0.495,450,584,0.771,232,893,1125,567,198,335,494,2619
1395,2017-12-5,Detroit Pistons,23,5520,910,1980,0.46,253,669,0.378,657,1311,0.501,330,440,0.75,233,732,965,515,185,323,454,2403
1396,2017-12-5,New York Knicks,23,5520,922,1967,0.469,186,532,0.35,736,1435,0.513,362,455,0.796,252,784,1036,536,154,363,473,2392
1397,2017-12-5,Utah Jazz,24,5785,909,1992,0.456,285,730,0.39,624,1262,0.494,385,470,0.819,211,767,978,533,230,345,487,2488
1398,2017-12-5,Portland Trail Blazers,23,5545,868,1973,0.44,206,554,0.372,662,1419,0.467,432,530,0.815,243,841,1084,419,153,325,453,2374
1399,2017-12-5,Milwaukee Bucks,22,5305,853,1781,0.479,196,537,0.365,657,1244,0.528,365,487,0.749,155,678,833,490,185,288,488,2267
1400,2017-12-5,Atlanta Hawks,23,5520,890,1966,0.453,243,643,0.378,647,1323,0.489,339,429,0.79,210,712,922,523,209,353,468,2362
1401,2017-12-5,Oklahoma City Thunder,22,5280,831,1890,0.44,230,672,0.342,601,1218,0.493,355,486,0.73,251,691,942,465,230,318,468,2247
1402,2017-12-5,Dallas Mavericks,24,5785,889,2034,0.437,284,786,0.361,605,1248,0.485,356,467,0.762,202,811,1013,517,162,327,481,2418
1403,2017-12-5,San Antonio Spurs,24,5760,904,1999,0.452,218,600,0.363,686,1399,0.49,389,494,0.787,247,827,1074,553,183,331,427,2415
1404,2017-12-5,Miami Heat,23,5545,851,1909,0.446,269,749,0.359,582,1160,0.502,329,427,0.77,185,780,965,479,171,359,478,2300
1405,2017-12-5,Memphis Grizzlies,23,5520,823,1840,0.447,209,619,0.338,614,1221,0.503,402,503,0.799,176,728,904,488,167,315,513,2257
1406,2017-12-5,Sacramento Kings,23,5520,858,1937,0.443,184,480,0.383,674,1457,0.463,300,403,0.744,208,691,899,468,182,322,456,2200
1407,2017-12-5,Chicago Bulls,22,5305,797,1930,0.413,238,699,0.34,559,1231,0.454,272,359,0.758,210,759,969,487,151,292,416,2104
1408,2017-12-6,Golden State Warriors,25,6025,1109,2156,0.514,317,786,0.403,792,1370,0.578,427,527,0.81,215,906,1121,777,221,401,510,2962
1409,2017-12-6,Houston Rockets,22,5280,861,1852,0.465,354,969,0.365,507,883,0.574,434,539,0.805,209,776,985,508,202,337,456,2510
1410,2017-12-6,Cleveland Cavaliers,24,5785,964,2001,0.482,286,772,0.37,678,1229,0.552,462,565,0.818,201,819,1020,545,168,344,468,2676
1411,2017-12-6,Toronto Raptors,22,5280,912,1871,0.487,249,702,0.355,663,1169,0.567,381,487,0.782,192,724,916,520,186,304,496,2454
1412,2017-12-6,Brooklyn Nets,23,5520,905,2034,0.445,276,780,0.354,629,1254,0.502,439,598,0.734,243,805,1048,525,167,357,498,2525
1413,2017-12-6,New Orleans Pelicans,24,5785,985,2052,0.48,261,724,0.36,724,1328,0.545,382,509,0.75,207,843,1050,628,183,375,488,2613
1414,2017-12-6,Indiana Pacers,24,5760,1001,2083,0.481,239,601,0.398,762,1482,0.514,372,481,0.773,218,804,1022,562,194,329,449,2613
1415,2017-12-6,Philadelphia 76ers,23,5520,922,2027,0.455,244,683,0.357,678,1344,0.504,400,549,0.729,280,855,1135,587,194,386,547,2488
1416,2017-12-6,Phoenix Suns,26,6265,1038,2324,0.447,224,665,0.337,814,1659,0.491,498,662,0.752,294,906,1200,526,189,409,579,2798
1417,2017-12-6,Orlando Magic,25,6000,1002,2151,0.466,286,761,0.376,716,1390,0.515,396,532,0.744,204,834,1038,595,194,368,504,2686
1418,2017-12-6,Minnesota Timberwolves,25,6025,989,2116,0.467,207,572,0.362,782,1544,0.506,497,625,0.795,270,780,1050,565,221,330,442,2682
1419,2017-12-6,Denver Nuggets,23,5520,908,1977,0.459,252,688,0.366,656,1289,0.509,389,534,0.728,280,757,1037,533,183,352,405,2457
1420,2017-12-6,Washington Wizards,24,5810,934,2051,0.455,225,616,0.365,709,1435,0.494,453,575,0.788,236,788,1024,522,195,323,524,2546
1421,2017-12-6,Los Angeles Lakers,23,5570,927,2036,0.455,190,603,0.315,737,1433,0.514,389,548,0.71,236,830,1066,522,189,391,511,2433
1422,2017-12-6,Charlotte Hornets,22,5305,826,1866,0.443,196,560,0.35,630,1306,0.482,471,646,0.729,223,809,1032,448,135,296,418,2319
1423,2017-12-6,Los Angeles Clippers,22,5305,834,1843,0.453,232,649,0.357,602,1194,0.504,407,539,0.755,240,705,945,446,174,328,471,2307
1424,2017-12-6,Boston Celtics,25,6025,942,2090,0.451,285,763,0.374,657,1327,0.495,450,584,0.771,232,893,1125,567,198,335,494,2619
1425,2017-12-6,Detroit Pistons,23,5520,910,1980,0.46,253,669,0.378,657,1311,0.501,330,440,0.75,233,732,965,515,185,323,454,2403
1426,2017-12-6,New York Knicks,23,5520,922,1967,0.469,186,532,0.35,736,1435,0.513,362,455,0.796,252,784,1036,536,154,363,473,2392
1427,2017-12-6,Utah Jazz,25,6025,943,2071,0.455,296,763,0.388,647,1308,0.495,400,491,0.815,220,793,1013,551,246,361,508,2582
1428,2017-12-6,Milwaukee Bucks,22,5305,853,1781,0.479,196,537,0.365,657,1244,0.528,365,487,0.749,155,678,833,490,185,288,488,2267
1429,2017-12-6,Portland Trail Blazers,24,5785,900,2051,0.439,218,581,0.375,682,1470,0.464,448,551,0.813,250,875,1125,437,155,343,473,2466
1430,2017-12-6,Atlanta Hawks,23,5520,890,1966,0.453,243,643,0.378,647,1323,0.489,339,429,0.79,210,712,922,523,209,353,468,2362
1431,2017-12-6,Oklahoma City Thunder,23,5520,870,1971,0.441,234,690,0.339,636,1281,0.496,373,512,0.729,263,725,988,483,241,336,486,2347
1432,2017-12-6,Dallas Mavericks,24,5785,889,2034,0.437,284,786,0.361,605,1248,0.485,356,467,0.762,202,811,1013,517,162,327,481,2418
1433,2017-12-6,San Antonio Spurs,24,5760,904,1999,0.452,218,600,0.363,686,1399,0.49,389,494,0.787,247,827,1074,553,183,331,427,2415
1434,2017-12-6,Miami Heat,23,5545,851,1909,0.446,269,749,0.359,582,1160,0.502,329,427,0.77,185,780,965,479,171,359,478,2300
1435,2017-12-6,Memphis Grizzlies,23,5520,823,1840,0.447,209,619,0.338,614,1221,0.503,402,503,0.799,176,728,904,488,167,315,513,2257
1436,2017-12-6,Sacramento Kings,23,5520,858,1937,0.443,184,480,0.383,674,1457,0.463,300,403,0.744,208,691,899,468,182,322,456,2200
1437,2017-12-6,Chicago Bulls,22,5305,797,1930,0.413,238,699,0.34,559,1231,0.454,272,359,0.758,210,759,969,487,151,292,416,2104
1438,2017-12-7,Golden State Warriors,26,6265,1149,2240,0.513,328,816,0.402,821,1424,0.577,437,540,0.809,223,945,1168,803,229,416,530,3063
1439,2017-12-7,Houston Rockets,22,5280,861,1852,0.465,354,969,0.365,507,883,0.574,434,539,0.805,209,776,985,508,202,337,456,2510
1440,2017-12-7,Toronto Raptors,22,5280,912,1871,0.487,249,702,0.355,663,1169,0.567,381,487,0.782,192,724,916,520,186,304,496,2454
1441,2017-12-7,Cleveland Cavaliers,25,6025,1001,2079,0.481,300,811,0.37,701,1268,0.553,475,586,0.811,208,855,1063,573,173,359,478,2777
1442,2017-12-7,Brooklyn Nets,23,5520,905,2034,0.445,276,780,0.354,629,1254,0.502,439,598,0.734,243,805,1048,525,167,357,498,2525
1443,2017-12-7,New Orleans Pelicans,25,6025,1031,2138,0.482,273,755,0.362,758,1383,0.548,401,538,0.745,218,881,1099,656,187,386,507,2736
1444,2017-12-7,Indiana Pacers,25,6000,1040,2170,0.479,251,635,0.395,789,1535,0.514,380,491,0.774,225,836,1061,583,201,342,463,2711
1445,2017-12-7,Philadelphia 76ers,23,5520,922,2027,0.455,244,683,0.357,678,1344,0.504,400,549,0.729,280,855,1135,587,194,386,547,2488
1446,2017-12-7,Phoenix Suns,26,6265,1038,2324,0.447,224,665,0.337,814,1659,0.491,498,662,0.752,294,906,1200,526,189,409,579,2798
1447,2017-12-7,Orlando Magic,26,6265,1048,2249,0.466,292,789,0.37,756,1460,0.518,408,550,0.742,217,873,1090,612,203,384,527,2796
1448,2017-12-7,Minnesota Timberwolves,26,6265,1034,2198,0.47,214,591,0.362,820,1607,0.51,513,646,0.794,278,818,1096,594,225,345,459,2795
1449,2017-12-7,Denver Nuggets,24,5760,949,2071,0.458,268,723,0.371,681,1348,0.505,405,556,0.728,290,787,1077,555,190,361,426,2571
1450,2017-12-7,Washington Wizards,24,5810,934,2051,0.455,225,616,0.365,709,1435,0.494,453,575,0.788,236,788,1024,522,195,323,524,2546
1451,2017-12-7,Los Angeles Lakers,23,5570,927,2036,0.455,190,603,0.315,737,1433,0.514,389,548,0.71,236,830,1066,522,189,391,511,2433
1452,2017-12-7,Los Angeles Clippers,23,5545,878,1942,0.452,242,681,0.355,636,1261,0.504,416,554,0.751,257,731,988,469,180,337,488,2414
1453,2017-12-7,Charlotte Hornets,23,5545,860,1963,0.438,202,579,0.349,658,1384,0.475,484,663,0.73,237,844,1081,465,140,308,431,2406
1454,2017-12-7,Boston Celtics,26,6265,978,2177,0.449,297,797,0.373,681,1380,0.493,463,601,0.77,241,937,1178,592,206,346,509,2716
1455,2017-12-7,Detroit Pistons,24,5760,946,2067,0.458,263,699,0.376,683,1368,0.499,348,467,0.745,250,761,1011,535,190,334,474,2503
1456,2017-12-7,New York Knicks,24,5760,957,2034,0.471,195,546,0.357,762,1488,0.512,382,482,0.793,262,816,1078,558,162,379,494,2491
1457,2017-12-7,Utah Jazz,25,6025,943,2071,0.455,296,763,0.388,647,1308,0.495,400,491,0.815,220,793,1013,551,246,361,508,2582
1458,2017-12-7,Milwaukee Bucks,23,5545,892,1860,0.48,204,559,0.365,688,1301,0.529,383,513,0.747,168,706,874,512,192,300,509,2371
1459,2017-12-7,Atlanta Hawks,24,5785,930,2059,0.452,254,670,0.379,676,1389,0.487,354,449,0.788,221,750,971,548,216,370,484,2468
1460,2017-12-7,Portland Trail Blazers,24,5785,900,2051,0.439,218,581,0.375,682,1470,0.464,448,551,0.813,250,875,1125,437,155,343,473,2466
1461,2017-12-7,Oklahoma City Thunder,23,5520,870,1971,0.441,234,690,0.339,636,1281,0.496,373,512,0.729,263,725,988,483,241,336,486,2347
1462,2017-12-7,San Antonio Spurs,25,6000,950,2086,0.455,231,625,0.37,719,1461,0.492,401,508,0.789,257,851,1108,583,189,342,441,2532
1463,2017-12-7,Dallas Mavericks,25,6025,923,2120,0.435,293,814,0.36,630,1306,0.482,369,484,0.762,208,850,1058,536,169,336,493,2508
1464,2017-12-7,Miami Heat,24,5785,890,1981,0.449,287,783,0.367,603,1198,0.503,338,439,0.77,191,803,994,507,178,377,495,2405
1465,2017-12-7,Memphis Grizzlies,24,5760,852,1910,0.446,221,647,0.342,631,1263,0.5,420,525,0.8,180,751,931,502,175,330,537,2345
1466,2017-12-7,Chicago Bulls,23,5545,836,2013,0.415,248,725,0.342,588,1288,0.457,280,375,0.747,221,794,1015,505,154,308,431,2200
1467,2017-12-7,Sacramento Kings,24,5760,897,2023,0.443,194,512,0.379,703,1511,0.465,307,416,0.738,217,727,944,493,197,334,476,2295
1468,2017-12-8,Golden State Warriors,26,6265,1149,2240,0.513,328,816,0.402,821,1424,0.577,437,540,0.809,223,945,1168,803,229,416,530,3063
1469,2017-12-8,Houston Rockets,23,5520,899,1933,0.465,372,1011,0.368,527,922,0.572,452,563,0.803,217,814,1031,530,212,354,481,2622
1470,2017-12-8,Toronto Raptors,22,5280,912,1871,0.487,249,702,0.355,663,1169,0.567,381,487,0.782,192,724,916,520,186,304,496,2454
1471,2017-12-8,Cleveland Cavaliers,25,6025,1001,2079,0.481,300,811,0.37,701,1268,0.553,475,586,0.811,208,855,1063,573,173,359,478,2777
1472,2017-12-8,Brooklyn Nets,24,5760,940,2114,0.445,287,817,0.351,653,1297,0.503,458,628,0.729,250,847,1097,549,170,370,519,2625
1473,2017-12-8,New Orleans Pelicans,25,6025,1031,2138,0.482,273,755,0.362,758,1383,0.548,401,538,0.745,218,881,1099,656,187,386,507,2736
1474,2017-12-8,Indiana Pacers,25,6000,1040,2170,0.479,251,635,0.395,789,1535,0.514,380,491,0.774,225,836,1061,583,201,342,463,2711
1475,2017-12-8,Philadelphia 76ers,24,5760,961,2108,0.456,254,709,0.358,707,1399,0.505,416,570,0.73,287,892,1179,616,197,404,574,2592
1476,2017-12-8,Orlando Magic,26,6265,1048,2249,0.466,292,789,0.37,756,1460,0.518,408,550,0.742,217,873,1090,612,203,384,527,2796
1477,2017-12-8,Minnesota Timberwolves,26,6265,1034,2198,0.47,214,591,0.362,820,1607,0.51,513,646,0.794,278,818,1096,594,225,345,459,2795
1478,2017-12-8,Phoenix Suns,27,6505,1074,2402,0.447,231,688,0.336,843,1714,0.492,518,690,0.751,304,938,1242,548,194,422,600,2897
1479,2017-12-8,Denver Nuggets,24,5760,949,2071,0.458,268,723,0.371,681,1348,0.505,405,556,0.728,290,787,1077,555,190,361,426,2571
1480,2017-12-8,Washington Wizards,25,6050,975,2132,0.457,233,637,0.366,742,1495,0.496,472,600,0.787,244,818,1062,547,201,333,547,2655
1481,2017-12-8,Los Angeles Lakers,24,5810,969,2132,0.455,201,631,0.319,768,1501,0.512,401,572,0.701,251,859,1110,544,202,402,535,2540
1482,2017-12-8,Los Angeles Clippers,23,5545,878,1942,0.452,242,681,0.355,636,1261,0.504,416,554,0.751,257,731,988,469,180,337,488,2414
1483,2017-12-8,Charlotte Hornets,23,5545,860,1963,0.438,202,579,0.349,658,1384,0.475,484,663,0.73,237,844,1081,465,140,308,431,2406
1484,2017-12-8,Boston Celtics,26,6265,978,2177,0.449,297,797,0.373,681,1380,0.493,463,601,0.77,241,937,1178,592,206,346,509,2716
1485,2017-12-8,Detroit Pistons,24,5760,946,2067,0.458,263,699,0.376,683,1368,0.499,348,467,0.745,250,761,1011,535,190,334,474,2503
1486,2017-12-8,New York Knicks,24,5760,957,2034,0.471,195,546,0.357,762,1488,0.512,382,482,0.793,262,816,1078,558,162,379,494,2491
1487,2017-12-8,Utah Jazz,26,6265,977,2148,0.455,307,793,0.387,670,1355,0.494,422,518,0.815,224,821,1045,568,256,374,529,2683
1488,2017-12-8,Milwaukee Bucks,23,5545,892,1860,0.48,204,559,0.365,688,1301,0.529,383,513,0.747,168,706,874,512,192,300,509,2371
1489,2017-12-8,Atlanta Hawks,24,5785,930,2059,0.452,254,670,0.379,676,1389,0.487,354,449,0.788,221,750,971,548,216,370,484,2468
1490,2017-12-8,Portland Trail Blazers,24,5785,900,2051,0.439,218,581,0.375,682,1470,0.464,448,551,0.813,250,875,1125,437,155,343,473,2466
1491,2017-12-8,Oklahoma City Thunder,24,5760,908,2069,0.439,241,714,0.338,667,1355,0.492,385,535,0.72,280,762,1042,501,247,348,511,2442
1492,2017-12-8,San Antonio Spurs,25,6000,950,2086,0.455,231,625,0.37,719,1461,0.492,401,508,0.789,257,851,1108,583,189,342,441,2532
1493,2017-12-8,Dallas Mavericks,25,6025,923,2120,0.435,293,814,0.36,630,1306,0.482,369,484,0.762,208,850,1058,536,169,336,493,2508
1494,2017-12-8,Miami Heat,24,5785,890,1981,0.449,287,783,0.367,603,1198,0.503,338,439,0.77,191,803,994,507,178,377,495,2405
1495,2017-12-8,Memphis Grizzlies,24,5760,852,1910,0.446,221,647,0.342,631,1263,0.5,420,525,0.8,180,751,931,502,175,330,537,2345
1496,2017-12-8,Chicago Bulls,23,5545,836,2013,0.415,248,725,0.342,588,1288,0.457,280,375,0.747,221,794,1015,505,154,308,431,2200
1497,2017-12-8,Sacramento Kings,24,5760,897,2023,0.443,194,512,0.379,703,1511,0.465,307,416,0.738,217,727,944,493,197,334,476,2295
1498,2017-12-9,Golden State Warriors,27,6505,1188,2321,0.512,335,842,0.398,853,1479,0.577,454,562,0.808,228,985,1213,832,234,430,549,3165
1499,2017-12-9,Houston Rockets,23,5520,899,1933,0.465,372,1011,0.368,527,922,0.572,452,563,0.803,217,814,1031,530,212,354,481,2622
1500,2017-12-9,Toronto Raptors,23,5520,949,1949,0.487,262,733,0.357,687,1216,0.565,410,520,0.788,202,750,952,541,194,315,519,2570
1501,2017-12-9,Cleveland Cavaliers,26,6265,1038,2164,0.48,311,847,0.367,727,1317,0.552,492,608,0.809,217,890,1107,596,177,370,501,2879
1502,2017-12-9,Brooklyn Nets,24,5760,940,2114,0.445,287,817,0.351,653,1297,0.503,458,628,0.729,250,847,1097,549,170,370,519,2625
1503,2017-12-9,New Orleans Pelicans,26,6290,1072,2227,0.481,283,783,0.361,789,1444,0.546,418,557,0.75,225,909,1134,675,194,403,521,2845
1504,2017-12-9,Indiana Pacers,26,6240,1078,2256,0.478,266,674,0.395,812,1582,0.513,395,515,0.767,237,873,1110,604,208,350,482,2817
1505,2017-12-9,Philadelphia 76ers,24,5760,961,2108,0.456,254,709,0.358,707,1399,0.505,416,570,0.73,287,892,1179,616,197,404,574,2592
1506,2017-12-9,Minnesota Timberwolves,26,6265,1034,2198,0.47,214,591,0.362,820,1607,0.51,513,646,0.794,278,818,1096,594,225,345,459,2795
1507,2017-12-9,Phoenix Suns,27,6505,1074,2402,0.447,231,688,0.336,843,1714,0.492,518,690,0.751,304,938,1242,548,194,422,600,2897
1508,2017-12-9,Denver Nuggets,25,6000,991,2156,0.46,274,744,0.368,717,1412,0.508,418,572,0.731,296,825,1121,576,197,373,446,2674
1509,2017-12-9,Orlando Magic,27,6505,1081,2332,0.464,297,810,0.367,784,1522,0.515,426,573,0.743,228,904,1132,630,208,398,544,2885
1510,2017-12-9,Washington Wizards,25,6050,975,2132,0.457,233,637,0.366,742,1495,0.496,472,600,0.787,244,818,1062,547,201,333,547,2655
1511,2017-12-9,Los Angeles Lakers,24,5810,969,2132,0.455,201,631,0.319,768,1501,0.512,401,572,0.701,251,859,1110,544,202,402,535,2540
1512,2017-12-9,Los Angeles Clippers,23,5545,878,1942,0.452,242,681,0.355,636,1261,0.504,416,554,0.751,257,731,988,469,180,337,488,2414
1513,2017-12-9,Charlotte Hornets,24,5810,900,2063,0.436,212,608,0.349,688,1455,0.473,505,692,0.73,246,885,1131,487,147,319,452,2517
1514,2017-12-9,Boston Celtics,27,6505,1016,2260,0.45,308,835,0.369,708,1425,0.497,478,618,0.773,252,965,1217,606,216,360,531,2818
1515,2017-12-9,Detroit Pistons,25,6000,984,2159,0.456,275,726,0.379,709,1433,0.495,358,486,0.737,265,795,1060,555,198,345,491,2601
1516,2017-12-9,New York Knicks,24,5760,957,2034,0.471,195,546,0.357,762,1488,0.512,382,482,0.793,262,816,1078,558,162,379,494,2491
1517,2017-12-9,Milwaukee Bucks,24,5785,928,1939,0.479,212,583,0.364,716,1356,0.528,412,547,0.753,175,739,914,532,202,310,533,2480
1518,2017-12-9,Utah Jazz,26,6265,977,2148,0.455,307,793,0.387,670,1355,0.494,422,518,0.815,224,821,1045,568,256,374,529,2683
1519,2017-12-9,Atlanta Hawks,24,5785,930,2059,0.452,254,670,0.379,676,1389,0.487,354,449,0.788,221,750,971,548,216,370,484,2468
1520,2017-12-9,Portland Trail Blazers,24,5785,900,2051,0.439,218,581,0.375,682,1470,0.464,448,551,0.813,250,875,1125,437,155,343,473,2466
1521,2017-12-9,Oklahoma City Thunder,24,5760,908,2069,0.439,241,714,0.338,667,1355,0.492,385,535,0.72,280,762,1042,501,247,348,511,2442
1522,2017-12-9,San Antonio Spurs,26,6240,988,2167,0.456,239,652,0.367,749,1515,0.494,422,532,0.793,271,883,1154,599,195,355,455,2637
1523,2017-12-9,Dallas Mavericks,26,6265,958,2195,0.436,303,838,0.362,655,1357,0.483,391,510,0.767,212,882,1094,554,175,347,515,2610
1524,2017-12-9,Miami Heat,24,5785,890,1981,0.449,287,783,0.367,603,1198,0.503,338,439,0.77,191,803,994,507,178,377,495,2405
1525,2017-12-9,Memphis Grizzlies,25,6000,893,1992,0.448,230,674,0.341,663,1318,0.503,436,547,0.797,191,775,966,526,183,346,562,2452
1526,2017-12-9,Chicago Bulls,24,5810,884,2112,0.419,254,743,0.342,630,1369,0.46,297,397,0.748,227,844,1071,528,159,322,460,2319
1527,2017-12-9,Sacramento Kings,25,6025,944,2120,0.445,207,542,0.382,737,1578,0.467,316,430,0.735,228,762,990,514,209,351,497,2411
1528,2017-12-10,Golden State Warriors,27,6505,1188,2321,0.512,335,842,0.398,853,1479,0.577,454,562,0.808,228,985,1213,832,234,430,549,3165
1529,2017-12-10,Houston Rockets,24,5760,939,2008,0.468,382,1036,0.369,557,972,0.573,486,605,0.803,224,842,1066,544,225,366,498,2746
1530,2017-12-10,Toronto Raptors,23,5520,949,1949,0.487,262,733,0.357,687,1216,0.565,410,520,0.788,202,750,952,541,194,315,519,2570
1531,2017-12-10,Cleveland Cavaliers,27,6505,1074,2239,0.48,325,876,0.371,749,1363,0.55,511,633,0.807,223,917,1140,622,189,387,517,2984
1532,2017-12-10,New Orleans Pelicans,26,6290,1072,2227,0.481,283,783,0.361,789,1444,0.546,418,557,0.75,225,909,1134,675,194,403,521,2845
1533,2017-12-10,Brooklyn Nets,25,6000,973,2195,0.443,294,844,0.348,679,1351,0.503,474,647,0.733,258,882,1140,565,173,382,536,2714
1534,2017-12-10,Indiana Pacers,26,6240,1078,2256,0.478,266,674,0.395,812,1582,0.513,395,515,0.767,237,873,1110,604,208,350,482,2817
1535,2017-12-10,Philadelphia 76ers,25,6000,998,2186,0.457,265,742,0.357,733,1444,0.508,429,583,0.736,294,924,1218,647,207,423,595,2690
1536,2017-12-10,Minnesota Timberwolves,26,6265,1034,2198,0.47,214,591,0.362,820,1607,0.51,513,646,0.794,278,818,1096,594,225,345,459,2795
1537,2017-12-10,Phoenix Suns,28,6745,1109,2482,0.447,238,713,0.334,871,1769,0.492,542,720,0.753,314,968,1282,559,198,432,621,2998
1538,2017-12-10,Orlando Magic,28,6745,1126,2424,0.465,310,844,0.367,816,1580,0.516,433,581,0.745,238,933,1171,669,215,410,568,2995
1539,2017-12-10,Denver Nuggets,25,6000,991,2156,0.46,274,744,0.368,717,1412,0.508,418,572,0.731,296,825,1121,576,197,373,446,2674
1540,2017-12-10,Washington Wizards,26,6290,1017,2214,0.459,246,669,0.368,771,1545,0.499,487,623,0.782,253,853,1106,580,206,346,565,2767
1541,2017-12-10,Los Angeles Lakers,25,6050,1012,2217,0.456,210,658,0.319,802,1559,0.514,416,593,0.702,257,899,1156,568,209,416,556,2650
1542,2017-12-10,Los Angeles Clippers,24,5785,917,2022,0.454,256,713,0.359,661,1309,0.505,437,578,0.756,261,760,1021,491,188,347,507,2527
1543,2017-12-10,Charlotte Hornets,25,6050,941,2156,0.436,220,633,0.348,721,1523,0.473,514,706,0.728,255,919,1174,508,154,330,473,2616
1544,2017-12-10,Boston Celtics,27,6505,1016,2260,0.45,308,835,0.369,708,1425,0.497,478,618,0.773,252,965,1217,606,216,360,531,2818
1545,2017-12-10,Detroit Pistons,25,6000,984,2159,0.456,275,726,0.379,709,1433,0.495,358,486,0.737,265,795,1060,555,198,345,491,2601
1546,2017-12-10,Milwaukee Bucks,25,6025,972,2020,0.481,219,600,0.365,753,1420,0.53,434,573,0.757,183,772,955,554,210,321,562,2597
1547,2017-12-10,New York Knicks,25,6000,1000,2125,0.471,202,570,0.354,798,1555,0.513,391,491,0.796,270,848,1118,583,168,393,511,2593
1548,2017-12-10,Atlanta Hawks,25,6025,971,2139,0.454,271,703,0.385,700,1436,0.487,372,474,0.785,230,781,1011,581,223,382,497,2585
1549,2017-12-10,Portland Trail Blazers,25,6025,945,2139,0.442,236,622,0.379,709,1517,0.467,457,563,0.812,257,901,1158,456,159,358,501,2583
1550,2017-12-10,Utah Jazz,27,6505,1010,2224,0.454,315,816,0.386,695,1408,0.494,448,555,0.807,233,847,1080,588,263,390,552,2783
1551,2017-12-10,Oklahoma City Thunder,25,6025,944,2161,0.437,253,748,0.338,691,1413,0.489,403,566,0.712,297,792,1089,519,254,358,532,2544
1552,2017-12-10,San Antonio Spurs,27,6480,1028,2254,0.456,245,671,0.365,783,1583,0.495,440,557,0.79,289,917,1206,617,200,370,478,2741
1553,2017-12-10,Dallas Mavericks,26,6265,958,2195,0.436,303,838,0.362,655,1357,0.483,391,510,0.767,212,882,1094,554,175,347,515,2610
1554,2017-12-10,Miami Heat,25,6025,932,2071,0.45,295,810,0.364,637,1261,0.505,347,453,0.766,199,839,1038,522,184,382,512,2506
1555,2017-12-10,Memphis Grizzlies,26,6265,932,2080,0.448,243,707,0.344,689,1373,0.502,446,564,0.791,204,809,1013,549,188,359,592,2553
1556,2017-12-10,Chicago Bulls,25,6050,926,2194,0.422,261,768,0.34,665,1426,0.466,310,420,0.738,235,876,1111,556,169,336,479,2423
1557,2017-12-10,Sacramento Kings,25,6025,944,2120,0.445,207,542,0.382,737,1578,0.467,316,430,0.735,228,762,990,514,209,351,497,2411
1558,2017-12-11,Golden State Warriors,27,6505,1188,2321,0.512,335,842,0.398,853,1479,0.577,454,562,0.808,228,985,1213,832,234,430,549,3165
1559,2017-12-11,Houston Rockets,24,5760,939,2008,0.468,382,1036,0.369,557,972,0.573,486,605,0.803,224,842,1066,544,225,366,498,2746
1560,2017-12-11,Toronto Raptors,24,5760,988,2036,0.485,273,770,0.355,715,1266,0.565,423,539,0.785,214,782,996,563,202,328,536,2672
1561,2017-12-11,Cleveland Cavaliers,27,6505,1074,2239,0.48,325,876,0.371,749,1363,0.55,511,633,0.807,223,917,1140,622,189,387,517,2984
1562,2017-12-11,New Orleans Pelicans,27,6530,1118,2307,0.485,298,807,0.369,820,1500,0.547,442,589,0.75,230,937,1167,706,205,417,542,2976
1563,2017-12-11,Indiana Pacers,27,6505,1127,2349,0.48,276,699,0.395,851,1650,0.516,413,537,0.769,248,902,1150,628,214,361,499,2943
1564,2017-12-11,Brooklyn Nets,25,6000,973,2195,0.443,294,844,0.348,679,1351,0.503,474,647,0.733,258,882,1140,565,173,382,536,2714
1565,2017-12-11,Philadelphia 76ers,26,6240,1042,2282,0.457,274,771,0.355,768,1511,0.508,456,613,0.744,316,949,1265,673,212,440,624,2814
1566,2017-12-11,Denver Nuggets,26,6265,1034,2251,0.459,291,786,0.37,743,1465,0.507,431,589,0.732,315,853,1168,600,204,394,466,2790
1567,2017-12-11,Phoenix Suns,28,6745,1109,2482,0.447,238,713,0.334,871,1769,0.492,542,720,0.753,314,968,1282,559,198,432,621,2998
1568,2017-12-11,Minnesota Timberwolves,27,6505,1070,2270,0.471,221,610,0.362,849,1660,0.511,531,669,0.794,287,854,1141,613,232,363,478,2892
1569,2017-12-11,Orlando Magic,28,6745,1126,2424,0.465,310,844,0.367,816,1580,0.516,433,581,0.745,238,933,1171,669,215,410,568,2995
1570,2017-12-11,Washington Wizards,26,6290,1017,2214,0.459,246,669,0.368,771,1545,0.499,487,623,0.782,253,853,1106,580,206,346,565,2767
1571,2017-12-11,Los Angeles Lakers,25,6050,1012,2217,0.456,210,658,0.319,802,1559,0.514,416,593,0.702,257,899,1156,568,209,416,556,2650
1572,2017-12-11,Los Angeles Clippers,24,5785,917,2022,0.454,256,713,0.359,661,1309,0.505,437,578,0.756,261,760,1021,491,188,347,507,2527
1573,2017-12-11,Charlotte Hornets,25,6050,941,2156,0.436,220,633,0.348,721,1523,0.473,514,706,0.728,255,919,1174,508,154,330,473,2616
1574,2017-12-11,New York Knicks,26,6240,1039,2205,0.471,207,587,0.353,832,1618,0.514,419,525,0.798,276,875,1151,599,177,405,541,2704
1575,2017-12-11,Milwaukee Bucks,25,6025,972,2020,0.481,219,600,0.365,753,1420,0.53,434,573,0.757,183,772,955,554,210,321,562,2597
1576,2017-12-11,Boston Celtics,28,6745,1049,2339,0.448,319,865,0.369,730,1474,0.495,492,636,0.774,261,1006,1267,622,220,373,549,2909
1577,2017-12-11,Atlanta Hawks,26,6265,1008,2216,0.455,280,734,0.381,728,1482,0.491,396,504,0.786,236,810,1046,603,228,398,525,2692
1578,2017-12-11,Portland Trail Blazers,25,6025,945,2139,0.442,236,622,0.379,709,1517,0.467,457,563,0.812,257,901,1158,456,159,358,501,2583
1579,2017-12-11,Detroit Pistons,26,6240,1012,2243,0.451,285,759,0.375,727,1484,0.49,373,505,0.739,276,830,1106,569,205,354,507,2682
1580,2017-12-11,Utah Jazz,27,6505,1010,2224,0.454,315,816,0.386,695,1408,0.494,448,555,0.807,233,847,1080,588,263,390,552,2783
1581,2017-12-11,Oklahoma City Thunder,25,6025,944,2161,0.437,253,748,0.338,691,1413,0.489,403,566,0.712,297,792,1089,519,254,358,532,2544
1582,2017-12-11,San Antonio Spurs,27,6480,1028,2254,0.456,245,671,0.365,783,1583,0.495,440,557,0.79,289,917,1206,617,200,370,478,2741
1583,2017-12-11,Miami Heat,25,6025,932,2071,0.45,295,810,0.364,637,1261,0.505,347,453,0.766,199,839,1038,522,184,382,512,2506
1584,2017-12-11,Dallas Mavericks,27,6505,995,2276,0.437,314,869,0.361,681,1407,0.484,398,519,0.767,218,909,1127,577,181,357,537,2702
1585,2017-12-11,Memphis Grizzlies,26,6265,932,2080,0.448,243,707,0.344,689,1373,0.502,446,564,0.791,204,809,1013,549,188,359,592,2553
1586,2017-12-11,Chicago Bulls,25,6050,926,2194,0.422,261,768,0.34,665,1426,0.466,310,420,0.738,235,876,1111,556,169,336,479,2423
1587,2017-12-11,Sacramento Kings,26,6265,979,2193,0.446,217,565,0.384,762,1628,0.468,323,444,0.727,235,797,1032,529,216,372,514,2498
1588,2017-12-12,Golden State Warriors,28,6745,1232,2401,0.513,345,862,0.4,887,1539,0.576,467,579,0.807,234,1021,1255,858,239,444,565,3276
1589,2017-12-12,Houston Rockets,25,6000,987,2096,0.471,399,1081,0.369,588,1015,0.579,503,630,0.798,228,874,1102,574,237,375,513,2876
1590,2017-12-12,New Orleans Pelicans,28,6770,1167,2392,0.488,316,840,0.376,851,1552,0.548,449,602,0.746,236,972,1208,738,211,435,561,3099
1591,2017-12-12,Cleveland Cavaliers,27,6505,1074,2239,0.48,325,876,0.371,749,1363,0.55,511,633,0.807,223,917,1140,622,189,387,517,2984
1592,2017-12-12,Toronto Raptors,25,6000,1020,2116,0.482,280,799,0.35,740,1317,0.562,443,565,0.784,217,822,1039,581,210,341,558,2763
1593,2017-12-12,Indiana Pacers,27,6505,1127,2349,0.48,276,699,0.395,851,1650,0.516,413,537,0.769,248,902,1150,628,214,361,499,2943
1594,2017-12-12,Brooklyn Nets,25,6000,973,2195,0.443,294,844,0.348,679,1351,0.503,474,647,0.733,258,882,1140,565,173,382,536,2714
1595,2017-12-12,Philadelphia 76ers,26,6240,1042,2282,0.457,274,771,0.355,768,1511,0.508,456,613,0.744,316,949,1265,673,212,440,624,2814
1596,2017-12-12,Denver Nuggets,26,6265,1034,2251,0.459,291,786,0.37,743,1465,0.507,431,589,0.732,315,853,1168,600,204,394,466,2790
1597,2017-12-12,Phoenix Suns,28,6745,1109,2482,0.447,238,713,0.334,871,1769,0.492,542,720,0.753,314,968,1282,559,198,432,621,2998
1598,2017-12-12,Minnesota Timberwolves,27,6505,1070,2270,0.471,221,610,0.362,849,1660,0.511,531,669,0.794,287,854,1141,613,232,363,478,2892
1599,2017-12-12,Orlando Magic,28,6745,1126,2424,0.465,310,844,0.367,816,1580,0.516,433,581,0.745,238,933,1171,669,215,410,568,2995
1600,2017-12-12,Washington Wizards,26,6290,1017,2214,0.459,246,669,0.368,771,1545,0.499,487,623,0.782,253,853,1106,580,206,346,565,2767
1601,2017-12-12,Los Angeles Lakers,25,6050,1012,2217,0.456,210,658,0.319,802,1559,0.514,416,593,0.702,257,899,1156,568,209,416,556,2650
1602,2017-12-12,Charlotte Hornets,26,6290,984,2237,0.44,233,658,0.354,751,1579,0.476,531,730,0.727,264,951,1215,530,161,342,493,2732
1603,2017-12-12,Los Angeles Clippers,25,6025,951,2114,0.45,264,749,0.352,687,1365,0.503,457,602,0.759,275,803,1078,509,194,359,527,2623
1604,2017-12-12,New York Knicks,26,6240,1039,2205,0.471,207,587,0.353,832,1618,0.514,419,525,0.798,276,875,1151,599,177,405,541,2704
1605,2017-12-12,Milwaukee Bucks,25,6025,972,2020,0.481,219,600,0.365,753,1420,0.53,434,573,0.757,183,772,955,554,210,321,562,2597
1606,2017-12-12,Atlanta Hawks,26,6265,1008,2216,0.455,280,734,0.381,728,1482,0.491,396,504,0.786,236,810,1046,603,228,398,525,2692
1607,2017-12-12,Portland Trail Blazers,26,6265,982,2227,0.441,243,650,0.374,739,1577,0.469,480,588,0.816,269,928,1197,470,170,367,519,2687
1608,2017-12-12,Detroit Pistons,26,6240,1012,2243,0.451,285,759,0.375,727,1484,0.49,373,505,0.739,276,830,1106,569,205,354,507,2682
1609,2017-12-12,Boston Celtics,29,6985,1082,2422,0.447,329,905,0.364,753,1517,0.496,501,650,0.771,272,1041,1313,644,222,388,568,2994
1610,2017-12-12,Utah Jazz,27,6505,1010,2224,0.454,315,816,0.386,695,1408,0.494,448,555,0.807,233,847,1080,588,263,390,552,2783
1611,2017-12-12,Oklahoma City Thunder,26,6265,979,2246,0.436,262,774,0.339,717,1472,0.487,427,591,0.723,308,820,1128,535,258,372,551,2647
1612,2017-12-12,San Antonio Spurs,27,6480,1028,2254,0.456,245,671,0.365,783,1583,0.495,440,557,0.79,289,917,1206,617,200,370,478,2741
1613,2017-12-12,Miami Heat,26,6265,969,2137,0.453,309,837,0.369,660,1300,0.508,366,477,0.767,201,872,1073,546,192,395,534,2613
1614,2017-12-12,Dallas Mavericks,27,6505,995,2276,0.437,314,869,0.361,681,1407,0.484,398,519,0.767,218,909,1127,577,181,357,537,2702
1615,2017-12-12,Memphis Grizzlies,27,6505,960,2152,0.446,251,734,0.342,709,1418,0.5,464,591,0.785,210,834,1044,566,194,373,614,2635
1616,2017-12-12,Chicago Bulls,26,6290,965,2275,0.424,273,797,0.343,692,1478,0.468,328,445,0.737,245,912,1157,579,178,344,497,2531
1617,2017-12-12,Sacramento Kings,26,6265,979,2193,0.446,217,565,0.384,762,1628,0.468,323,444,0.727,235,797,1032,529,216,372,514,2498
1618,2017-12-13,Golden State Warriors,28,6745,1232,2401,0.513,345,862,0.4,887,1539,0.576,467,579,0.807,234,1021,1255,858,239,444,565,3276
1619,2017-12-13,Houston Rockets,25,6000,987,2096,0.471,399,1081,0.369,588,1015,0.579,503,630,0.798,228,874,1102,574,237,375,513,2876
1620,2017-12-13,Cleveland Cavaliers,28,6745,1122,2325,0.483,345,914,0.377,777,1411,0.551,518,643,0.806,229,948,1177,657,194,400,535,3107
1621,2017-12-13,New Orleans Pelicans,28,6770,1167,2392,0.488,316,840,0.376,851,1552,0.548,449,602,0.746,236,972,1208,738,211,435,561,3099
1622,2017-12-13,Toronto Raptors,25,6000,1020,2116,0.482,280,799,0.35,740,1317,0.562,443,565,0.784,217,822,1039,581,210,341,558,2763
1623,2017-12-13,Indiana Pacers,27,6505,1127,2349,0.48,276,699,0.395,851,1650,0.516,413,537,0.769,248,902,1150,628,214,361,499,2943
1624,2017-12-13,Philadelphia 76ers,27,6505,1082,2362,0.458,285,797,0.358,797,1565,0.509,483,645,0.749,323,994,1317,705,218,464,642,2932
1625,2017-12-13,Brooklyn Nets,26,6240,1007,2279,0.442,304,887,0.343,703,1392,0.505,499,680,0.734,267,926,1193,591,177,396,557,2817
1626,2017-12-13,Minnesota Timberwolves,28,6770,1114,2378,0.468,226,639,0.354,888,1739,0.511,550,696,0.79,304,887,1191,632,246,373,499,3004
1627,2017-12-13,Denver Nuggets,27,6505,1074,2330,0.461,301,816,0.369,773,1514,0.511,444,603,0.736,321,891,1212,627,212,411,481,2893
1628,2017-12-13,Orlando Magic,28,6745,1126,2424,0.465,310,844,0.367,816,1580,0.516,433,581,0.745,238,933,1171,669,215,410,568,2995
1629,2017-12-13,Phoenix Suns,29,6985,1146,2572,0.446,245,745,0.329,901,1827,0.493,553,734,0.753,327,1000,1327,581,203,444,639,3090
1630,2017-12-13,Los Angeles Lakers,26,6315,1054,2319,0.455,223,693,0.322,831,1626,0.511,428,608,0.704,277,931,1208,592,215,432,575,2759
1631,2017-12-13,Washington Wizards,27,6530,1055,2309,0.457,250,691,0.362,805,1618,0.498,505,645,0.783,265,890,1155,598,214,356,591,2865
1632,2017-12-13,Charlotte Hornets,26,6290,984,2237,0.44,233,658,0.354,751,1579,0.476,531,730,0.727,264,951,1215,530,161,342,493,2732
1633,2017-12-13,Los Angeles Clippers,25,6025,951,2114,0.45,264,749,0.352,687,1365,0.503,457,602,0.759,275,803,1078,509,194,359,527,2623
1634,2017-12-13,New York Knicks,27,6505,1087,2306,0.471,216,609,0.355,871,1697,0.513,427,536,0.797,291,909,1200,624,184,419,557,2817
1635,2017-12-13,Atlanta Hawks,27,6505,1051,2308,0.455,296,770,0.384,755,1538,0.491,408,517,0.789,246,837,1083,629,236,408,542,2806
1636,2017-12-13,Milwaukee Bucks,25,6025,972,2020,0.481,219,600,0.365,753,1420,0.53,434,573,0.757,183,772,955,554,210,321,562,2597
1637,2017-12-13,Portland Trail Blazers,26,6265,982,2227,0.441,243,650,0.374,739,1577,0.469,480,588,0.816,269,928,1197,470,170,367,519,2687
1638,2017-12-13,Boston Celtics,29,6985,1082,2422,0.447,329,905,0.364,753,1517,0.496,501,650,0.771,272,1041,1313,644,222,388,568,2994
1639,2017-12-13,Utah Jazz,27,6505,1010,2224,0.454,315,816,0.386,695,1408,0.494,448,555,0.807,233,847,1080,588,263,390,552,2783
1640,2017-12-13,Detroit Pistons,27,6480,1040,2322,0.448,294,784,0.375,746,1538,0.485,392,527,0.744,287,859,1146,586,212,374,523,2766
1641,2017-12-13,Oklahoma City Thunder,26,6265,979,2246,0.436,262,774,0.339,717,1472,0.487,427,591,0.723,308,820,1128,535,258,372,551,2647
1642,2017-12-13,San Antonio Spurs,28,6720,1063,2341,0.454,252,699,0.361,811,1642,0.494,452,576,0.785,299,956,1255,637,204,380,489,2830
1643,2017-12-13,Miami Heat,26,6265,969,2137,0.453,309,837,0.369,660,1300,0.508,366,477,0.767,201,872,1073,546,192,395,534,2613
1644,2017-12-13,Dallas Mavericks,28,6745,1033,2365,0.437,323,893,0.362,710,1472,0.482,408,531,0.768,226,950,1176,594,189,363,556,2797
1645,2017-12-13,Memphis Grizzlies,27,6505,960,2152,0.446,251,734,0.342,709,1418,0.5,464,591,0.785,210,834,1044,566,194,373,614,2635
1646,2017-12-13,Chicago Bulls,26,6290,965,2275,0.424,273,797,0.343,692,1478,0.468,328,445,0.737,245,912,1157,579,178,344,497,2531
1647,2017-12-13,Sacramento Kings,27,6505,1017,2282,0.446,224,587,0.382,793,1695,0.468,339,466,0.727,246,831,1077,550,225,381,532,2597
1648,2017-12-14,Golden State Warriors,28,6745,1232,2401,0.513,345,862,0.4,887,1539,0.576,467,579,0.807,234,1021,1255,858,239,444,565,3276
1649,2017-12-14,Houston Rockets,26,6240,1026,2184,0.47,416,1126,0.369,610,1058,0.577,516,649,0.795,234,913,1147,598,244,385,531,2984
1650,2017-12-14,Cleveland Cavaliers,28,6745,1122,2325,0.483,345,914,0.377,777,1411,0.551,518,643,0.806,229,948,1177,657,194,400,535,3107
1651,2017-12-14,New Orleans Pelicans,29,7010,1212,2472,0.49,329,865,0.38,883,1607,0.549,461,617,0.747,245,1004,1249,773,216,456,577,3214
1652,2017-12-14,Toronto Raptors,26,6240,1060,2208,0.48,289,825,0.35,771,1383,0.557,469,596,0.787,225,859,1084,597,217,347,583,2878
1653,2017-12-14,Philadelphia 76ers,27,6505,1082,2362,0.458,285,797,0.358,797,1565,0.509,483,645,0.749,323,994,1317,705,218,464,642,2932
1654,2017-12-14,Indiana Pacers,28,6745,1167,2438,0.479,287,730,0.393,880,1708,0.515,417,543,0.768,259,933,1192,646,225,374,520,3038
1655,2017-12-14,Brooklyn Nets,26,6240,1007,2279,0.442,304,887,0.343,703,1392,0.505,499,680,0.734,267,926,1193,591,177,396,557,2817
1656,2017-12-14,Denver Nuggets,28,6745,1119,2421,0.462,310,844,0.367,809,1577,0.513,463,629,0.736,341,919,1260,649,220,426,501,3011
1657,2017-12-14,Minnesota Timberwolves,28,6770,1114,2378,0.468,226,639,0.354,888,1739,0.511,550,696,0.79,304,887,1191,632,246,373,499,3004
1658,2017-12-14,Orlando Magic,29,6985,1163,2512,0.463,319,871,0.366,844,1641,0.514,445,602,0.739,245,971,1216,693,221,422,581,3090
1659,2017-12-14,Phoenix Suns,30,7225,1183,2655,0.446,253,769,0.329,930,1886,0.493,580,768,0.755,337,1031,1368,601,206,455,663,3199
1660,2017-12-14,Los Angeles Lakers,26,6315,1054,2319,0.455,223,693,0.322,831,1626,0.511,428,608,0.704,277,931,1208,592,215,432,575,2759
1661,2017-12-14,Washington Wizards,28,6770,1091,2386,0.457,259,713,0.363,832,1673,0.497,517,669,0.773,271,928,1199,619,221,371,613,2958
1662,2017-12-14,Los Angeles Clippers,26,6265,990,2202,0.45,276,775,0.356,714,1427,0.5,473,622,0.76,281,848,1129,534,204,367,546,2729
1663,2017-12-14,Charlotte Hornets,27,6530,1020,2324,0.439,237,679,0.349,783,1645,0.476,551,757,0.728,276,995,1271,544,165,354,508,2828
1664,2017-12-14,New York Knicks,27,6505,1087,2306,0.471,216,609,0.355,871,1697,0.513,427,536,0.797,291,909,1200,624,184,419,557,2817
1665,2017-12-14,Milwaukee Bucks,26,6265,1016,2115,0.48,227,627,0.362,789,1488,0.53,446,592,0.753,198,795,993,577,224,330,575,2705
1666,2017-12-14,Atlanta Hawks,27,6505,1051,2308,0.455,296,770,0.384,755,1538,0.491,408,517,0.789,246,837,1083,629,236,408,542,2806
1667,2017-12-14,Boston Celtics,30,7225,1129,2501,0.451,340,930,0.366,789,1571,0.502,520,674,0.772,276,1067,1343,673,232,401,588,3118
1668,2017-12-14,Portland Trail Blazers,27,6505,1018,2299,0.443,253,678,0.373,765,1621,0.472,500,611,0.818,274,956,1230,484,177,378,540,2789
1669,2017-12-14,Utah Jazz,28,6745,1052,2315,0.454,324,846,0.383,728,1469,0.496,455,562,0.81,238,890,1128,612,266,406,571,2883
1670,2017-12-14,Detroit Pistons,27,6480,1040,2322,0.448,294,784,0.375,746,1538,0.485,392,527,0.744,287,859,1146,586,212,374,523,2766
1671,2017-12-14,Oklahoma City Thunder,27,6505,1015,2334,0.435,275,803,0.342,740,1531,0.483,442,615,0.719,325,855,1180,561,268,385,563,2747
1672,2017-12-14,San Antonio Spurs,28,6720,1063,2341,0.454,252,699,0.361,811,1642,0.494,452,576,0.785,299,956,1255,637,204,380,489,2830
1673,2017-12-14,Miami Heat,27,6505,1003,2209,0.454,322,867,0.371,681,1342,0.507,380,500,0.76,211,898,1109,565,198,410,555,2708
1674,2017-12-14,Dallas Mavericks,28,6745,1033,2365,0.437,323,893,0.362,710,1472,0.482,408,531,0.768,226,950,1176,594,189,363,556,2797
1675,2017-12-14,Chicago Bulls,27,6530,1006,2368,0.425,280,814,0.344,726,1554,0.467,342,466,0.734,254,949,1203,600,187,353,511,2634
1676,2017-12-14,Memphis Grizzlies,28,6745,991,2233,0.444,261,762,0.343,730,1471,0.496,479,607,0.789,220,871,1091,584,200,389,637,2722
1677,2017-12-14,Sacramento Kings,27,6505,1017,2282,0.446,224,587,0.382,793,1695,0.468,339,466,0.727,246,831,1077,550,225,381,532,2597
1678,2017-12-15,Golden State Warriors,29,6985,1279,2479,0.516,356,884,0.403,923,1595,0.579,474,588,0.806,238,1058,1296,893,246,460,587,3388
1679,2017-12-15,Houston Rockets,26,6240,1026,2184,0.47,416,1126,0.369,610,1058,0.577,516,649,0.795,234,913,1147,598,244,385,531,2984
1680,2017-12-15,Cleveland Cavaliers,29,6985,1165,2411,0.483,360,950,0.379,805,1461,0.551,538,668,0.805,237,979,1216,689,204,414,551,3228
1681,2017-12-15,New Orleans Pelicans,29,7010,1212,2472,0.49,329,865,0.38,883,1607,0.549,461,617,0.747,245,1004,1249,773,216,456,577,3214
1682,2017-12-15,Toronto Raptors,26,6240,1060,2208,0.48,289,825,0.35,771,1383,0.557,469,596,0.787,225,859,1084,597,217,347,583,2878
1683,2017-12-15,Philadelphia 76ers,27,6505,1082,2362,0.458,285,797,0.358,797,1565,0.509,483,645,0.749,323,994,1317,705,218,464,642,2932
1684,2017-12-15,Indiana Pacers,28,6745,1167,2438,0.479,287,730,0.393,880,1708,0.515,417,543,0.768,259,933,1192,646,225,374,520,3038
1685,2017-12-15,Brooklyn Nets,27,6480,1044,2362,0.442,316,929,0.34,728,1433,0.508,517,703,0.735,278,958,1236,612,187,413,578,2921
1686,2017-12-15,Minnesota Timberwolves,29,7010,1160,2460,0.472,236,660,0.358,924,1800,0.513,567,716,0.792,312,918,1230,661,258,382,518,3123
1687,2017-12-15,Denver Nuggets,28,6745,1119,2421,0.462,310,844,0.367,809,1577,0.513,463,629,0.736,341,919,1260,649,220,426,501,3011
1688,2017-12-15,Orlando Magic,29,6985,1163,2512,0.463,319,871,0.366,844,1641,0.514,445,602,0.739,245,971,1216,693,221,422,581,3090
1689,2017-12-15,Phoenix Suns,30,7225,1183,2655,0.446,253,769,0.329,930,1886,0.493,580,768,0.755,337,1031,1368,601,206,455,663,3199
1690,2017-12-15,Los Angeles Lakers,27,6555,1101,2414,0.456,232,724,0.32,869,1690,0.514,437,622,0.703,293,964,1257,625,222,450,595,2871
1691,2017-12-15,Washington Wizards,28,6770,1091,2386,0.457,259,713,0.363,832,1673,0.497,517,669,0.773,271,928,1199,619,221,371,613,2958
1692,2017-12-15,Los Angeles Clippers,26,6265,990,2202,0.45,276,775,0.356,714,1427,0.5,473,622,0.76,281,848,1129,534,204,367,546,2729
1693,2017-12-15,Charlotte Hornets,27,6530,1020,2324,0.439,237,679,0.349,783,1645,0.476,551,757,0.728,276,995,1271,544,165,354,508,2828
1694,2017-12-15,New York Knicks,28,6745,1128,2395,0.471,226,629,0.359,902,1766,0.511,446,558,0.799,303,937,1240,647,195,432,580,2928
1695,2017-12-15,Milwaukee Bucks,26,6265,1016,2115,0.48,227,627,0.362,789,1488,0.53,446,592,0.753,198,795,993,577,224,330,575,2705
1696,2017-12-15,Boston Celtics,30,7225,1129,2501,0.451,340,930,0.366,789,1571,0.502,520,674,0.772,276,1067,1343,673,232,401,588,3118
1697,2017-12-15,Atlanta Hawks,28,6745,1083,2378,0.455,307,801,0.383,776,1577,0.492,424,543,0.781,253,864,1117,657,242,424,554,2897
1698,2017-12-15,Portland Trail Blazers,27,6505,1018,2299,0.443,253,678,0.373,765,1621,0.472,500,611,0.818,274,956,1230,484,177,378,540,2789
1699,2017-12-15,Utah Jazz,28,6745,1052,2315,0.454,324,846,0.383,728,1469,0.496,455,562,0.81,238,890,1128,612,266,406,571,2883
1700,2017-12-15,Detroit Pistons,28,6720,1081,2412,0.448,307,814,0.377,774,1598,0.484,402,539,0.746,301,891,1192,612,222,389,546,2871
1701,2017-12-15,Oklahoma City Thunder,27,6505,1015,2334,0.435,275,803,0.342,740,1531,0.483,442,615,0.719,325,855,1180,561,268,385,563,2747
1702,2017-12-15,San Antonio Spurs,28,6720,1063,2341,0.454,252,699,0.361,811,1642,0.494,452,576,0.785,299,956,1255,637,204,380,489,2830
1703,2017-12-15,Miami Heat,27,6505,1003,2209,0.454,322,867,0.371,681,1342,0.507,380,500,0.76,211,898,1109,565,198,410,555,2708
1704,2017-12-15,Dallas Mavericks,29,6985,1070,2447,0.437,333,922,0.361,737,1525,0.483,421,548,0.768,234,973,1207,619,196,374,572,2894
1705,2017-12-15,Chicago Bulls,27,6530,1006,2368,0.425,280,814,0.344,726,1554,0.467,342,466,0.734,254,949,1203,600,187,353,511,2634
1706,2017-12-15,Memphis Grizzlies,28,6745,991,2233,0.444,261,762,0.343,730,1471,0.496,479,607,0.789,220,871,1091,584,200,389,637,2722
1707,2017-12-15,Sacramento Kings,28,6745,1053,2369,0.444,238,620,0.384,815,1749,0.466,349,478,0.73,261,858,1119,574,229,395,553,2693
1708,2017-12-16,Golden State Warriors,29,6985,1279,2479,0.516,356,884,0.403,923,1595,0.579,474,588,0.806,238,1058,1296,893,246,460,587,3388
1709,2017-12-16,Houston Rockets,27,6480,1069,2275,0.47,434,1176,0.369,635,1099,0.578,536,674,0.795,246,946,1192,618,259,398,547,3108
1710,2017-12-16,Cleveland Cavaliers,29,6985,1165,2411,0.483,360,950,0.379,805,1461,0.551,538,668,0.805,237,979,1216,689,204,414,551,3228
1711,2017-12-16,Toronto Raptors,27,6480,1114,2305,0.483,296,853,0.347,818,1452,0.563,474,605,0.783,236,893,1129,623,228,355,599,2998
1712,2017-12-16,New Orleans Pelicans,30,7275,1255,2563,0.49,344,899,0.383,911,1664,0.547,471,631,0.746,252,1039,1291,800,224,475,592,3325
1713,2017-12-16,Philadelphia 76ers,28,6820,1126,2462,0.457,298,843,0.353,828,1619,0.511,499,665,0.75,330,1037,1367,740,231,483,662,3049
1714,2017-12-16,Indiana Pacers,29,6985,1202,2525,0.476,296,760,0.389,906,1765,0.513,436,568,0.768,274,969,1243,667,231,387,534,3136
1715,2017-12-16,Denver Nuggets,29,7010,1165,2521,0.462,326,880,0.37,839,1641,0.511,472,643,0.734,352,956,1308,679,232,441,518,3128
1716,2017-12-16,Minnesota Timberwolves,29,7010,1160,2460,0.472,236,660,0.358,924,1800,0.513,567,716,0.792,312,918,1230,661,258,382,518,3123
1717,2017-12-16,Brooklyn Nets,28,6720,1076,2438,0.441,323,952,0.339,753,1486,0.507,533,722,0.738,284,989,1273,628,191,435,592,3008
1718,2017-12-16,Phoenix Suns,30,7225,1183,2655,0.446,253,769,0.329,930,1886,0.493,580,768,0.755,337,1031,1368,601,206,455,663,3199
1719,2017-12-16,Los Angeles Lakers,27,6555,1101,2414,0.456,232,724,0.32,869,1690,0.514,437,622,0.703,293,964,1257,625,222,450,595,2871
1720,2017-12-16,Orlando Magic,30,7225,1195,2596,0.46,329,900,0.366,866,1696,0.511,459,621,0.739,253,1008,1261,708,228,437,599,3178
1721,2017-12-16,Washington Wizards,29,7010,1130,2474,0.457,266,744,0.358,864,1730,0.499,532,692,0.769,282,967,1249,640,233,390,639,3058
1722,2017-12-16,New York Knicks,28,6745,1128,2395,0.471,226,629,0.359,902,1766,0.511,446,558,0.799,303,937,1240,647,195,432,580,2928
1723,2017-12-16,Charlotte Hornets,28,6770,1054,2407,0.438,247,706,0.35,807,1701,0.474,571,784,0.728,286,1026,1312,565,172,370,521,2926
1724,2017-12-16,Los Angeles Clippers,27,6505,1023,2288,0.447,283,799,0.354,740,1489,0.497,491,651,0.754,293,883,1176,551,216,387,566,2820
1725,2017-12-16,Milwaukee Bucks,27,6505,1056,2198,0.48,236,660,0.358,820,1538,0.533,466,621,0.75,207,829,1036,601,230,341,599,2814
1726,2017-12-16,Boston Celtics,31,7465,1164,2587,0.45,349,961,0.363,815,1626,0.501,536,693,0.773,278,1096,1374,693,242,409,606,3213
1727,2017-12-16,Atlanta Hawks,29,6985,1117,2455,0.455,319,832,0.383,798,1623,0.492,438,559,0.784,260,892,1152,684,254,441,573,2991
1728,2017-12-16,Utah Jazz,29,6985,1092,2398,0.455,337,871,0.387,755,1527,0.494,469,580,0.809,247,936,1183,631,272,421,591,2990
1729,2017-12-16,Portland Trail Blazers,28,6745,1055,2385,0.442,261,696,0.375,794,1689,0.47,513,626,0.819,280,995,1275,502,184,392,560,2884
1730,2017-12-16,Detroit Pistons,29,6960,1120,2505,0.447,320,846,0.378,800,1659,0.482,415,556,0.746,312,924,1236,634,229,398,567,2975
1731,2017-12-16,Oklahoma City Thunder,28,6820,1062,2447,0.434,290,838,0.346,772,1609,0.48,452,634,0.713,343,897,1240,589,278,403,584,2866
1732,2017-12-16,San Antonio Spurs,29,6960,1109,2435,0.455,262,725,0.361,847,1710,0.495,459,589,0.779,311,983,1294,659,214,397,506,2939
1733,2017-12-16,Miami Heat,28,6745,1042,2287,0.456,333,898,0.371,709,1389,0.51,395,517,0.764,216,934,1150,590,208,426,577,2812
1734,2017-12-16,Dallas Mavericks,29,6985,1070,2447,0.437,333,922,0.361,737,1525,0.483,421,548,0.768,234,973,1207,619,196,374,572,2894
1735,2017-12-16,Chicago Bulls,28,6770,1048,2454,0.427,288,836,0.344,760,1618,0.47,365,501,0.729,268,985,1253,624,195,365,537,2749
1736,2017-12-16,Memphis Grizzlies,29,6985,1027,2311,0.444,273,787,0.347,754,1524,0.495,491,624,0.787,230,904,1134,605,212,410,661,2818
1737,2017-12-16,Sacramento Kings,28,6745,1053,2369,0.444,238,620,0.384,815,1749,0.466,349,478,0.73,261,858,1119,574,229,395,553,2693
1738,2017-12-17,Golden State Warriors,29,6985,1279,2479,0.516,356,884,0.403,923,1595,0.579,474,588,0.806,238,1058,1296,893,246,460,587,3388
1739,2017-12-17,Houston Rockets,28,6720,1104,2351,0.47,445,1211,0.367,659,1140,0.578,570,716,0.796,250,980,1230,634,266,413,570,3223
1740,2017-12-17,Cleveland Cavaliers,30,7225,1207,2490,0.485,370,972,0.381,837,1518,0.551,553,685,0.807,245,1012,1257,719,213,426,566,3337
1741,2017-12-17,Toronto Raptors,27,6480,1114,2305,0.483,296,853,0.347,818,1452,0.563,474,605,0.783,236,893,1129,623,228,355,599,2998
1742,2017-12-17,New Orleans Pelicans,30,7275,1255,2563,0.49,344,899,0.383,911,1664,0.547,471,631,0.746,252,1039,1291,800,224,475,592,3325
1743,2017-12-17,Philadelphia 76ers,28,6820,1126,2462,0.457,298,843,0.353,828,1619,0.511,499,665,0.75,330,1037,1367,740,231,483,662,3049
1744,2017-12-17,Indiana Pacers,29,6985,1202,2525,0.476,296,760,0.389,906,1765,0.513,436,568,0.768,274,969,1243,667,231,387,534,3136
1745,2017-12-17,Denver Nuggets,29,7010,1165,2521,0.462,326,880,0.37,839,1641,0.511,472,643,0.734,352,956,1308,679,232,441,518,3128
1746,2017-12-17,Minnesota Timberwolves,30,7250,1200,2555,0.47,245,687,0.357,955,1868,0.511,584,740,0.789,322,939,1261,682,272,388,537,3229
1747,2017-12-17,Brooklyn Nets,28,6720,1076,2438,0.441,323,952,0.339,753,1486,0.507,533,722,0.738,284,989,1273,628,191,435,592,3008
1748,2017-12-17,Phoenix Suns,31,7465,1216,2727,0.446,264,793,0.333,952,1934,0.492,611,803,0.761,350,1070,1420,623,210,478,684,3307
1749,2017-12-17,Los Angeles Lakers,27,6555,1101,2414,0.456,232,724,0.32,869,1690,0.514,437,622,0.703,293,964,1257,625,222,450,595,2871
1750,2017-12-17,Orlando Magic,30,7225,1195,2596,0.46,329,900,0.366,866,1696,0.511,459,621,0.739,253,1008,1261,708,228,437,599,3178
1751,2017-12-17,Washington Wizards,29,7010,1130,2474,0.457,266,744,0.358,864,1730,0.499,532,692,0.769,282,967,1249,640,233,390,639,3058
1752,2017-12-17,New York Knicks,29,6985,1166,2464,0.473,240,652,0.368,926,1812,0.511,467,584,0.8,309,966,1275,668,204,445,602,3039
1753,2017-12-17,Milwaukee Bucks,28,6745,1094,2280,0.48,244,687,0.355,850,1593,0.534,493,654,0.754,215,861,1076,618,242,355,633,2925
1754,2017-12-17,Charlotte Hornets,29,7010,1087,2503,0.434,254,737,0.345,833,1766,0.472,589,812,0.725,299,1064,1363,583,181,376,542,3017
1755,2017-12-17,Los Angeles Clippers,28,6745,1058,2368,0.447,291,827,0.352,767,1541,0.498,498,665,0.749,305,917,1222,569,219,404,588,2905
1756,2017-12-17,Boston Celtics,32,7705,1203,2667,0.451,363,991,0.366,840,1676,0.501,546,707,0.772,292,1124,1416,714,248,425,625,3315
1757,2017-12-17,Atlanta Hawks,29,6985,1117,2455,0.455,319,832,0.383,798,1623,0.492,438,559,0.784,260,892,1152,684,254,441,573,2991
1758,2017-12-17,Utah Jazz,30,7225,1129,2479,0.455,354,905,0.391,775,1574,0.492,478,594,0.805,258,963,1221,655,281,433,605,3090
1759,2017-12-17,Portland Trail Blazers,29,6985,1092,2464,0.443,271,720,0.376,821,1744,0.471,522,644,0.811,285,1037,1322,521,186,412,581,2977
1760,2017-12-17,Detroit Pistons,29,6960,1120,2505,0.447,320,846,0.378,800,1659,0.482,415,556,0.746,312,924,1236,634,229,398,567,2975
1761,2017-12-17,Oklahoma City Thunder,29,7060,1098,2532,0.434,302,865,0.349,796,1667,0.478,464,654,0.709,359,923,1282,607,287,417,606,2962
1762,2017-12-17,San Antonio Spurs,30,7200,1148,2521,0.455,267,750,0.356,881,1771,0.497,474,607,0.781,320,1015,1335,673,219,404,520,3037
1763,2017-12-17,Miami Heat,29,6985,1073,2369,0.453,345,933,0.37,728,1436,0.507,411,538,0.764,225,962,1187,612,218,434,592,2902
1764,2017-12-17,Dallas Mavericks,30,7225,1109,2527,0.439,343,950,0.361,766,1577,0.486,429,557,0.77,238,1007,1245,642,200,383,588,2990
1765,2017-12-17,Chicago Bulls,28,6770,1048,2454,0.427,288,836,0.344,760,1618,0.47,365,501,0.729,268,985,1253,624,195,365,537,2749
1766,2017-12-17,Memphis Grizzlies,30,7225,1059,2390,0.443,287,821,0.35,772,1569,0.492,506,641,0.789,240,932,1172,623,220,423,680,2911
1767,2017-12-17,Sacramento Kings,28,6745,1053,2369,0.444,238,620,0.384,815,1749,0.466,349,478,0.73,261,858,1119,574,229,395,553,2693
1768,2017-12-18,Golden State Warriors,29,6985,1279,2479,0.516,356,884,0.403,923,1595,0.579,474,588,0.806,238,1058,1296,893,246,460,587,3388
1769,2017-12-18,Houston Rockets,28,6720,1104,2351,0.47,445,1211,0.367,659,1140,0.578,570,716,0.796,250,980,1230,634,266,413,570,3223
1770,2017-12-18,Cleveland Cavaliers,31,7465,1248,2577,0.484,384,1006,0.382,864,1571,0.55,563,697,0.808,249,1050,1299,743,219,434,582,3443
1771,2017-12-18,Toronto Raptors,28,6720,1150,2390,0.481,309,883,0.35,841,1507,0.558,497,633,0.785,248,927,1175,643,236,367,612,3106
1772,2017-12-18,New Orleans Pelicans,30,7275,1255,2563,0.49,344,899,0.383,911,1664,0.547,471,631,0.746,252,1039,1291,800,224,475,592,3325
1773,2017-12-18,Philadelphia 76ers,28,6820,1126,2462,0.457,298,843,0.353,828,1619,0.511,499,665,0.75,330,1037,1367,740,231,483,662,3049
1774,2017-12-18,Indiana Pacers,30,7225,1245,2601,0.479,304,778,0.391,941,1823,0.516,451,587,0.768,280,1006,1286,688,237,402,554,3245
1775,2017-12-18,Denver Nuggets,29,7010,1165,2521,0.462,326,880,0.37,839,1641,0.511,472,643,0.734,352,956,1308,679,232,441,518,3128
1776,2017-12-18,Minnesota Timberwolves,30,7250,1200,2555,0.47,245,687,0.357,955,1868,0.511,584,740,0.789,322,939,1261,682,272,388,537,3229
1777,2017-12-18,Brooklyn Nets,29,6960,1110,2519,0.441,335,985,0.34,775,1534,0.505,550,743,0.74,291,1011,1302,654,198,444,609,3105
1778,2017-12-18,Phoenix Suns,31,7465,1216,2727,0.446,264,793,0.333,952,1934,0.492,611,803,0.761,350,1070,1420,623,210,478,684,3307
1779,2017-12-18,Los Angeles Lakers,27,6555,1101,2414,0.456,232,724,0.32,869,1690,0.514,437,622,0.703,293,964,1257,625,222,450,595,2871
1780,2017-12-18,Orlando Magic,31,7465,1236,2681,0.461,346,933,0.371,890,1748,0.509,470,638,0.737,261,1040,1301,735,234,453,615,3288
1781,2017-12-18,Washington Wizards,30,7250,1169,2565,0.456,278,777,0.358,891,1788,0.498,541,708,0.764,295,1005,1300,660,237,400,657,3157
1782,2017-12-18,New York Knicks,29,6985,1166,2464,0.473,240,652,0.368,926,1812,0.511,467,584,0.8,309,966,1275,668,204,445,602,3039
1783,2017-12-18,Milwaukee Bucks,28,6745,1094,2280,0.48,244,687,0.355,850,1593,0.534,493,654,0.754,215,861,1076,618,242,355,633,2925
1784,2017-12-18,Charlotte Hornets,29,7010,1087,2503,0.434,254,737,0.345,833,1766,0.472,589,812,0.725,299,1064,1363,583,181,376,542,3017
1785,2017-12-18,Los Angeles Clippers,28,6745,1058,2368,0.447,291,827,0.352,767,1541,0.498,498,665,0.749,305,917,1222,569,219,404,588,2905
1786,2017-12-18,Boston Celtics,32,7705,1203,2667,0.451,363,991,0.366,840,1676,0.501,546,707,0.772,292,1124,1416,714,248,425,625,3315
1787,2017-12-18,Atlanta Hawks,29,6985,1117,2455,0.455,319,832,0.383,798,1623,0.492,438,559,0.784,260,892,1152,684,254,441,573,2991
1788,2017-12-18,Detroit Pistons,30,7200,1162,2594,0.448,337,880,0.383,825,1714,0.481,428,572,0.748,319,956,1275,661,240,411,584,3089
1789,2017-12-18,Utah Jazz,30,7225,1129,2479,0.455,354,905,0.391,775,1574,0.492,478,594,0.805,258,963,1221,655,281,433,605,3090
1790,2017-12-18,Portland Trail Blazers,29,6985,1092,2464,0.443,271,720,0.376,821,1744,0.471,522,644,0.811,285,1037,1322,521,186,412,581,2977
1791,2017-12-18,Oklahoma City Thunder,29,7060,1098,2532,0.434,302,865,0.349,796,1667,0.478,464,654,0.709,359,923,1282,607,287,417,606,2962
1792,2017-12-18,San Antonio Spurs,30,7200,1148,2521,0.455,267,750,0.356,881,1771,0.497,474,607,0.781,320,1015,1335,673,219,404,520,3037
1793,2017-12-18,Miami Heat,29,6985,1073,2369,0.453,345,933,0.37,728,1436,0.507,411,538,0.764,225,962,1187,612,218,434,592,2902
1794,2017-12-18,Dallas Mavericks,30,7225,1109,2527,0.439,343,950,0.361,766,1577,0.486,429,557,0.77,238,1007,1245,642,200,383,588,2990
1795,2017-12-18,Chicago Bulls,28,6770,1048,2454,0.427,288,836,0.344,760,1618,0.47,365,501,0.729,268,985,1253,624,195,365,537,2749
1796,2017-12-18,Memphis Grizzlies,30,7225,1059,2390,0.443,287,821,0.35,772,1569,0.492,506,641,0.789,240,932,1172,623,220,423,680,2911
1797,2017-12-18,Sacramento Kings,29,6985,1091,2450,0.445,249,646,0.385,842,1804,0.467,355,486,0.73,267,884,1151,599,238,410,572,2786
1798,2017-12-19,Golden State Warriors,30,7250,1322,2586,0.511,367,918,0.4,955,1668,0.573,493,609,0.81,253,1104,1357,918,252,474,613,3504
1799,2017-12-19,Houston Rockets,29,6960,1144,2428,0.471,462,1254,0.368,682,1174,0.581,593,743,0.798,262,1020,1282,659,271,427,583,3343
1800,2017-12-19,Cleveland Cavaliers,31,7465,1248,2577,0.484,384,1006,0.382,864,1571,0.55,563,697,0.808,249,1050,1299,743,219,434,582,3443
1801,2017-12-19,Toronto Raptors,28,6720,1150,2390,0.481,309,883,0.35,841,1507,0.558,497,633,0.785,248,927,1175,643,236,367,612,3106
1802,2017-12-19,New Orleans Pelicans,30,7275,1255,2563,0.49,344,899,0.383,911,1664,0.547,471,631,0.746,252,1039,1291,800,224,475,592,3325
1803,2017-12-19,Philadelphia 76ers,29,7060,1170,2553,0.458,312,876,0.356,858,1677,0.512,512,683,0.75,339,1075,1414,770,240,503,685,3164
1804,2017-12-19,Indiana Pacers,31,7465,1282,2680,0.478,311,799,0.389,971,1881,0.516,481,625,0.77,289,1035,1324,702,249,414,570,3356
1805,2017-12-19,Minnesota Timberwolves,31,7490,1242,2646,0.469,252,706,0.357,990,1940,0.51,601,761,0.79,333,960,1293,701,278,398,551,3337
1806,2017-12-19,Denver Nuggets,30,7250,1202,2607,0.461,338,917,0.369,864,1690,0.511,480,655,0.733,360,993,1353,700,240,452,536,3222
1807,2017-12-19,Brooklyn Nets,29,6960,1110,2519,0.441,335,985,0.34,775,1534,0.505,550,743,0.74,291,1011,1302,654,198,444,609,3105
1808,2017-12-19,Los Angeles Lakers,28,6820,1142,2506,0.456,242,749,0.323,900,1757,0.512,459,657,0.699,300,1002,1302,648,231,462,621,2985
1809,2017-12-19,Phoenix Suns,32,7705,1251,2806,0.446,274,818,0.335,977,1988,0.491,628,825,0.761,357,1112,1469,640,219,496,709,3404
1810,2017-12-19,Orlando Magic,31,7465,1236,2681,0.461,346,933,0.371,890,1748,0.509,470,638,0.737,261,1040,1301,735,234,453,615,3288
1811,2017-12-19,Washington Wizards,30,7250,1169,2565,0.456,278,777,0.358,891,1788,0.498,541,708,0.764,295,1005,1300,660,237,400,657,3157
1812,2017-12-19,Milwaukee Bucks,28,6745,1094,2280,0.48,244,687,0.355,850,1593,0.534,493,654,0.754,215,861,1076,618,242,355,633,2925
1813,2017-12-19,New York Knicks,30,7225,1202,2550,0.471,243,670,0.363,959,1880,0.51,483,604,0.8,319,993,1312,689,214,462,618,3130
1814,2017-12-19,Charlotte Hornets,30,7250,1130,2591,0.436,263,757,0.347,867,1834,0.473,603,828,0.728,311,1099,1410,613,191,395,558,3126
1815,2017-12-19,Boston Celtics,33,7945,1247,2746,0.454,379,1017,0.373,868,1729,0.502,554,721,0.768,298,1156,1454,740,254,444,656,3427
1816,2017-12-19,Atlanta Hawks,30,7225,1155,2538,0.455,327,854,0.383,828,1684,0.492,464,590,0.786,270,921,1191,709,262,453,596,3101
1817,2017-12-19,Los Angeles Clippers,29,6985,1095,2452,0.447,300,856,0.35,795,1596,0.498,506,681,0.743,313,951,1264,590,231,421,611,2996
1818,2017-12-19,Detroit Pistons,30,7200,1162,2594,0.448,337,880,0.383,825,1714,0.481,428,572,0.748,319,956,1275,661,240,411,584,3089
1819,2017-12-19,Utah Jazz,31,7465,1171,2570,0.456,362,932,0.388,809,1638,0.494,485,602,0.806,263,990,1253,672,293,439,627,3189
1820,2017-12-19,Portland Trail Blazers,30,7225,1138,2548,0.447,281,744,0.378,857,1804,0.475,527,649,0.812,292,1070,1362,547,192,429,600,3084
1821,2017-12-19,Oklahoma City Thunder,30,7300,1137,2613,0.435,309,889,0.348,828,1724,0.48,474,669,0.709,365,957,1322,620,296,427,619,3057
1822,2017-12-19,San Antonio Spurs,31,7440,1188,2603,0.456,276,774,0.357,912,1829,0.499,494,632,0.782,328,1052,1380,695,226,420,539,3146
1823,2017-12-19,Miami Heat,30,7225,1109,2448,0.453,352,958,0.367,757,1490,0.508,436,568,0.768,233,996,1229,631,227,453,620,3006
1824,2017-12-19,Dallas Mavericks,31,7465,1141,2615,0.436,354,987,0.359,787,1628,0.483,445,574,0.775,246,1041,1287,663,210,398,606,3081
1825,2017-12-19,Chicago Bulls,29,7010,1092,2546,0.429,301,864,0.348,791,1682,0.47,381,520,0.733,273,1019,1292,651,204,380,553,2866
1826,2017-12-19,Memphis Grizzlies,30,7225,1059,2390,0.443,287,821,0.35,772,1569,0.492,506,641,0.789,240,932,1172,623,220,423,680,2911
1827,2017-12-19,Sacramento Kings,29,6985,1091,2450,0.445,249,646,0.385,842,1804,0.467,355,486,0.73,267,884,1151,599,238,410,572,2786
1828,2017-12-20,Golden State Warriors,30,7250,1322,2586,0.511,367,918,0.4,955,1668,0.573,493,609,0.81,253,1104,1357,918,252,474,613,3504
1829,2017-12-20,Houston Rockets,29,6960,1144,2428,0.471,462,1254,0.368,682,1174,0.581,593,743,0.798,262,1020,1282,659,271,427,583,3343
1830,2017-12-20,Cleveland Cavaliers,32,7705,1288,2657,0.485,400,1047,0.382,888,1610,0.552,583,721,0.809,256,1080,1336,769,228,448,602,3559
1831,2017-12-20,Toronto Raptors,28,6720,1150,2390,0.481,309,883,0.35,841,1507,0.558,497,633,0.785,248,927,1175,643,236,367,612,3106
1832,2017-12-20,New Orleans Pelicans,31,7515,1289,2643,0.488,349,919,0.38,940,1724,0.545,504,671,0.751,263,1070,1333,820,231,491,608,3431
1833,2017-12-20,Philadelphia 76ers,30,7300,1204,2634,0.457,322,911,0.353,882,1723,0.512,529,707,0.748,352,1115,1467,791,247,522,704,3259
1834,2017-12-20,Indiana Pacers,31,7465,1282,2680,0.478,311,799,0.389,971,1881,0.516,481,625,0.77,289,1035,1324,702,249,414,570,3356
1835,2017-12-20,Minnesota Timberwolves,31,7490,1242,2646,0.469,252,706,0.357,990,1940,0.51,601,761,0.79,333,960,1293,701,278,398,551,3337
1836,2017-12-20,Denver Nuggets,30,7250,1202,2607,0.461,338,917,0.369,864,1690,0.511,480,655,0.733,360,993,1353,700,240,452,536,3222
1837,2017-12-20,Brooklyn Nets,29,6960,1110,2519,0.441,335,985,0.34,775,1534,0.505,550,743,0.74,291,1011,1302,654,198,444,609,3105
1838,2017-12-20,Los Angeles Lakers,28,6820,1142,2506,0.456,242,749,0.323,900,1757,0.512,459,657,0.699,300,1002,1302,648,231,462,621,2985
1839,2017-12-20,Phoenix Suns,32,7705,1251,2806,0.446,274,818,0.335,977,1988,0.491,628,825,0.761,357,1112,1469,640,219,496,709,3404
1840,2017-12-20,Orlando Magic,31,7465,1236,2681,0.461,346,933,0.371,890,1748,0.509,470,638,0.737,261,1040,1301,735,234,453,615,3288
1841,2017-12-20,Washington Wizards,31,7490,1215,2657,0.457,292,812,0.36,923,1845,0.5,551,722,0.763,305,1039,1344,689,245,416,688,3273
1842,2017-12-20,Milwaukee Bucks,29,6985,1137,2362,0.481,255,716,0.356,882,1646,0.536,515,681,0.756,223,893,1116,645,254,369,651,3044
1843,2017-12-20,New York Knicks,30,7225,1202,2550,0.471,243,670,0.363,959,1880,0.51,483,604,0.8,319,993,1312,689,214,462,618,3130
1844,2017-12-20,Charlotte Hornets,30,7250,1130,2591,0.436,263,757,0.347,867,1834,0.473,603,828,0.728,311,1099,1410,613,191,395,558,3126
1845,2017-12-20,Boston Celtics,33,7945,1247,2746,0.454,379,1017,0.373,868,1729,0.502,554,721,0.768,298,1156,1454,740,254,444,656,3427
1846,2017-12-20,Atlanta Hawks,30,7225,1155,2538,0.455,327,854,0.383,828,1684,0.492,464,590,0.786,270,921,1191,709,262,453,596,3101
1847,2017-12-20,Los Angeles Clippers,29,6985,1095,2452,0.447,300,856,0.35,795,1596,0.498,506,681,0.743,313,951,1264,590,231,421,611,2996
1848,2017-12-20,Detroit Pistons,30,7200,1162,2594,0.448,337,880,0.383,825,1714,0.481,428,572,0.748,319,956,1275,661,240,411,584,3089
1849,2017-12-20,Utah Jazz,31,7465,1171,2570,0.456,362,932,0.388,809,1638,0.494,485,602,0.806,263,990,1253,672,293,439,627,3189
1850,2017-12-20,Portland Trail Blazers,30,7225,1138,2548,0.447,281,744,0.378,857,1804,0.475,527,649,0.812,292,1070,1362,547,192,429,600,3084
1851,2017-12-20,Oklahoma City Thunder,30,7300,1137,2613,0.435,309,889,0.348,828,1724,0.48,474,669,0.709,365,957,1322,620,296,427,619,3057
1852,2017-12-20,San Antonio Spurs,31,7440,1188,2603,0.456,276,774,0.357,912,1829,0.499,494,632,0.782,328,1052,1380,695,226,420,539,3146
1853,2017-12-20,Miami Heat,30,7225,1109,2448,0.453,352,958,0.367,757,1490,0.508,436,568,0.768,233,996,1229,631,227,453,620,3006
1854,2017-12-20,Dallas Mavericks,31,7465,1141,2615,0.436,354,987,0.359,787,1628,0.483,445,574,0.775,246,1041,1287,663,210,398,606,3081
1855,2017-12-20,Chicago Bulls,29,7010,1092,2546,0.429,301,864,0.348,791,1682,0.47,381,520,0.733,273,1019,1292,651,204,380,553,2866
1856,2017-12-20,Memphis Grizzlies,30,7225,1059,2390,0.443,287,821,0.35,772,1569,0.492,506,641,0.789,240,932,1172,623,220,423,680,2911
1857,2017-12-20,Sacramento Kings,30,7225,1132,2541,0.445,256,673,0.38,876,1868,0.469,367,509,0.721,276,914,1190,620,249,422,592,2887
1858,2017-12-21,Golden State Warriors,31,7490,1356,2660,0.51,374,939,0.398,982,1721,0.571,515,634,0.812,267,1134,1401,944,261,490,632,3601
1859,2017-12-21,Houston Rockets,30,7200,1181,2518,0.469,479,1296,0.37,702,1222,0.574,618,775,0.797,274,1055,1329,678,278,441,613,3459
1860,2017-12-21,Toronto Raptors,29,6960,1199,2481,0.483,325,916,0.355,874,1565,0.558,512,651,0.786,258,960,1218,678,242,381,639,3235
1861,2017-12-21,Cleveland Cavaliers,32,7705,1288,2657,0.485,400,1047,0.382,888,1610,0.552,583,721,0.809,256,1080,1336,769,228,448,602,3559
1862,2017-12-21,New Orleans Pelicans,31,7515,1289,2643,0.488,349,919,0.38,940,1724,0.545,504,671,0.751,263,1070,1333,820,231,491,608,3431
1863,2017-12-21,Philadelphia 76ers,30,7300,1204,2634,0.457,322,911,0.353,882,1723,0.512,529,707,0.748,352,1115,1467,791,247,522,704,3259
1864,2017-12-21,Indiana Pacers,32,7705,1322,2762,0.479,318,820,0.388,1004,1942,0.517,499,644,0.775,297,1064,1361,721,254,423,588,3461
1865,2017-12-21,Minnesota Timberwolves,32,7730,1285,2733,0.47,260,730,0.356,1025,2003,0.512,619,780,0.794,341,989,1330,729,290,406,571,3449
1866,2017-12-21,Denver Nuggets,31,7490,1238,2679,0.462,351,945,0.371,887,1734,0.512,499,679,0.735,368,1027,1395,727,246,473,554,3326
1867,2017-12-21,Los Angeles Lakers,29,7060,1182,2591,0.456,257,784,0.328,925,1807,0.512,486,700,0.694,310,1039,1349,675,239,472,646,3107
1868,2017-12-21,Brooklyn Nets,30,7200,1142,2601,0.439,350,1027,0.341,792,1574,0.503,570,766,0.744,305,1035,1340,669,203,454,628,3204
1869,2017-12-21,Phoenix Suns,33,7945,1286,2903,0.443,282,853,0.331,1004,2050,0.49,645,844,0.764,371,1148,1519,662,222,506,734,3499
1870,2017-12-21,Orlando Magic,32,7705,1271,2770,0.459,351,960,0.366,920,1810,0.508,489,661,0.74,267,1069,1336,758,239,462,630,3382
1871,2017-12-21,Washington Wizards,31,7490,1215,2657,0.457,292,812,0.36,923,1845,0.5,551,722,0.763,305,1039,1344,689,245,416,688,3273
1872,2017-12-21,Milwaukee Bucks,29,6985,1137,2362,0.481,255,716,0.356,882,1646,0.536,515,681,0.756,223,893,1116,645,254,369,651,3044
1873,2017-12-21,Charlotte Hornets,31,7490,1169,2676,0.437,270,780,0.346,899,1896,0.474,629,863,0.729,319,1130,1449,634,201,407,576,3237
1874,2017-12-21,New York Knicks,30,7225,1202,2550,0.471,243,670,0.363,959,1880,0.51,483,604,0.8,319,993,1312,689,214,462,618,3130
1875,2017-12-21,Los Angeles Clippers,30,7225,1136,2539,0.447,310,886,0.35,826,1653,0.5,522,705,0.74,322,992,1314,612,232,430,630,3104
1876,2017-12-21,Boston Celtics,34,8185,1277,2826,0.452,392,1049,0.374,885,1777,0.498,570,742,0.768,303,1195,1498,758,259,454,678,3516
1877,2017-12-21,Atlanta Hawks,31,7465,1190,2618,0.455,335,883,0.379,855,1735,0.493,481,610,0.789,280,953,1233,736,267,466,613,3196
1878,2017-12-21,Detroit Pistons,31,7440,1195,2671,0.447,344,904,0.381,851,1767,0.482,448,594,0.754,325,988,1313,680,244,423,603,3182
1879,2017-12-21,Portland Trail Blazers,31,7465,1176,2644,0.445,287,769,0.373,889,1875,0.474,536,663,0.808,304,1095,1399,565,205,437,614,3175
1880,2017-12-21,Oklahoma City Thunder,31,7540,1177,2690,0.438,317,912,0.348,860,1778,0.484,493,691,0.713,373,991,1364,643,311,440,645,3164
1881,2017-12-21,Utah Jazz,32,7705,1197,2643,0.453,369,963,0.383,828,1680,0.493,505,629,0.803,274,1018,1292,685,299,457,642,3268
1882,2017-12-21,San Antonio Spurs,32,7680,1229,2682,0.458,282,791,0.357,947,1891,0.501,499,638,0.782,337,1096,1433,712,233,443,555,3239
1883,2017-12-21,Miami Heat,31,7465,1142,2523,0.453,362,986,0.367,780,1537,0.507,450,593,0.759,239,1036,1275,654,233,465,636,3096
1884,2017-12-21,Dallas Mavericks,32,7705,1181,2690,0.439,368,1017,0.362,813,1673,0.486,461,594,0.776,250,1074,1324,685,216,410,623,3191
1885,2017-12-21,Chicago Bulls,30,7250,1136,2634,0.431,312,897,0.348,824,1737,0.474,394,534,0.738,282,1061,1343,682,210,391,576,2978
1886,2017-12-21,Memphis Grizzlies,31,7465,1087,2474,0.439,299,852,0.351,788,1622,0.486,522,660,0.791,255,958,1213,643,230,439,703,2995
1887,2017-12-21,Sacramento Kings,31,7465,1172,2623,0.447,263,692,0.38,909,1931,0.471,384,529,0.726,289,949,1238,634,253,434,611,2991
1888,2017-12-22,Golden State Warriors,31,7490,1356,2660,0.51,374,939,0.398,982,1721,0.571,515,634,0.812,267,1134,1401,944,261,490,632,3601
1889,2017-12-22,Houston Rockets,30,7200,1181,2518,0.469,479,1296,0.37,702,1222,0.574,618,775,0.797,274,1055,1329,678,278,441,613,3459
1890,2017-12-22,Toronto Raptors,30,7200,1234,2566,0.481,337,951,0.354,897,1615,0.555,544,686,0.793,277,986,1263,696,256,402,658,3349
1891,2017-12-22,Cleveland Cavaliers,33,7945,1330,2739,0.486,412,1076,0.383,918,1663,0.552,602,743,0.81,263,1108,1371,794,238,460,616,3674
1892,2017-12-22,New Orleans Pelicans,31,7515,1289,2643,0.488,349,919,0.38,940,1724,0.545,504,671,0.751,263,1070,1333,820,231,491,608,3431
1893,2017-12-22,Philadelphia 76ers,31,7540,1249,2720,0.459,331,940,0.352,918,1780,0.516,539,721,0.748,365,1142,1507,818,261,545,731,3368
1894,2017-12-22,Indiana Pacers,32,7705,1322,2762,0.479,318,820,0.388,1004,1942,0.517,499,644,0.775,297,1064,1361,721,254,423,588,3461
1895,2017-12-22,Minnesota Timberwolves,32,7730,1285,2733,0.47,260,730,0.356,1025,2003,0.512,619,780,0.794,341,989,1330,729,290,406,571,3449
1896,2017-12-22,Denver Nuggets,31,7490,1238,2679,0.462,351,945,0.371,887,1734,0.512,499,679,0.735,368,1027,1395,727,246,473,554,3326
1897,2017-12-22,Los Angeles Lakers,29,7060,1182,2591,0.456,257,784,0.328,925,1807,0.512,486,700,0.694,310,1039,1349,675,239,472,646,3107
1898,2017-12-22,Brooklyn Nets,30,7200,1142,2601,0.439,350,1027,0.341,792,1574,0.503,570,766,0.744,305,1035,1340,669,203,454,628,3204
1899,2017-12-22,Phoenix Suns,34,8185,1319,2984,0.442,292,879,0.332,1027,2105,0.488,666,871,0.765,383,1180,1563,683,226,516,751,3596
1900,2017-12-22,Orlando Magic,32,7705,1271,2770,0.459,351,960,0.366,920,1810,0.508,489,661,0.74,267,1069,1336,758,239,462,630,3382
1901,2017-12-22,Washington Wizards,31,7490,1215,2657,0.457,292,812,0.36,923,1845,0.5,551,722,0.763,305,1039,1344,689,245,416,688,3273
1902,2017-12-22,Milwaukee Bucks,29,6985,1137,2362,0.481,255,716,0.356,882,1646,0.536,515,681,0.756,223,893,1116,645,254,369,651,3044
1903,2017-12-22,Charlotte Hornets,31,7490,1169,2676,0.437,270,780,0.346,899,1896,0.474,629,863,0.729,319,1130,1449,634,201,407,576,3237
1904,2017-12-22,New York Knicks,31,7465,1238,2629,0.471,251,684,0.367,987,1945,0.507,505,630,0.802,330,1031,1361,702,222,479,638,3232
1905,2017-12-22,Los Angeles Clippers,30,7225,1136,2539,0.447,310,886,0.35,826,1653,0.5,522,705,0.74,322,992,1314,612,232,430,630,3104
1906,2017-12-22,Atlanta Hawks,31,7465,1190,2618,0.455,335,883,0.379,855,1735,0.493,481,610,0.789,280,953,1233,736,267,466,613,3196
1907,2017-12-22,Boston Celtics,35,8425,1310,2912,0.45,405,1087,0.373,905,1825,0.496,584,761,0.767,312,1221,1533,775,270,464,698,3609
1908,2017-12-22,Detroit Pistons,31,7440,1195,2671,0.447,344,904,0.381,851,1767,0.482,448,594,0.754,325,988,1313,680,244,423,603,3182
1909,2017-12-22,Portland Trail Blazers,31,7465,1176,2644,0.445,287,769,0.373,889,1875,0.474,536,663,0.808,304,1095,1399,565,205,437,614,3175
1910,2017-12-22,Oklahoma City Thunder,31,7540,1177,2690,0.438,317,912,0.348,860,1778,0.484,493,691,0.713,373,991,1364,643,311,440,645,3164
1911,2017-12-22,Utah Jazz,33,7945,1231,2717,0.453,381,989,0.385,850,1728,0.492,525,653,0.804,279,1054,1333,703,306,469,660,3368
1912,2017-12-22,San Antonio Spurs,33,7920,1263,2760,0.458,292,812,0.36,971,1948,0.498,510,654,0.78,342,1129,1471,726,240,457,576,3328
1913,2017-12-22,Miami Heat,31,7465,1142,2523,0.453,362,986,0.367,780,1537,0.507,450,593,0.759,239,1036,1275,654,233,465,636,3096
1914,2017-12-22,Dallas Mavericks,32,7705,1181,2690,0.439,368,1017,0.362,813,1673,0.486,461,594,0.776,250,1074,1324,685,216,410,623,3191
1915,2017-12-22,Chicago Bulls,31,7490,1183,2719,0.435,324,928,0.349,859,1791,0.48,400,542,0.738,287,1091,1378,716,218,403,595,3090
1916,2017-12-22,Memphis Grizzlies,32,7705,1126,2564,0.439,304,878,0.346,822,1686,0.488,534,676,0.79,270,993,1263,658,235,448,725,3090
1917,2017-12-22,Sacramento Kings,31,7465,1172,2623,0.447,263,692,0.38,909,1931,0.471,384,529,0.726,289,949,1238,634,253,434,611,2991
1918,2017-12-23,Golden State Warriors,32,7730,1398,2745,0.509,381,963,0.396,1017,1782,0.571,537,661,0.812,277,1166,1443,968,270,505,649,3714
1919,2017-12-23,Houston Rockets,31,7440,1217,2596,0.469,496,1336,0.371,721,1260,0.572,647,810,0.799,283,1089,1372,694,282,458,639,3577
1920,2017-12-23,Toronto Raptors,30,7200,1234,2566,0.481,337,951,0.354,897,1615,0.555,544,686,0.793,277,986,1263,696,256,402,658,3349
1921,2017-12-23,Cleveland Cavaliers,33,7945,1330,2739,0.486,412,1076,0.383,918,1663,0.552,602,743,0.81,263,1108,1371,794,238,460,616,3674
1922,2017-12-23,New Orleans Pelicans,32,7755,1332,2729,0.488,359,949,0.378,973,1780,0.547,519,695,0.747,274,1107,1381,843,241,506,633,3542
1923,2017-12-23,Philadelphia 76ers,31,7540,1249,2720,0.459,331,940,0.352,918,1780,0.516,539,721,0.748,365,1142,1507,818,261,545,731,3368
1924,2017-12-23,Indiana Pacers,32,7705,1322,2762,0.479,318,820,0.388,1004,1942,0.517,499,644,0.775,297,1064,1361,721,254,423,588,3461
1925,2017-12-23,Minnesota Timberwolves,32,7730,1285,2733,0.47,260,730,0.356,1025,2003,0.512,619,780,0.794,341,989,1330,729,290,406,571,3449
1926,2017-12-23,Brooklyn Nets,31,7440,1186,2689,0.441,364,1068,0.341,822,1621,0.507,587,787,0.746,318,1082,1400,698,207,468,645,3323
1927,2017-12-23,Los Angeles Lakers,30,7300,1222,2685,0.455,268,813,0.33,954,1872,0.51,501,722,0.694,325,1070,1395,697,250,487,669,3213
1928,2017-12-23,Denver Nuggets,32,7730,1280,2764,0.463,358,970,0.369,922,1794,0.514,510,695,0.734,384,1060,1444,746,250,487,567,3428
1929,2017-12-23,Phoenix Suns,34,8185,1319,2984,0.442,292,879,0.332,1027,2105,0.488,666,871,0.765,383,1180,1563,683,226,516,751,3596
1930,2017-12-23,Orlando Magic,33,7945,1307,2855,0.458,355,980,0.362,952,1875,0.508,510,690,0.739,277,1099,1376,774,246,476,649,3479
1931,2017-12-23,Milwaukee Bucks,30,7225,1178,2449,0.481,263,745,0.353,915,1704,0.537,534,704,0.759,229,930,1159,672,261,376,667,3153
1932,2017-12-23,Washington Wizards,32,7730,1249,2750,0.454,297,832,0.357,952,1918,0.496,562,737,0.763,312,1067,1379,711,252,423,706,3357
1933,2017-12-23,Charlotte Hornets,32,7730,1208,2764,0.437,282,806,0.35,926,1958,0.473,643,880,0.731,328,1164,1492,655,205,416,594,3341
1934,2017-12-23,Los Angeles Clippers,31,7465,1179,2630,0.448,328,928,0.353,851,1702,0.5,546,736,0.742,331,1021,1352,636,240,438,655,3232
1935,2017-12-23,New York Knicks,32,7705,1282,2726,0.47,259,708,0.366,1023,2018,0.507,510,636,0.802,346,1066,1412,727,228,493,658,3333
1936,2017-12-23,Atlanta Hawks,32,7705,1234,2703,0.457,350,915,0.383,884,1788,0.494,495,627,0.789,287,973,1260,764,279,481,637,3313
1937,2017-12-23,Boston Celtics,35,8425,1310,2912,0.45,405,1087,0.373,905,1825,0.496,584,761,0.767,312,1221,1533,775,270,464,698,3609
1938,2017-12-23,Detroit Pistons,32,7680,1233,2759,0.447,354,929,0.381,879,1830,0.48,466,619,0.753,340,1017,1357,699,252,434,614,3286
1939,2017-12-23,Oklahoma City Thunder,32,7780,1221,2772,0.44,330,937,0.352,891,1835,0.486,512,722,0.709,388,1016,1404,667,322,459,663,3284
1940,2017-12-23,Utah Jazz,33,7945,1231,2717,0.453,381,989,0.385,850,1728,0.492,525,653,0.804,279,1054,1333,703,306,469,660,3368
1941,2017-12-23,Portland Trail Blazers,32,7705,1211,2727,0.444,293,791,0.37,918,1936,0.474,545,679,0.803,314,1119,1433,580,211,446,633,3260
1942,2017-12-23,San Antonio Spurs,33,7920,1263,2760,0.458,292,812,0.36,971,1948,0.498,510,654,0.78,342,1129,1471,726,240,457,576,3328
1943,2017-12-23,Miami Heat,32,7705,1188,2595,0.458,378,1011,0.374,810,1584,0.511,455,599,0.76,241,1069,1310,679,236,476,651,3209
1944,2017-12-23,Dallas Mavericks,33,7945,1219,2765,0.441,385,1052,0.366,834,1713,0.487,469,605,0.775,253,1093,1346,713,221,418,635,3292
1945,2017-12-23,Chicago Bulls,31,7490,1183,2719,0.435,324,928,0.349,859,1791,0.48,400,542,0.738,287,1091,1378,716,218,403,595,3090
1946,2017-12-23,Memphis Grizzlies,32,7705,1126,2564,0.439,304,878,0.346,822,1686,0.488,534,676,0.79,270,993,1263,658,235,448,725,3090
1947,2017-12-23,Sacramento Kings,31,7465,1172,2623,0.447,263,692,0.38,909,1931,0.471,384,529,0.726,289,949,1238,634,253,434,611,2991
1948,2017-12-24,Houston Rockets,31,7440,1217,2596,0.469,496,1336,0.371,721,1260,0.572,647,810,0.799,283,1089,1372,694,282,458,639,3577
1949,2017-12-24,Golden State Warriors,33,7970,1430,2829,0.505,384,990,0.388,1046,1839,0.569,551,678,0.813,288,1193,1481,993,284,521,663,3795
1950,2017-12-24,Cleveland Cavaliers,33,7945,1330,2739,0.486,412,1076,0.383,918,1663,0.552,602,743,0.81,263,1108,1371,794,238,460,616,3674
1951,2017-12-24,Toronto Raptors,31,7440,1269,2651,0.479,346,978,0.354,923,1673,0.552,567,712,0.796,284,1022,1306,714,271,419,679,3451
1952,2017-12-24,New Orleans Pelicans,33,7995,1371,2802,0.489,374,974,0.384,997,1828,0.545,535,714,0.749,280,1138,1418,870,246,520,653,3651
1953,2017-12-24,Indiana Pacers,33,7970,1369,2852,0.48,328,843,0.389,1041,2009,0.518,518,668,0.775,304,1098,1402,752,262,431,613,3584
1954,2017-12-24,Minnesota Timberwolves,33,7970,1327,2817,0.471,266,746,0.357,1061,2071,0.512,644,809,0.796,354,1023,1377,747,296,420,592,3564
1955,2017-12-24,Philadelphia 76ers,32,7780,1282,2800,0.458,338,967,0.35,944,1833,0.515,552,741,0.745,372,1176,1548,837,271,567,755,3454
1956,2017-12-24,Brooklyn Nets,32,7705,1228,2787,0.441,380,1104,0.344,848,1683,0.504,606,812,0.746,336,1115,1451,722,209,478,665,3442
1957,2017-12-24,Denver Nuggets,33,7970,1318,2846,0.463,365,998,0.366,953,1848,0.516,523,710,0.737,394,1095,1489,771,260,505,581,3524
1958,2017-12-24,Los Angeles Lakers,31,7540,1258,2770,0.454,276,838,0.329,982,1932,0.508,513,742,0.691,336,1114,1450,720,258,504,691,3305
1959,2017-12-24,Phoenix Suns,35,8425,1359,3070,0.443,303,911,0.333,1056,2159,0.489,681,895,0.761,392,1207,1599,707,231,529,773,3702
1960,2017-12-24,Washington Wizards,33,7970,1296,2836,0.457,313,862,0.363,983,1974,0.498,582,760,0.766,324,1104,1428,740,257,439,724,3487
1961,2017-12-24,Orlando Magic,34,8185,1349,2942,0.459,363,1006,0.361,986,1936,0.509,521,707,0.737,281,1123,1404,791,253,488,671,3582
1962,2017-12-24,Milwaukee Bucks,31,7465,1220,2536,0.481,271,771,0.351,949,1765,0.538,548,721,0.76,236,958,1194,697,265,385,699,3259
1963,2017-12-24,Charlotte Hornets,33,7970,1244,2838,0.438,291,827,0.352,953,2011,0.474,673,920,0.732,337,1198,1535,677,207,432,614,3452
1964,2017-12-24,Los Angeles Clippers,32,7705,1218,2709,0.45,341,962,0.354,877,1747,0.502,567,764,0.742,336,1052,1388,650,244,448,677,3344
1965,2017-12-24,New York Knicks,32,7705,1282,2726,0.47,259,708,0.366,1023,2018,0.507,510,636,0.802,346,1066,1412,727,228,493,658,3333
1966,2017-12-24,Atlanta Hawks,33,7945,1276,2778,0.459,360,939,0.383,916,1839,0.498,513,649,0.79,293,1005,1298,793,284,496,656,3425
1967,2017-12-24,Boston Celtics,36,8665,1354,3004,0.451,417,1119,0.373,937,1885,0.497,601,782,0.769,320,1259,1579,804,279,469,716,3726
1968,2017-12-24,Detroit Pistons,32,7680,1233,2759,0.447,354,929,0.381,879,1830,0.48,466,619,0.753,340,1017,1357,699,252,434,614,3286
1969,2017-12-24,Oklahoma City Thunder,33,8020,1260,2860,0.441,342,966,0.354,918,1894,0.485,525,738,0.711,403,1046,1449,685,331,466,679,3387
1970,2017-12-24,Portland Trail Blazers,33,7945,1250,2822,0.443,303,816,0.371,947,2006,0.472,552,693,0.797,323,1157,1480,599,218,457,648,3355
1971,2017-12-24,Utah Jazz,34,8185,1264,2789,0.453,387,1015,0.381,877,1774,0.494,542,673,0.805,285,1085,1370,719,309,481,673,3457
1972,2017-12-24,San Antonio Spurs,34,8160,1307,2848,0.459,303,835,0.363,1004,2013,0.499,519,665,0.78,349,1166,1515,755,243,465,587,3436
1973,2017-12-24,Miami Heat,33,7945,1224,2680,0.457,388,1043,0.372,836,1637,0.511,467,614,0.761,254,1094,1348,697,240,489,670,3303
1974,2017-12-24,Dallas Mavericks,34,8185,1262,2850,0.443,394,1085,0.363,868,1765,0.492,481,620,0.776,260,1116,1376,744,229,428,652,3399
1975,2017-12-24,Chicago Bulls,32,7730,1217,2805,0.434,331,947,0.35,886,1858,0.477,417,567,0.735,299,1130,1429,740,222,418,611,3182
1976,2017-12-24,Memphis Grizzlies,33,7945,1166,2654,0.439,317,909,0.349,849,1745,0.487,556,701,0.793,285,1025,1310,686,240,457,751,3205
1977,2017-12-24,Sacramento Kings,32,7705,1212,2709,0.447,275,714,0.385,937,1995,0.47,391,540,0.724,298,982,1280,655,255,444,628,3090
1978,2017-12-25,Houston Rockets,31,7440,1217,2596,0.469,496,1336,0.371,721,1260,0.572,647,810,0.799,283,1089,1372,694,282,458,639,3577
1979,2017-12-25,Golden State Warriors,33,7970,1430,2829,0.505,384,990,0.388,1046,1839,0.569,551,678,0.813,288,1193,1481,993,284,521,663,3795
1980,2017-12-25,Cleveland Cavaliers,33,7945,1330,2739,0.486,412,1076,0.383,918,1663,0.552,602,743,0.81,263,1108,1371,794,238,460,616,3674
1981,2017-12-25,Toronto Raptors,31,7440,1269,2651,0.479,346,978,0.354,923,1673,0.552,567,712,0.796,284,1022,1306,714,271,419,679,3451
1982,2017-12-25,New Orleans Pelicans,33,7995,1371,2802,0.489,374,974,0.384,997,1828,0.545,535,714,0.749,280,1138,1418,870,246,520,653,3651
1983,2017-12-25,Indiana Pacers,33,7970,1369,2852,0.48,328,843,0.389,1041,2009,0.518,518,668,0.775,304,1098,1402,752,262,431,613,3584
1984,2017-12-25,Minnesota Timberwolves,33,7970,1327,2817,0.471,266,746,0.357,1061,2071,0.512,644,809,0.796,354,1023,1377,747,296,420,592,3564
1985,2017-12-25,Philadelphia 76ers,32,7780,1282,2800,0.458,338,967,0.35,944,1833,0.515,552,741,0.745,372,1176,1548,837,271,567,755,3454
1986,2017-12-25,Brooklyn Nets,32,7705,1228,2787,0.441,380,1104,0.344,848,1683,0.504,606,812,0.746,336,1115,1451,722,209,478,665,3442
1987,2017-12-25,Denver Nuggets,33,7970,1318,2846,0.463,365,998,0.366,953,1848,0.516,523,710,0.737,394,1095,1489,771,260,505,581,3524
1988,2017-12-25,Los Angeles Lakers,31,7540,1258,2770,0.454,276,838,0.329,982,1932,0.508,513,742,0.691,336,1114,1450,720,258,504,691,3305
1989,2017-12-25,Phoenix Suns,35,8425,1359,3070,0.443,303,911,0.333,1056,2159,0.489,681,895,0.761,392,1207,1599,707,231,529,773,3702
1990,2017-12-25,Washington Wizards,33,7970,1296,2836,0.457,313,862,0.363,983,1974,0.498,582,760,0.766,324,1104,1428,740,257,439,724,3487
1991,2017-12-25,Orlando Magic,34,8185,1349,2942,0.459,363,1006,0.361,986,1936,0.509,521,707,0.737,281,1123,1404,791,253,488,671,3582
1992,2017-12-25,Milwaukee Bucks,31,7465,1220,2536,0.481,271,771,0.351,949,1765,0.538,548,721,0.76,236,958,1194,697,265,385,699,3259
1993,2017-12-25,Charlotte Hornets,33,7970,1244,2838,0.438,291,827,0.352,953,2011,0.474,673,920,0.732,337,1198,1535,677,207,432,614,3452
1994,2017-12-25,Los Angeles Clippers,32,7705,1218,2709,0.45,341,962,0.354,877,1747,0.502,567,764,0.742,336,1052,1388,650,244,448,677,3344
1995,2017-12-25,New York Knicks,32,7705,1282,2726,0.47,259,708,0.366,1023,2018,0.507,510,636,0.802,346,1066,1412,727,228,493,658,3333
1996,2017-12-25,Atlanta Hawks,33,7945,1276,2778,0.459,360,939,0.383,916,1839,0.498,513,649,0.79,293,1005,1298,793,284,496,656,3425
1997,2017-12-25,Boston Celtics,36,8665,1354,3004,0.451,417,1119,0.373,937,1885,0.497,601,782,0.769,320,1259,1579,804,279,469,716,3726
1998,2017-12-25,Detroit Pistons,32,7680,1233,2759,0.447,354,929,0.381,879,1830,0.48,466,619,0.753,340,1017,1357,699,252,434,614,3286
1999,2017-12-25,Oklahoma City Thunder,33,8020,1260,2860,0.441,342,966,0.354,918,1894,0.485,525,738,0.711,403,1046,1449,685,331,466,679,3387
2000,2017-12-25,Portland Trail Blazers,33,7945,1250,2822,0.443,303,816,0.371,947,2006,0.472,552,693,0.797,323,1157,1480,599,218,457,648,3355
2001,2017-12-25,Utah Jazz,34,8185,1264,2789,0.453,387,1015,0.381,877,1774,0.494,542,673,0.805,285,1085,1370,719,309,481,673,3457
2002,2017-12-25,San Antonio Spurs,34,8160,1307,2848,0.459,303,835,0.363,1004,2013,0.499,519,665,0.78,349,1166,1515,755,243,465,587,3436
2003,2017-12-25,Miami Heat,33,7945,1224,2680,0.457,388,1043,0.372,836,1637,0.511,467,614,0.761,254,1094,1348,697,240,489,670,3303
2004,2017-12-25,Dallas Mavericks,34,8185,1262,2850,0.443,394,1085,0.363,868,1765,0.492,481,620,0.776,260,1116,1376,744,229,428,652,3399
2005,2017-12-25,Chicago Bulls,32,7730,1217,2805,0.434,331,947,0.35,886,1858,0.477,417,567,0.735,299,1130,1429,740,222,418,611,3182
2006,2017-12-25,Memphis Grizzlies,33,7945,1166,2654,0.439,317,909,0.349,849,1745,0.487,556,701,0.793,285,1025,1310,686,240,457,751,3205
2007,2017-12-25,Sacramento Kings,32,7705,1212,2709,0.447,275,714,0.385,937,1995,0.47,391,540,0.724,298,982,1280,655,255,444,628,3090
2008,2017-12-26,Houston Rockets,32,7680,1252,2677,0.468,508,1373,0.37,744,1304,0.571,672,841,0.799,295,1115,1410,717,293,471,659,3684
2009,2017-12-26,Golden State Warriors,34,8210,1468,2911,0.504,394,1027,0.384,1074,1884,0.57,564,695,0.812,298,1230,1528,1021,291,536,681,3894
2010,2017-12-26,Toronto Raptors,31,7440,1269,2651,0.479,346,978,0.354,923,1673,0.552,567,712,0.796,284,1022,1306,714,271,419,679,3451
2011,2017-12-26,Cleveland Cavaliers,34,8185,1358,2827,0.48,427,1112,0.384,931,1715,0.543,623,768,0.811,282,1139,1421,806,246,474,635,3766
2012,2017-12-26,New Orleans Pelicans,33,7995,1371,2802,0.489,374,974,0.384,997,1828,0.545,535,714,0.749,280,1138,1418,870,246,520,653,3651
2013,2017-12-26,Indiana Pacers,33,7970,1369,2852,0.48,328,843,0.389,1041,2009,0.518,518,668,0.775,304,1098,1402,752,262,431,613,3584
2014,2017-12-26,Minnesota Timberwolves,34,8210,1376,2901,0.474,277,778,0.356,1099,2123,0.518,656,823,0.797,361,1058,1419,777,305,435,605,3685
2015,2017-12-26,Philadelphia 76ers,33,8020,1317,2882,0.457,348,995,0.35,969,1887,0.514,577,771,0.748,384,1212,1596,858,278,582,777,3559
2016,2017-12-26,Brooklyn Nets,32,7705,1228,2787,0.441,380,1104,0.344,848,1683,0.504,606,812,0.746,336,1115,1451,722,209,478,665,3442
2017,2017-12-26,Denver Nuggets,33,7970,1318,2846,0.463,365,998,0.366,953,1848,0.516,523,710,0.737,394,1095,1489,771,260,505,581,3524
2018,2017-12-26,Los Angeles Lakers,32,7780,1298,2862,0.454,286,868,0.329,1012,1994,0.508,527,762,0.692,349,1138,1487,741,268,516,707,3409
2019,2017-12-26,Washington Wizards,34,8210,1339,2929,0.457,319,888,0.359,1020,2041,0.5,601,788,0.763,338,1137,1475,766,263,447,741,3598
2020,2017-12-26,Phoenix Suns,35,8425,1359,3070,0.443,303,911,0.333,1056,2159,0.489,681,895,0.761,392,1207,1599,707,231,529,773,3702
2021,2017-12-26,Orlando Magic,34,8185,1349,2942,0.459,363,1006,0.361,986,1936,0.509,521,707,0.737,281,1123,1404,791,253,488,671,3582
2022,2017-12-26,Milwaukee Bucks,31,7465,1220,2536,0.481,271,771,0.351,949,1765,0.538,548,721,0.76,236,958,1194,697,265,385,699,3259
2023,2017-12-26,Charlotte Hornets,33,7970,1244,2838,0.438,291,827,0.352,953,2011,0.474,673,920,0.732,337,1198,1535,677,207,432,614,3452
2024,2017-12-26,Los Angeles Clippers,32,7705,1218,2709,0.45,341,962,0.354,877,1747,0.502,567,764,0.742,336,1052,1388,650,244,448,677,3344
2025,2017-12-26,New York Knicks,33,7945,1320,2820,0.468,263,723,0.364,1057,2097,0.504,528,664,0.795,364,1093,1457,745,235,503,679,3431
2026,2017-12-26,Atlanta Hawks,33,7945,1276,2778,0.459,360,939,0.383,916,1839,0.498,513,649,0.79,293,1005,1298,793,284,496,656,3425
2027,2017-12-26,Boston Celtics,37,8905,1393,3085,0.452,431,1148,0.375,962,1937,0.497,612,799,0.766,328,1296,1624,824,281,485,739,3829
2028,2017-12-26,Oklahoma City Thunder,34,8260,1303,2939,0.443,350,984,0.356,953,1955,0.487,543,761,0.714,412,1077,1489,706,340,480,699,3499
2029,2017-12-26,Detroit Pistons,32,7680,1233,2759,0.447,354,929,0.381,879,1830,0.48,466,619,0.753,340,1017,1357,699,252,434,614,3286
2030,2017-12-26,Portland Trail Blazers,33,7945,1250,2822,0.443,303,816,0.371,947,2006,0.472,552,693,0.797,323,1157,1480,599,218,457,648,3355
2031,2017-12-26,Utah Jazz,34,8185,1264,2789,0.453,387,1015,0.381,877,1774,0.494,542,673,0.805,285,1085,1370,719,309,481,673,3457
2032,2017-12-26,San Antonio Spurs,34,8160,1307,2848,0.459,303,835,0.363,1004,2013,0.499,519,665,0.78,349,1166,1515,755,243,465,587,3436
2033,2017-12-26,Miami Heat,33,7945,1224,2680,0.457,388,1043,0.372,836,1637,0.511,467,614,0.761,254,1094,1348,697,240,489,670,3303
2034,2017-12-26,Dallas Mavericks,34,8185,1262,2850,0.443,394,1085,0.363,868,1765,0.492,481,620,0.776,260,1116,1376,744,229,428,652,3399
2035,2017-12-26,Chicago Bulls,32,7730,1217,2805,0.434,331,947,0.35,886,1858,0.477,417,567,0.735,299,1130,1429,740,222,418,611,3182
2036,2017-12-26,Memphis Grizzlies,33,7945,1166,2654,0.439,317,909,0.349,849,1745,0.487,556,701,0.793,285,1025,1310,686,240,457,751,3205
2037,2017-12-26,Sacramento Kings,32,7705,1212,2709,0.447,275,714,0.385,937,1995,0.47,391,540,0.724,298,982,1280,655,255,444,628,3090
2038,2017-12-27,Houston Rockets,32,7680,1252,2677,0.468,508,1373,0.37,744,1304,0.571,672,841,0.799,295,1115,1410,717,293,471,659,3684
2039,2017-12-27,Golden State Warriors,34,8210,1468,2911,0.504,394,1027,0.384,1074,1884,0.57,564,695,0.812,298,1230,1528,1021,291,536,681,3894
2040,2017-12-27,Cleveland Cavaliers,34,8185,1358,2827,0.48,427,1112,0.384,931,1715,0.543,623,768,0.811,282,1139,1421,806,246,474,635,3766
2041,2017-12-27,Toronto Raptors,32,7680,1299,2740,0.474,355,1007,0.353,944,1733,0.545,591,744,0.794,300,1059,1359,730,281,429,703,3544
2042,2017-12-27,New Orleans Pelicans,33,7995,1371,2802,0.489,374,974,0.384,997,1828,0.545,535,714,0.749,280,1138,1418,870,246,520,653,3651
2043,2017-12-27,Minnesota Timberwolves,34,8210,1376,2901,0.474,277,778,0.356,1099,2123,0.518,656,823,0.797,361,1058,1419,777,305,435,605,3685
2044,2017-12-27,Indiana Pacers,34,8210,1403,2929,0.479,334,864,0.387,1069,2065,0.518,527,681,0.774,309,1119,1428,770,268,443,632,3667
2045,2017-12-27,Philadelphia 76ers,33,8020,1317,2882,0.457,348,995,0.35,969,1887,0.514,577,771,0.748,384,1212,1596,858,278,582,777,3559
2046,2017-12-27,Brooklyn Nets,33,7945,1267,2880,0.44,392,1136,0.345,875,1744,0.502,613,821,0.747,348,1148,1496,745,214,491,683,3539
2047,2017-12-27,Denver Nuggets,34,8210,1357,2927,0.464,376,1028,0.366,981,1899,0.517,541,732,0.739,404,1138,1542,794,263,514,602,3631
2048,2017-12-27,Los Angeles Lakers,32,7780,1298,2862,0.454,286,868,0.329,1012,1994,0.508,527,762,0.692,349,1138,1487,741,268,516,707,3409
2049,2017-12-27,Washington Wizards,34,8210,1339,2929,0.457,319,888,0.359,1020,2041,0.5,601,788,0.763,338,1137,1475,766,263,447,741,3598
2050,2017-12-27,Phoenix Suns,36,8665,1391,3142,0.443,311,933,0.333,1080,2209,0.489,708,930,0.761,398,1242,1640,731,236,548,802,3801
2051,2017-12-27,Milwaukee Bucks,32,7705,1259,2619,0.481,281,802,0.35,978,1817,0.538,566,745,0.76,240,995,1235,720,267,402,720,3365
2052,2017-12-27,Los Angeles Clippers,33,7945,1262,2790,0.452,354,993,0.356,908,1797,0.505,588,791,0.743,345,1092,1437,681,251,461,690,3466
2053,2017-12-27,Orlando Magic,35,8425,1382,3023,0.457,368,1026,0.359,1014,1997,0.508,539,729,0.739,291,1155,1446,805,261,505,691,3671
2054,2017-12-27,Charlotte Hornets,33,7970,1244,2838,0.438,291,827,0.352,953,2011,0.474,673,920,0.732,337,1198,1535,677,207,432,614,3452
2055,2017-12-27,New York Knicks,33,7945,1320,2820,0.468,263,723,0.364,1057,2097,0.504,528,664,0.795,364,1093,1457,745,235,503,679,3431
2056,2017-12-27,Atlanta Hawks,33,7945,1276,2778,0.459,360,939,0.383,916,1839,0.498,513,649,0.79,293,1005,1298,793,284,496,656,3425
2057,2017-12-27,Boston Celtics,37,8905,1393,3085,0.452,431,1148,0.375,962,1937,0.497,612,799,0.766,328,1296,1624,824,281,485,739,3829
2058,2017-12-27,Oklahoma City Thunder,34,8260,1303,2939,0.443,350,984,0.356,953,1955,0.487,543,761,0.714,412,1077,1489,706,340,480,699,3499
2059,2017-12-27,Detroit Pistons,33,7920,1274,2841,0.448,366,963,0.38,908,1878,0.483,479,635,0.754,350,1053,1403,725,257,444,631,3393
2060,2017-12-27,Portland Trail Blazers,33,7945,1250,2822,0.443,303,816,0.371,947,2006,0.472,552,693,0.797,323,1157,1480,599,218,457,648,3355
2061,2017-12-27,San Antonio Spurs,35,8400,1348,2928,0.46,310,851,0.364,1038,2077,0.5,539,689,0.782,354,1204,1558,773,250,477,601,3545
2062,2017-12-27,Utah Jazz,35,8425,1291,2873,0.449,397,1050,0.378,894,1823,0.49,561,696,0.806,297,1115,1412,738,316,488,695,3540
2063,2017-12-27,Miami Heat,34,8185,1265,2771,0.457,399,1076,0.371,866,1695,0.511,481,631,0.762,270,1131,1401,719,251,504,690,3410
2064,2017-12-27,Dallas Mavericks,35,8425,1302,2944,0.442,400,1109,0.361,902,1835,0.492,493,636,0.775,276,1156,1432,764,234,441,676,3497
2065,2017-12-27,Chicago Bulls,33,7970,1262,2908,0.434,341,975,0.35,921,1933,0.476,432,592,0.73,314,1162,1476,766,233,424,630,3297
2066,2017-12-27,Memphis Grizzlies,34,8185,1201,2741,0.438,320,929,0.344,881,1812,0.486,580,730,0.795,295,1053,1348,698,250,467,779,3302
2067,2017-12-27,Sacramento Kings,33,7945,1252,2805,0.446,282,736,0.383,970,2069,0.469,399,552,0.723,308,1009,1317,680,266,453,647,3185
2068,2017-12-28,Houston Rockets,32,7680,1252,2677,0.468,508,1373,0.37,744,1304,0.571,672,841,0.799,295,1115,1410,717,293,471,659,3684
2069,2017-12-28,Golden State Warriors,35,8450,1519,2997,0.507,405,1050,0.386,1114,1947,0.572,577,712,0.81,302,1276,1578,1058,299,552,699,4020
2070,2017-12-28,New Orleans Pelicans,34,8235,1419,2892,0.491,391,1007,0.388,1028,1885,0.545,550,733,0.75,286,1175,1461,910,254,530,668,3779
2071,2017-12-28,Toronto Raptors,33,7920,1335,2825,0.473,366,1045,0.35,969,1780,0.544,615,770,0.799,307,1086,1393,754,290,440,732,3651
2072,2017-12-28,Cleveland Cavaliers,35,8425,1390,2901,0.479,439,1143,0.384,951,1758,0.541,642,793,0.81,289,1169,1458,825,255,485,650,3861
2073,2017-12-28,Minnesota Timberwolves,35,8475,1423,2991,0.476,289,807,0.358,1134,2184,0.519,678,853,0.795,368,1093,1461,804,309,441,631,3813
2074,2017-12-28,Philadelphia 76ers,33,8020,1317,2882,0.457,348,995,0.35,969,1887,0.514,577,771,0.748,384,1212,1596,858,278,582,777,3559
2075,2017-12-28,Indiana Pacers,35,8450,1441,3008,0.479,344,889,0.387,1097,2119,0.518,535,691,0.774,316,1151,1467,797,276,459,649,3761
2076,2017-12-28,Brooklyn Nets,34,8185,1308,2970,0.44,411,1174,0.35,897,1796,0.499,625,835,0.749,358,1181,1539,771,222,506,701,3652
2077,2017-12-28,Denver Nuggets,35,8475,1399,3018,0.464,391,1067,0.366,1008,1951,0.517,567,763,0.743,415,1175,1590,820,266,523,626,3756
2078,2017-12-28,Los Angeles Lakers,33,8020,1333,2955,0.451,294,896,0.328,1039,2059,0.505,548,795,0.689,371,1165,1536,755,273,527,733,3508
2079,2017-12-28,Washington Wizards,35,8450,1374,3010,0.456,328,912,0.36,1046,2098,0.499,621,814,0.763,347,1168,1515,790,269,460,765,3697
2080,2017-12-28,Phoenix Suns,36,8665,1391,3142,0.443,311,933,0.333,1080,2209,0.489,708,930,0.761,398,1242,1640,731,236,548,802,3801
2081,2017-12-28,Milwaukee Bucks,32,7705,1259,2619,0.481,281,802,0.35,978,1817,0.538,566,745,0.76,240,995,1235,720,267,402,720,3365
2082,2017-12-28,Los Angeles Clippers,33,7945,1262,2790,0.452,354,993,0.356,908,1797,0.505,588,791,0.743,345,1092,1437,681,251,461,690,3466
2083,2017-12-28,Orlando Magic,35,8425,1382,3023,0.457,368,1026,0.359,1014,1997,0.508,539,729,0.739,291,1155,1446,805,261,505,691,3671
2084,2017-12-28,Charlotte Hornets,34,8210,1276,2925,0.436,298,850,0.351,978,2075,0.471,693,949,0.73,356,1231,1587,692,214,443,625,3543
2085,2017-12-28,Atlanta Hawks,34,8185,1317,2872,0.459,371,976,0.38,946,1896,0.499,533,678,0.786,309,1042,1351,821,291,507,677,3538
2086,2017-12-28,Oklahoma City Thunder,35,8500,1349,3026,0.446,359,1009,0.356,990,2017,0.491,566,794,0.713,427,1114,1541,731,349,492,725,3623
2087,2017-12-28,New York Knicks,34,8185,1357,2911,0.466,267,746,0.358,1090,2165,0.503,537,677,0.793,371,1137,1508,766,241,515,696,3518
2088,2017-12-28,Boston Celtics,38,9145,1430,3163,0.452,446,1182,0.377,984,1981,0.497,625,812,0.77,334,1333,1667,844,285,500,759,3931
2089,2017-12-28,Detroit Pistons,33,7920,1274,2841,0.448,366,963,0.38,908,1878,0.483,479,635,0.754,350,1053,1403,725,257,444,631,3393
2090,2017-12-28,Portland Trail Blazers,33,7945,1250,2822,0.443,303,816,0.371,947,2006,0.472,552,693,0.797,323,1157,1480,599,218,457,648,3355
2091,2017-12-28,San Antonio Spurs,35,8400,1348,2928,0.46,310,851,0.364,1038,2077,0.5,539,689,0.782,354,1204,1558,773,250,477,601,3545
2092,2017-12-28,Utah Jazz,36,8665,1328,2965,0.448,403,1073,0.376,925,1892,0.489,582,723,0.805,307,1148,1455,759,326,501,717,3641
2093,2017-12-28,Miami Heat,34,8185,1265,2771,0.457,399,1076,0.371,866,1695,0.511,481,631,0.762,270,1131,1401,719,251,504,690,3410
2094,2017-12-28,Dallas Mavericks,36,8665,1342,3022,0.444,408,1138,0.359,934,1884,0.496,503,651,0.773,280,1187,1467,790,241,450,688,3595
2095,2017-12-28,Chicago Bulls,34,8210,1297,2994,0.433,351,1003,0.35,946,1991,0.475,444,608,0.73,318,1208,1526,789,242,439,645,3389
2096,2017-12-28,Memphis Grizzlies,35,8425,1236,2812,0.44,325,950,0.342,911,1862,0.489,614,769,0.798,300,1085,1385,718,253,477,799,3411
2097,2017-12-28,Sacramento Kings,34,8185,1293,2884,0.448,294,766,0.384,999,2118,0.472,414,570,0.726,315,1042,1357,705,274,464,666,3294
2098,2017-12-29,Golden State Warriors,35,8450,1519,2997,0.507,405,1050,0.386,1114,1947,0.572,577,712,0.81,302,1276,1578,1058,299,552,699,4020
2099,2017-12-29,Houston Rockets,33,7920,1282,2757,0.465,522,1416,0.369,760,1341,0.567,696,872,0.798,302,1151,1453,733,302,487,682,3782
2100,2017-12-29,New Orleans Pelicans,34,8235,1419,2892,0.491,391,1007,0.388,1028,1885,0.545,550,733,0.75,286,1175,1461,910,254,530,668,3779
2101,2017-12-29,Toronto Raptors,33,7920,1335,2825,0.473,366,1045,0.35,969,1780,0.544,615,770,0.799,307,1086,1393,754,290,440,732,3651
2102,2017-12-29,Cleveland Cavaliers,35,8425,1390,2901,0.479,439,1143,0.384,951,1758,0.541,642,793,0.81,289,1169,1458,825,255,485,650,3861
2103,2017-12-29,Minnesota Timberwolves,36,8715,1457,3062,0.476,298,835,0.357,1159,2227,0.52,697,879,0.793,374,1120,1494,824,318,457,645,3909
2104,2017-12-29,Philadelphia 76ers,34,8260,1359,2969,0.458,364,1027,0.354,995,1942,0.512,587,785,0.748,389,1244,1633,886,286,595,803,3669
2105,2017-12-29,Indiana Pacers,35,8450,1441,3008,0.479,344,889,0.387,1097,2119,0.518,535,691,0.774,316,1151,1467,797,276,459,649,3761
2106,2017-12-29,Brooklyn Nets,34,8185,1308,2970,0.44,411,1174,0.35,897,1796,0.499,625,835,0.749,358,1181,1539,771,222,506,701,3652
2107,2017-12-29,Denver Nuggets,35,8475,1399,3018,0.464,391,1067,0.366,1008,1951,0.517,567,763,0.743,415,1175,1590,820,266,523,626,3756
2108,2017-12-29,Los Angeles Lakers,33,8020,1333,2955,0.451,294,896,0.328,1039,2059,0.505,548,795,0.689,371,1165,1536,755,273,527,733,3508
2109,2017-12-29,Washington Wizards,35,8450,1374,3010,0.456,328,912,0.36,1046,2098,0.499,621,814,0.763,347,1168,1515,790,269,460,765,3697
2110,2017-12-29,Phoenix Suns,36,8665,1391,3142,0.443,311,933,0.333,1080,2209,0.489,708,930,0.761,398,1242,1640,731,236,548,802,3801
2111,2017-12-29,Milwaukee Bucks,33,7945,1300,2694,0.483,286,817,0.35,1014,1877,0.54,581,761,0.763,247,1024,1271,743,277,418,738,3467
2112,2017-12-29,Los Angeles Clippers,33,7945,1262,2790,0.452,354,993,0.356,908,1797,0.505,588,791,0.743,345,1092,1437,681,251,461,690,3466
2113,2017-12-29,Orlando Magic,36,8665,1419,3105,0.457,379,1052,0.36,1040,2053,0.507,556,746,0.745,300,1194,1494,827,271,523,709,3773
2114,2017-12-29,Charlotte Hornets,34,8210,1276,2925,0.436,298,850,0.351,978,2075,0.471,693,949,0.73,356,1231,1587,692,214,443,625,3543
2115,2017-12-29,Atlanta Hawks,34,8185,1317,2872,0.459,371,976,0.38,946,1896,0.499,533,678,0.786,309,1042,1351,821,291,507,677,3538
2116,2017-12-29,New York Knicks,35,8425,1398,3001,0.466,272,760,0.358,1126,2241,0.502,557,699,0.797,383,1169,1552,797,247,524,722,3625
2117,2017-12-29,Oklahoma City Thunder,35,8500,1349,3026,0.446,359,1009,0.356,990,2017,0.491,566,794,0.713,427,1114,1541,731,349,492,725,3623
2118,2017-12-29,Boston Celtics,39,9385,1467,3245,0.452,454,1211,0.375,1013,2034,0.498,642,836,0.768,344,1367,1711,862,294,516,781,4030
2119,2017-12-29,Detroit Pistons,34,8160,1309,2928,0.447,375,986,0.38,934,1942,0.481,489,649,0.753,359,1085,1444,745,262,459,649,3482
2120,2017-12-29,Portland Trail Blazers,34,8185,1285,2897,0.444,311,840,0.37,974,2057,0.474,588,740,0.795,331,1196,1527,614,225,472,666,3469
2121,2017-12-29,San Antonio Spurs,36,8640,1389,3008,0.462,319,871,0.366,1070,2137,0.501,567,728,0.779,364,1237,1601,801,252,486,619,3664
2122,2017-12-29,Utah Jazz,36,8665,1328,2965,0.448,403,1073,0.376,925,1892,0.489,582,723,0.805,307,1148,1455,759,326,501,717,3641
2123,2017-12-29,Miami Heat,34,8185,1265,2771,0.457,399,1076,0.371,866,1695,0.511,481,631,0.762,270,1131,1401,719,251,504,690,3410
2124,2017-12-29,Dallas Mavericks,36,8665,1342,3022,0.444,408,1138,0.359,934,1884,0.496,503,651,0.773,280,1187,1467,790,241,450,688,3595
2125,2017-12-29,Chicago Bulls,34,8210,1297,2994,0.433,351,1003,0.35,946,1991,0.475,444,608,0.73,318,1208,1526,789,242,439,645,3389
2126,2017-12-29,Memphis Grizzlies,35,8425,1236,2812,0.44,325,950,0.342,911,1862,0.489,614,769,0.798,300,1085,1385,718,253,477,799,3411
2127,2017-12-29,Sacramento Kings,34,8185,1293,2884,0.448,294,766,0.384,999,2118,0.472,414,570,0.726,315,1042,1357,705,274,464,666,3294
2128,2017-12-30,Golden State Warriors,36,8690,1559,3084,0.506,413,1072,0.385,1146,2012,0.57,589,725,0.812,310,1311,1621,1090,305,569,724,4120
2129,2017-12-30,Houston Rockets,34,8160,1320,2846,0.464,536,1464,0.366,784,1382,0.567,709,888,0.798,310,1178,1488,748,313,501,695,3885
2130,2017-12-30,New Orleans Pelicans,35,8475,1461,2977,0.491,399,1038,0.384,1062,1939,0.548,578,765,0.756,290,1202,1492,938,262,538,687,3899
2131,2017-12-30,Toronto Raptors,34,8160,1381,2930,0.471,379,1082,0.35,1002,1848,0.542,621,778,0.798,326,1118,1444,776,299,451,754,3762
2132,2017-12-30,Cleveland Cavaliers,35,8425,1390,2901,0.479,439,1143,0.384,951,1758,0.541,642,793,0.81,289,1169,1458,825,255,485,650,3861
2133,2017-12-30,Minnesota Timberwolves,36,8715,1457,3062,0.476,298,835,0.357,1159,2227,0.52,697,879,0.793,374,1120,1494,824,318,457,645,3909
2134,2017-12-30,Philadelphia 76ers,34,8260,1359,2969,0.458,364,1027,0.354,995,1942,0.512,587,785,0.748,389,1244,1633,886,286,595,803,3669
2135,2017-12-30,Brooklyn Nets,35,8425,1347,3049,0.442,422,1200,0.352,925,1849,0.5,647,860,0.752,366,1227,1593,796,230,524,724,3763
2136,2017-12-30,Indiana Pacers,36,8690,1484,3101,0.479,351,911,0.385,1133,2190,0.517,549,711,0.772,327,1183,1510,819,286,469,664,3868
2137,2017-12-30,Denver Nuggets,35,8475,1399,3018,0.464,391,1067,0.366,1008,1951,0.517,567,763,0.743,415,1175,1590,820,266,523,626,3756
2138,2017-12-30,Los Angeles Lakers,34,8260,1379,3049,0.452,297,915,0.325,1082,2134,0.507,559,811,0.689,382,1189,1571,780,280,539,755,3614
2139,2017-12-30,Washington Wizards,36,8690,1421,3098,0.459,346,948,0.365,1075,2150,0.5,630,826,0.763,357,1203,1560,813,281,476,780,3818
2140,2017-12-30,Phoenix Suns,37,8905,1432,3227,0.444,324,963,0.336,1108,2264,0.489,724,954,0.759,414,1273,1687,757,241,558,821,3912
2141,2017-12-30,Los Angeles Clippers,34,8185,1304,2876,0.453,363,1025,0.354,941,1851,0.508,616,825,0.747,360,1126,1486,704,258,474,711,3587
2142,2017-12-30,Milwaukee Bucks,34,8185,1340,2779,0.482,295,846,0.349,1045,1933,0.541,589,778,0.757,259,1055,1314,769,286,427,761,3564
2143,2017-12-30,Orlando Magic,36,8665,1419,3105,0.457,379,1052,0.36,1040,2053,0.507,556,746,0.745,300,1194,1494,827,271,523,709,3773
2144,2017-12-30,Charlotte Hornets,35,8450,1317,3014,0.437,304,870,0.349,1013,2144,0.472,716,983,0.728,369,1265,1634,719,226,453,635,3654
2145,2017-12-30,Atlanta Hawks,35,8425,1355,2960,0.458,380,1000,0.38,975,1960,0.497,546,698,0.782,323,1076,1399,842,297,525,692,3636
2146,2017-12-30,New York Knicks,35,8425,1398,3001,0.466,272,760,0.358,1126,2241,0.502,557,699,0.797,383,1169,1552,797,247,524,722,3625
2147,2017-12-30,Oklahoma City Thunder,36,8740,1387,3109,0.446,366,1034,0.354,1021,2075,0.492,578,815,0.709,437,1149,1586,747,354,504,744,3718
2148,2017-12-30,Boston Celtics,39,9385,1467,3245,0.452,454,1211,0.375,1013,2034,0.498,642,836,0.768,344,1367,1711,862,294,516,781,4030
2149,2017-12-30,Detroit Pistons,34,8160,1309,2928,0.447,375,986,0.38,934,1942,0.481,489,649,0.753,359,1085,1444,745,262,459,649,3482
2150,2017-12-30,Portland Trail Blazers,34,8185,1285,2897,0.444,311,840,0.37,974,2057,0.474,588,740,0.795,331,1196,1527,614,225,472,666,3469
2151,2017-12-30,San Antonio Spurs,36,8640,1389,3008,0.462,319,871,0.366,1070,2137,0.501,567,728,0.779,364,1237,1601,801,252,486,619,3664
2152,2017-12-30,Utah Jazz,36,8665,1328,2965,0.448,403,1073,0.376,925,1892,0.489,582,723,0.805,307,1148,1455,759,326,501,717,3641
2153,2017-12-30,Dallas Mavericks,37,8905,1388,3105,0.447,430,1177,0.365,958,1928,0.497,517,669,0.773,285,1225,1510,817,246,465,711,3723
2154,2017-12-30,Chicago Bulls,35,8450,1340,3079,0.435,369,1042,0.354,971,2037,0.477,459,623,0.737,325,1241,1566,820,248,454,665,3508
2155,2017-12-30,Miami Heat,35,8425,1295,2860,0.453,402,1102,0.365,893,1758,0.508,505,662,0.763,282,1162,1444,731,260,515,708,3497
2156,2017-12-30,Memphis Grizzlies,35,8425,1236,2812,0.44,325,950,0.342,911,1862,0.489,614,769,0.798,300,1085,1385,718,253,477,799,3411
2157,2017-12-30,Sacramento Kings,35,8425,1330,2964,0.449,302,789,0.383,1028,2175,0.473,433,593,0.73,323,1071,1394,728,280,473,689,3395
2158,2017-1-1,Golden State Warriors,34,8210,1473,2962,0.497,402,1056,0.381,1071,1906,0.562,630,793,0.794,309,1235,1544,1060,316,505,670,3978
2159,2017-1-1,Houston Rockets,35,8475,1430,3041,0.47,528,1388,0.38,902,1653,0.546,635,838,0.758,397,1181,1578,902,280,533,701,4023
2160,2017-1-1,Cleveland Cavaliers,32,7705,1256,2726,0.461,425,1067,0.398,831,1659,0.501,612,804,0.761,325,1087,1412,723,231,420,583,3549
2161,2017-1-1,Toronto Raptors,32,7705,1286,2736,0.47,309,795,0.389,977,1941,0.503,664,821,0.809,353,1012,1365,633,298,359,669,3545
2162,2017-1-1,Los Angeles Clippers,36,8690,1408,3031,0.465,373,991,0.376,1035,2040,0.507,699,918,0.761,336,1223,1559,795,290,452,744,3888
2163,2017-1-1,Denver Nuggets,33,7995,1293,2872,0.45,315,879,0.358,978,1993,0.491,658,878,0.749,411,1164,1575,751,213,506,692,3559
2164,2017-1-1,Portland Trail Blazers,35,8475,1371,3004,0.456,365,1009,0.362,1006,1995,0.504,660,837,0.789,335,1129,1464,766,245,461,789,3767
2165,2017-1-1,Oklahoma City Thunder,34,8260,1344,2931,0.459,285,867,0.329,1059,2064,0.513,644,886,0.727,380,1161,1541,736,261,501,690,3617
2166,2017-1-1,Phoenix Suns,34,8285,1334,3006,0.444,282,819,0.344,1052,2187,0.481,660,869,0.759,393,1135,1528,620,298,528,861,3610
2167,2017-1-1,Boston Celtics,34,8185,1319,2928,0.45,382,1075,0.355,937,1853,0.506,589,735,0.801,318,1086,1404,847,265,396,704,3609
2168,2017-1-1,Brooklyn Nets,32,7730,1202,2734,0.44,355,1054,0.337,847,1680,0.504,633,810,0.781,296,1113,1409,673,245,541,664,3392
2169,2017-1-1,Washington Wizards,32,7755,1287,2743,0.469,255,716,0.356,1032,2027,0.509,552,712,0.775,331,1013,1344,721,280,443,697,3381
2170,2017-1-1,New York Knicks,33,7995,1310,2967,0.442,296,832,0.356,1014,2135,0.475,564,713,0.791,400,1129,1529,711,241,442,698,3480
2171,2017-1-1,San Antonio Spurs,33,7920,1281,2703,0.474,296,722,0.41,985,1981,0.497,613,746,0.822,321,1103,1424,774,273,429,599,3471
2172,2017-1-1,Milwaukee Bucks,32,7730,1274,2691,0.473,276,765,0.361,998,1926,0.518,540,709,0.762,304,1085,1389,796,256,424,644,3364
2173,2017-1-1,Charlotte Hornets,34,8235,1291,2924,0.442,323,921,0.351,968,2003,0.483,661,857,0.771,320,1235,1555,800,225,389,564,3566
2174,2017-1-1,Minnesota Timberwolves,33,7970,1266,2780,0.455,275,777,0.354,991,2003,0.495,630,804,0.784,397,1011,1408,740,249,464,679,3437
2175,2017-1-1,Indiana Pacers,34,8260,1317,2912,0.452,276,775,0.356,1041,2137,0.487,629,775,0.812,295,1147,1442,752,288,469,680,3539
2176,2017-1-1,Los Angeles Lakers,36,8640,1387,3107,0.446,320,917,0.349,1067,2190,0.487,648,835,0.776,421,1156,1577,735,294,550,730,3742
2177,2017-1-1,New Orleans Pelicans,35,8550,1339,3041,0.44,309,892,0.346,1030,2149,0.479,613,812,0.755,294,1259,1553,801,263,421,646,3600
2178,2017-1-1,Atlanta Hawks,33,7945,1272,2801,0.454,280,860,0.326,992,1941,0.511,540,750,0.72,350,1095,1445,791,286,516,594,3364
2179,2017-1-1,Sacramento Kings,33,7995,1223,2739,0.447,286,813,0.352,937,1926,0.487,626,810,0.773,316,1046,1362,709,264,444,676,3358
2180,2017-1-1,Chicago Bulls,34,8160,1278,2944,0.434,207,675,0.307,1071,2269,0.472,655,819,0.8,467,1155,1622,711,259,443,596,3418
2181,2017-1-1,Philadelphia 76ers,32,7780,1176,2700,0.436,342,953,0.359,834,1747,0.477,475,637,0.746,306,1067,1373,720,245,522,707,3169
2182,2017-1-1,Utah Jazz,34,8160,1222,2614,0.467,331,898,0.369,891,1716,0.519,589,778,0.757,280,1163,1443,649,209,453,652,3364
2183,2017-1-1,Orlando Magic,34,8210,1281,2919,0.439,297,881,0.337,984,2038,0.483,500,705,0.709,325,1132,1457,744,220,414,624,3359
2184,2017-1-1,Memphis Grizzlies,36,8815,1283,3030,0.423,317,917,0.346,966,2113,0.457,665,852,0.781,388,1181,1569,730,310,449,861,3548
2185,2017-1-1,Detroit Pistons,35,8400,1346,3003,0.448,265,781,0.339,1081,2222,0.486,491,660,0.744,343,1190,1533,738,246,403,615,3448
2186,2017-1-1,Miami Heat,34,8235,1291,2934,0.44,289,850,0.34,1002,2084,0.481,475,720,0.66,381,1145,1526,714,232,423,690,3346
2187,2017-1-1,Dallas Mavericks,34,8210,1200,2796,0.429,351,1021,0.344,849,1775,0.478,482,607,0.794,297,1010,1307,666,273,389,643,3233
2188,2017-1-2,Golden State Warriors,34,8210,1473,2962,0.497,402,1056,0.381,1071,1906,0.562,630,793,0.794,309,1235,1544,1060,316,505,670,3978
2189,2017-1-2,Houston Rockets,35,8475,1430,3041,0.47,528,1388,0.38,902,1653,0.546,635,838,0.758,397,1181,1578,902,280,533,701,4023
2190,2017-1-2,Toronto Raptors,33,7945,1328,2811,0.472,319,812,0.393,1009,1999,0.505,693,853,0.812,358,1047,1405,651,303,375,694,3668
2191,2017-1-2,Cleveland Cavaliers,32,7705,1256,2726,0.461,425,1067,0.398,831,1659,0.501,612,804,0.761,325,1087,1412,723,231,420,583,3549
2192,2017-1-2,Los Angeles Clippers,36,8690,1408,3031,0.465,373,991,0.376,1035,2040,0.507,699,918,0.761,336,1223,1559,795,290,452,744,3888
2193,2017-1-2,Denver Nuggets,33,7995,1293,2872,0.45,315,879,0.358,978,1993,0.491,658,878,0.749,411,1164,1575,751,213,506,692,3559
2194,2017-1-2,Portland Trail Blazers,36,8715,1407,3077,0.457,371,1031,0.36,1036,2046,0.506,677,865,0.783,339,1166,1505,779,255,475,808,3862
2195,2017-1-2,Oklahoma City Thunder,34,8260,1344,2931,0.459,285,867,0.329,1059,2064,0.513,644,886,0.727,380,1161,1541,736,261,501,690,3617
2196,2017-1-2,Phoenix Suns,34,8285,1334,3006,0.444,282,819,0.344,1052,2187,0.481,660,869,0.759,393,1135,1528,620,298,528,861,3610
2197,2017-1-2,Boston Celtics,34,8185,1319,2928,0.45,382,1075,0.355,937,1853,0.506,589,735,0.801,318,1086,1404,847,265,396,704,3609
2198,2017-1-2,Brooklyn Nets,32,7730,1202,2734,0.44,355,1054,0.337,847,1680,0.504,633,810,0.781,296,1113,1409,673,245,541,664,3392
2199,2017-1-2,Washington Wizards,32,7755,1287,2743,0.469,255,716,0.356,1032,2027,0.509,552,712,0.775,331,1013,1344,721,280,443,697,3381
2200,2017-1-2,New York Knicks,33,7995,1310,2967,0.442,296,832,0.356,1014,2135,0.475,564,713,0.791,400,1129,1529,711,241,442,698,3480
2201,2017-1-2,San Antonio Spurs,34,8185,1323,2793,0.474,305,749,0.407,1018,2044,0.498,632,768,0.823,330,1141,1471,801,278,441,620,3583
2202,2017-1-2,Milwaukee Bucks,32,7730,1274,2691,0.473,276,765,0.361,998,1926,0.518,540,709,0.762,304,1085,1389,796,256,424,644,3364
2203,2017-1-2,Charlotte Hornets,34,8235,1291,2924,0.442,323,921,0.351,968,2003,0.483,661,857,0.771,320,1235,1555,800,225,389,564,3566
2204,2017-1-2,Indiana Pacers,35,8500,1360,2998,0.454,285,797,0.358,1075,2201,0.488,651,799,0.815,303,1185,1488,780,293,480,696,3656
2205,2017-1-2,Los Angeles Lakers,37,8880,1424,3199,0.445,335,949,0.353,1089,2250,0.484,673,866,0.777,437,1183,1620,754,302,557,751,3856
2206,2017-1-2,Minnesota Timberwolves,34,8210,1301,2867,0.454,282,800,0.353,1019,2067,0.493,642,822,0.781,410,1045,1455,761,260,480,704,3526
2207,2017-1-2,New Orleans Pelicans,35,8550,1339,3041,0.44,309,892,0.346,1030,2149,0.479,613,812,0.755,294,1259,1553,801,263,421,646,3600
2208,2017-1-2,Atlanta Hawks,34,8210,1314,2893,0.454,294,888,0.331,1020,2005,0.509,556,777,0.716,361,1130,1491,816,292,527,615,3478
2209,2017-1-2,Sacramento Kings,33,7995,1223,2739,0.447,286,813,0.352,937,1926,0.487,626,810,0.773,316,1046,1362,709,264,444,676,3358
2210,2017-1-2,Chicago Bulls,34,8160,1278,2944,0.434,207,675,0.307,1071,2269,0.472,655,819,0.8,467,1155,1622,711,259,443,596,3418
2211,2017-1-2,Philadelphia 76ers,32,7780,1176,2700,0.436,342,953,0.359,834,1747,0.477,475,637,0.746,306,1067,1373,720,245,522,707,3169
2212,2017-1-2,Orlando Magic,35,8450,1323,3016,0.439,307,919,0.334,1016,2097,0.485,510,716,0.712,335,1164,1499,769,226,424,646,3463
2213,2017-1-2,Utah Jazz,34,8160,1222,2614,0.467,331,898,0.369,891,1716,0.519,589,778,0.757,280,1163,1443,649,209,453,652,3364
2214,2017-1-2,Detroit Pistons,36,8640,1388,3089,0.449,274,803,0.341,1114,2286,0.487,505,682,0.74,353,1228,1581,754,253,415,633,3555
2215,2017-1-2,Memphis Grizzlies,36,8815,1283,3030,0.423,317,917,0.346,966,2113,0.457,665,852,0.781,388,1181,1569,730,310,449,861,3548
2216,2017-1-2,Miami Heat,35,8475,1326,3011,0.44,303,876,0.346,1023,2135,0.479,489,738,0.663,384,1176,1560,739,238,433,712,3444
2217,2017-1-2,Dallas Mavericks,34,8210,1200,2796,0.429,351,1021,0.344,849,1775,0.478,482,607,0.794,297,1010,1307,666,273,389,643,3233
2218,2017-1-3,Golden State Warriors,35,8450,1523,3057,0.498,413,1081,0.382,1110,1976,0.562,646,814,0.794,321,1266,1587,1093,323,518,684,4105
2219,2017-1-3,Houston Rockets,36,8715,1467,3127,0.469,540,1427,0.378,927,1700,0.545,650,859,0.757,404,1215,1619,927,289,546,713,4124
2220,2017-1-3,Toronto Raptors,33,7945,1328,2811,0.472,319,812,0.393,1009,1999,0.505,693,853,0.812,358,1047,1405,651,303,375,694,3668
2221,2017-1-3,Cleveland Cavaliers,33,7945,1290,2816,0.458,431,1098,0.393,859,1718,0.5,628,826,0.76,336,1132,1468,739,240,431,596,3639
2222,2017-1-3,Denver Nuggets,34,8235,1341,2973,0.451,324,914,0.354,1017,2059,0.494,672,896,0.75,427,1196,1623,784,223,520,713,3678
2223,2017-1-3,Los Angeles Clippers,37,8930,1445,3111,0.464,380,1007,0.377,1065,2104,0.506,727,956,0.76,348,1262,1610,812,291,471,765,3997
2224,2017-1-3,Portland Trail Blazers,36,8715,1407,3077,0.457,371,1031,0.36,1036,2046,0.506,677,865,0.783,339,1166,1505,779,255,475,808,3862
2225,2017-1-3,Boston Celtics,34,8185,1319,2928,0.45,382,1075,0.355,937,1853,0.506,589,735,0.801,318,1086,1404,847,265,396,704,3609
2226,2017-1-3,Oklahoma City Thunder,35,8500,1380,3009,0.459,294,894,0.329,1086,2115,0.513,657,905,0.726,388,1193,1581,756,268,511,710,3711
2227,2017-1-3,Phoenix Suns,35,8525,1373,3108,0.442,284,834,0.341,1089,2274,0.479,678,891,0.761,412,1164,1576,642,309,540,890,3708
2228,2017-1-3,Brooklyn Nets,33,7970,1235,2812,0.439,361,1081,0.334,874,1731,0.505,650,833,0.78,304,1149,1453,686,250,556,684,3481
2229,2017-1-3,San Antonio Spurs,34,8185,1323,2793,0.474,305,749,0.407,1018,2044,0.498,632,768,0.823,330,1141,1471,801,278,441,620,3583
2230,2017-1-3,New York Knicks,34,8235,1349,3050,0.442,304,853,0.356,1045,2197,0.476,581,737,0.788,416,1159,1575,729,248,460,715,3583
2231,2017-1-3,Washington Wizards,33,7995,1325,2830,0.468,261,742,0.352,1064,2088,0.51,561,724,0.775,338,1051,1389,744,289,460,718,3472
2232,2017-1-3,Charlotte Hornets,35,8475,1332,3007,0.443,332,940,0.353,1000,2067,0.484,681,879,0.775,327,1262,1589,824,232,403,583,3677
2233,2017-1-3,Milwaukee Bucks,33,7970,1312,2770,0.474,283,784,0.361,1029,1986,0.518,555,733,0.757,311,1117,1428,817,260,434,661,3462
2234,2017-1-3,Indiana Pacers,35,8500,1360,2998,0.454,285,797,0.358,1075,2201,0.488,651,799,0.815,303,1185,1488,780,293,480,696,3656
2235,2017-1-3,Los Angeles Lakers,37,8880,1424,3199,0.445,335,949,0.353,1089,2250,0.484,673,866,0.777,437,1183,1620,754,302,557,751,3856
2236,2017-1-3,Minnesota Timberwolves,34,8210,1301,2867,0.454,282,800,0.353,1019,2067,0.493,642,822,0.781,410,1045,1455,761,260,480,704,3526
2237,2017-1-3,Atlanta Hawks,34,8210,1314,2893,0.454,294,888,0.331,1020,2005,0.509,556,777,0.716,361,1130,1491,816,292,527,615,3478
2238,2017-1-3,New Orleans Pelicans,36,8790,1371,3129,0.438,320,918,0.349,1051,2211,0.475,620,822,0.754,302,1296,1598,827,269,434,664,3682
2239,2017-1-3,Sacramento Kings,33,7995,1223,2739,0.447,286,813,0.352,937,1926,0.487,626,810,0.773,316,1046,1362,709,264,444,676,3358
2240,2017-1-3,Chicago Bulls,35,8400,1320,3034,0.435,214,698,0.307,1106,2336,0.473,682,848,0.804,482,1185,1667,734,269,453,613,3536
2241,2017-1-3,Orlando Magic,36,8690,1368,3107,0.44,322,950,0.339,1046,2157,0.485,520,730,0.712,348,1190,1538,804,236,436,666,3578
2242,2017-1-3,Utah Jazz,35,8400,1261,2707,0.466,338,922,0.367,923,1785,0.517,605,798,0.758,292,1197,1489,660,218,462,671,3465
2243,2017-1-3,Philadelphia 76ers,32,7780,1176,2700,0.436,342,953,0.359,834,1747,0.477,475,637,0.746,306,1067,1373,720,245,522,707,3169
2244,2017-1-3,Detroit Pistons,36,8640,1388,3089,0.449,274,803,0.341,1114,2286,0.487,505,682,0.74,353,1228,1581,754,253,415,633,3555
2245,2017-1-3,Memphis Grizzlies,36,8815,1283,3030,0.423,317,917,0.346,966,2113,0.457,665,852,0.781,388,1181,1569,730,310,449,861,3548
2246,2017-1-3,Miami Heat,35,8475,1326,3011,0.44,303,876,0.346,1023,2135,0.479,489,738,0.663,384,1176,1560,739,238,433,712,3444
2247,2017-1-3,Dallas Mavericks,34,8210,1200,2796,0.429,351,1021,0.344,849,1775,0.478,482,607,0.794,297,1010,1307,666,273,389,643,3233
2248,2017-1-4,Golden State Warriors,35,8450,1523,3057,0.498,413,1081,0.382,1110,1976,0.562,646,814,0.794,321,1266,1587,1093,323,518,684,4105
2249,2017-1-4,Houston Rockets,36,8715,1467,3127,0.469,540,1427,0.378,927,1700,0.545,650,859,0.757,404,1215,1619,927,289,546,713,4124
2250,2017-1-4,Cleveland Cavaliers,33,7945,1290,2816,0.458,431,1098,0.393,859,1718,0.5,628,826,0.76,336,1132,1468,739,240,431,596,3639
2251,2017-1-4,Toronto Raptors,34,8185,1359,2894,0.47,323,830,0.389,1036,2064,0.502,709,875,0.81,372,1076,1448,659,311,387,711,3750
2252,2017-1-4,Denver Nuggets,35,8475,1382,3055,0.452,342,952,0.359,1040,2103,0.495,685,909,0.754,431,1224,1655,813,229,534,731,3791
2253,2017-1-4,Los Angeles Clippers,37,8930,1445,3111,0.464,380,1007,0.377,1065,2104,0.506,727,956,0.76,348,1262,1610,812,291,471,765,3997
2254,2017-1-4,Portland Trail Blazers,36,8715,1407,3077,0.457,371,1031,0.36,1036,2046,0.506,677,865,0.783,339,1166,1505,779,255,475,808,3862
2255,2017-1-4,Boston Celtics,35,8425,1360,3002,0.453,399,1106,0.361,961,1896,0.507,605,752,0.805,322,1114,1436,878,270,409,726,3724
2256,2017-1-4,Oklahoma City Thunder,35,8500,1380,3009,0.459,294,894,0.329,1086,2115,0.513,657,905,0.726,388,1193,1581,756,268,511,710,3711
2257,2017-1-4,Phoenix Suns,36,8765,1409,3185,0.442,293,857,0.342,1116,2328,0.479,696,913,0.762,425,1200,1625,663,316,558,913,3807
2258,2017-1-4,Brooklyn Nets,33,7970,1235,2812,0.439,361,1081,0.334,874,1731,0.505,650,833,0.78,304,1149,1453,686,250,556,684,3481
2259,2017-1-4,San Antonio Spurs,35,8425,1366,2871,0.476,318,773,0.411,1048,2098,0.5,643,783,0.821,336,1178,1514,833,285,456,638,3693
2260,2017-1-4,New York Knicks,34,8235,1349,3050,0.442,304,853,0.356,1045,2197,0.476,581,737,0.788,416,1159,1575,729,248,460,715,3583
2261,2017-1-4,Washington Wizards,34,8235,1366,2922,0.467,272,772,0.352,1094,2150,0.509,573,738,0.776,343,1084,1427,771,295,469,737,3577
2262,2017-1-4,Charlotte Hornets,35,8475,1332,3007,0.443,332,940,0.353,1000,2067,0.484,681,879,0.775,327,1262,1589,824,232,403,583,3677
2263,2017-1-4,Milwaukee Bucks,33,7970,1312,2770,0.474,283,784,0.361,1029,1986,0.518,555,733,0.757,311,1117,1428,817,260,434,661,3462
2264,2017-1-4,Indiana Pacers,36,8740,1403,3072,0.457,294,813,0.362,1109,2259,0.491,677,829,0.817,309,1213,1522,806,300,491,704,3777
2265,2017-1-4,Los Angeles Lakers,38,9120,1466,3281,0.447,352,982,0.358,1114,2299,0.485,688,894,0.77,446,1217,1663,788,307,566,774,3972
2266,2017-1-4,Minnesota Timberwolves,35,8450,1334,2949,0.452,289,824,0.351,1045,2125,0.492,660,842,0.784,419,1083,1502,781,267,497,728,3617
2267,2017-1-4,Atlanta Hawks,34,8210,1314,2893,0.454,294,888,0.331,1020,2005,0.509,556,777,0.716,361,1130,1491,816,292,527,615,3478
2268,2017-1-4,New Orleans Pelicans,36,8790,1371,3129,0.438,320,918,0.349,1051,2211,0.475,620,822,0.754,302,1296,1598,827,269,434,664,3682
2269,2017-1-4,Sacramento Kings,34,8235,1269,2827,0.449,297,842,0.353,972,1985,0.49,643,828,0.777,321,1074,1395,735,271,452,689,3478
2270,2017-1-4,Chicago Bulls,35,8400,1320,3034,0.435,214,698,0.307,1106,2336,0.473,682,848,0.804,482,1185,1667,734,269,453,613,3536
2271,2017-1-4,Orlando Magic,36,8690,1368,3107,0.44,322,950,0.339,1046,2157,0.485,520,730,0.712,348,1190,1538,804,236,436,666,3578
2272,2017-1-4,Detroit Pistons,37,8880,1436,3186,0.451,284,832,0.341,1152,2354,0.489,515,694,0.742,369,1254,1623,785,258,425,652,3671
2273,2017-1-4,Utah Jazz,36,8640,1299,2789,0.466,349,948,0.368,950,1841,0.516,622,819,0.759,300,1224,1524,687,225,472,688,3569
2274,2017-1-4,Philadelphia 76ers,33,8020,1209,2785,0.434,349,985,0.354,860,1800,0.478,495,662,0.748,318,1103,1421,739,255,538,728,3262
2275,2017-1-4,Memphis Grizzlies,37,9055,1313,3107,0.423,327,948,0.345,986,2159,0.457,697,887,0.786,393,1215,1608,748,316,459,877,3650
2276,2017-1-4,Miami Heat,36,8715,1362,3102,0.439,309,899,0.344,1053,2203,0.478,501,754,0.664,399,1204,1603,757,246,445,735,3534
2277,2017-1-4,Dallas Mavericks,35,8450,1237,2874,0.43,368,1053,0.349,869,1821,0.477,504,631,0.799,299,1050,1349,686,277,401,664,3346
2278,2017-1-5,Golden State Warriors,36,8690,1567,3144,0.498,426,1117,0.381,1141,2027,0.563,670,843,0.795,329,1297,1626,1124,337,533,704,4230
2279,2017-1-5,Houston Rockets,36,8715,1467,3127,0.469,540,1427,0.378,927,1700,0.545,650,859,0.757,404,1215,1619,927,289,546,713,4124
2280,2017-1-5,Toronto Raptors,34,8185,1359,2894,0.47,323,830,0.389,1036,2064,0.502,709,875,0.81,372,1076,1448,659,311,387,711,3750
2281,2017-1-5,Cleveland Cavaliers,34,8185,1324,2899,0.457,439,1123,0.391,885,1776,0.498,646,850,0.76,352,1160,1512,752,246,446,612,3733
2282,2017-1-5,Denver Nuggets,35,8475,1382,3055,0.452,342,952,0.359,1040,2103,0.495,685,909,0.754,431,1224,1655,813,229,534,731,3791
2283,2017-1-5,Los Angeles Clippers,38,9170,1482,3184,0.465,389,1030,0.378,1093,2154,0.507,759,1001,0.758,356,1299,1655,835,296,484,788,4112
2284,2017-1-5,Portland Trail Blazers,37,8955,1447,3166,0.457,383,1057,0.362,1064,2109,0.505,702,893,0.786,350,1199,1549,802,263,492,834,3979
2285,2017-1-5,Boston Celtics,35,8425,1360,3002,0.453,399,1106,0.361,961,1896,0.507,605,752,0.805,322,1114,1436,878,270,409,726,3724
2286,2017-1-5,Oklahoma City Thunder,36,8740,1422,3105,0.458,303,924,0.328,1119,2181,0.513,676,928,0.728,402,1230,1632,778,274,525,741,3823
2287,2017-1-5,Phoenix Suns,36,8765,1409,3185,0.442,293,857,0.342,1116,2328,0.479,696,913,0.762,425,1200,1625,663,316,558,913,3807
2288,2017-1-5,Charlotte Hornets,36,8715,1369,3087,0.443,341,964,0.354,1028,2123,0.484,721,928,0.777,337,1295,1632,849,240,414,604,3800
2289,2017-1-5,Brooklyn Nets,33,7970,1235,2812,0.439,361,1081,0.334,874,1731,0.505,650,833,0.78,304,1149,1453,686,250,556,684,3481
2290,2017-1-5,San Antonio Spurs,35,8425,1366,2871,0.476,318,773,0.411,1048,2098,0.5,643,783,0.821,336,1178,1514,833,285,456,638,3693
2291,2017-1-5,New York Knicks,35,8475,1391,3144,0.442,317,881,0.36,1074,2263,0.475,588,749,0.785,431,1190,1621,755,257,473,734,3687
2292,2017-1-5,Washington Wizards,34,8235,1366,2922,0.467,272,772,0.352,1094,2150,0.509,573,738,0.776,343,1084,1427,771,295,469,737,3577
2293,2017-1-5,Milwaukee Bucks,34,8210,1349,2848,0.474,292,812,0.36,1057,2036,0.519,577,764,0.755,318,1152,1470,837,267,447,676,3567
2294,2017-1-5,Indiana Pacers,36,8740,1403,3072,0.457,294,813,0.362,1109,2259,0.491,677,829,0.817,309,1213,1522,806,300,491,704,3777
2295,2017-1-5,Los Angeles Lakers,38,9120,1466,3281,0.447,352,982,0.358,1114,2299,0.485,688,894,0.77,446,1217,1663,788,307,566,774,3972
2296,2017-1-5,Minnesota Timberwolves,35,8450,1334,2949,0.452,289,824,0.351,1045,2125,0.492,660,842,0.784,419,1083,1502,781,267,497,728,3617
2297,2017-1-5,Atlanta Hawks,35,8450,1358,2974,0.457,304,907,0.335,1054,2067,0.51,569,795,0.716,364,1166,1530,843,304,539,627,3589
2298,2017-1-5,New Orleans Pelicans,36,8790,1371,3129,0.438,320,918,0.349,1051,2211,0.475,620,822,0.754,302,1296,1598,827,269,434,664,3682
2299,2017-1-5,Sacramento Kings,35,8475,1309,2905,0.451,305,862,0.354,1004,2043,0.491,657,845,0.778,325,1096,1421,761,279,468,717,3580
2300,2017-1-5,Chicago Bulls,36,8640,1361,3119,0.436,227,728,0.312,1134,2391,0.474,693,863,0.803,494,1216,1710,757,277,465,631,3642
2301,2017-1-5,Detroit Pistons,37,8880,1436,3186,0.451,284,832,0.341,1152,2354,0.489,515,694,0.742,369,1254,1623,785,258,425,652,3671
2302,2017-1-5,Orlando Magic,37,8930,1405,3193,0.44,331,978,0.338,1074,2215,0.485,529,740,0.715,358,1220,1578,823,245,453,683,3670
2303,2017-1-5,Utah Jazz,36,8640,1299,2789,0.466,349,948,0.368,950,1841,0.516,622,819,0.759,300,1224,1524,687,225,472,688,3569
2304,2017-1-5,Memphis Grizzlies,38,9295,1351,3195,0.423,338,976,0.346,1013,2219,0.457,716,912,0.785,405,1246,1651,778,322,468,908,3756
2305,2017-1-5,Philadelphia 76ers,33,8020,1209,2785,0.434,349,985,0.354,860,1800,0.478,495,662,0.748,318,1103,1421,739,255,538,728,3262
2306,2017-1-5,Miami Heat,37,8955,1397,3174,0.44,321,927,0.346,1076,2247,0.479,526,783,0.672,406,1236,1642,781,254,463,755,3641
2307,2017-1-5,Dallas Mavericks,35,8450,1237,2874,0.43,368,1053,0.349,869,1821,0.477,504,631,0.799,299,1050,1349,686,277,401,664,3346
2308,2017-1-6,Golden State Warriors,36,8690,1567,3144,0.498,426,1117,0.381,1141,2027,0.563,670,843,0.795,329,1297,1626,1124,337,533,704,4230
2309,2017-1-6,Houston Rockets,37,8955,1508,3213,0.469,555,1466,0.379,953,1747,0.546,671,889,0.755,413,1249,1662,954,295,555,733,4242
2310,2017-1-6,Toronto Raptors,35,8425,1395,2985,0.467,331,851,0.389,1064,2134,0.499,730,903,0.808,393,1100,1493,673,321,391,730,3851
2311,2017-1-6,Cleveland Cavaliers,34,8185,1324,2899,0.457,439,1123,0.391,885,1776,0.498,646,850,0.76,352,1160,1512,752,246,446,612,3733
2312,2017-1-6,Los Angeles Clippers,38,9170,1482,3184,0.465,389,1030,0.378,1093,2154,0.507,759,1001,0.758,356,1299,1655,835,296,484,788,4112
2313,2017-1-6,Denver Nuggets,36,8715,1421,3141,0.452,349,977,0.357,1072,2164,0.495,699,926,0.755,442,1251,1693,838,236,547,748,3890
2314,2017-1-6,Portland Trail Blazers,38,9195,1490,3247,0.459,395,1090,0.362,1095,2157,0.508,722,923,0.782,358,1238,1596,831,269,505,855,4097
2315,2017-1-6,Oklahoma City Thunder,37,8980,1463,3196,0.458,315,954,0.33,1148,2242,0.512,698,955,0.731,418,1268,1686,793,280,534,762,3939
2316,2017-1-6,Boston Celtics,35,8425,1360,3002,0.453,399,1106,0.361,961,1896,0.507,605,752,0.805,322,1114,1436,878,270,409,726,3724
2317,2017-1-6,San Antonio Spurs,36,8665,1417,2961,0.479,330,797,0.414,1087,2164,0.502,656,800,0.82,343,1212,1555,867,290,463,653,3820
2318,2017-1-6,Charlotte Hornets,37,8955,1406,3178,0.442,351,990,0.355,1055,2188,0.482,751,962,0.781,345,1336,1681,869,244,419,627,3914
2319,2017-1-6,Brooklyn Nets,34,8210,1276,2902,0.44,378,1119,0.338,898,1783,0.504,660,846,0.78,312,1186,1498,708,255,569,701,3590
2320,2017-1-6,Phoenix Suns,37,9005,1447,3270,0.443,300,874,0.343,1147,2396,0.479,715,935,0.765,443,1235,1678,678,320,573,934,3909
2321,2017-1-6,Indiana Pacers,37,8980,1451,3165,0.458,304,835,0.364,1147,2330,0.492,692,848,0.816,316,1250,1566,829,307,497,716,3898
2322,2017-1-6,New York Knicks,35,8475,1391,3144,0.442,317,881,0.36,1074,2263,0.475,588,749,0.785,431,1190,1621,755,257,473,734,3687
2323,2017-1-6,Washington Wizards,34,8235,1366,2922,0.467,272,772,0.352,1094,2150,0.509,573,738,0.776,343,1084,1427,771,295,469,737,3577
2324,2017-1-6,Milwaukee Bucks,34,8210,1349,2848,0.474,292,812,0.36,1057,2036,0.519,577,764,0.755,318,1152,1470,837,267,447,676,3567
2325,2017-1-6,Los Angeles Lakers,39,9360,1502,3367,0.446,362,1013,0.357,1140,2354,0.484,715,927,0.771,456,1247,1703,803,314,577,799,4081
2326,2017-1-6,Minnesota Timberwolves,35,8450,1334,2949,0.452,289,824,0.351,1045,2125,0.492,660,842,0.784,419,1083,1502,781,267,497,728,3617
2327,2017-1-6,Atlanta Hawks,36,8690,1396,3064,0.456,313,930,0.337,1083,2134,0.507,583,812,0.718,376,1209,1585,866,313,553,641,3688
2328,2017-1-6,Sacramento Kings,35,8475,1309,2905,0.451,305,862,0.354,1004,2043,0.491,657,845,0.778,325,1096,1421,761,279,468,717,3580
2329,2017-1-6,New Orleans Pelicans,37,9030,1405,3222,0.436,335,953,0.352,1070,2269,0.472,631,836,0.755,317,1333,1650,846,277,449,682,3776
2330,2017-1-6,Chicago Bulls,36,8640,1361,3119,0.436,227,728,0.312,1134,2391,0.474,693,863,0.803,494,1216,1710,757,277,465,631,3642
2331,2017-1-6,Detroit Pistons,38,9120,1475,3283,0.449,294,860,0.342,1181,2423,0.487,542,726,0.747,385,1294,1679,809,260,432,675,3786
2332,2017-1-6,Orlando Magic,37,8930,1405,3193,0.44,331,978,0.338,1074,2215,0.485,529,740,0.715,358,1220,1578,823,245,453,683,3670
2333,2017-1-6,Utah Jazz,37,8880,1333,2862,0.466,356,968,0.368,977,1894,0.516,640,840,0.762,312,1258,1570,703,227,490,710,3662
2334,2017-1-6,Memphis Grizzlies,38,9295,1351,3195,0.423,338,976,0.346,1013,2219,0.457,716,912,0.785,405,1246,1651,778,322,468,908,3756
2335,2017-1-6,Philadelphia 76ers,33,8020,1209,2785,0.434,349,985,0.354,860,1800,0.478,495,662,0.748,318,1103,1421,739,255,538,728,3262
2336,2017-1-6,Miami Heat,37,8955,1397,3174,0.44,321,927,0.346,1076,2247,0.479,526,783,0.672,406,1236,1642,781,254,463,755,3641
2337,2017-1-6,Dallas Mavericks,36,8690,1273,2953,0.431,377,1082,0.348,896,1871,0.479,518,648,0.799,306,1074,1380,704,283,411,684,3441
2338,2017-1-7,Golden State Warriors,37,8955,1608,3227,0.498,434,1147,0.378,1174,2080,0.564,699,882,0.793,336,1334,1670,1147,344,549,725,4349
2339,2017-1-7,Houston Rockets,38,9195,1547,3299,0.469,570,1515,0.376,977,1784,0.548,678,901,0.752,425,1282,1707,980,307,570,748,4342
2340,2017-1-7,Cleveland Cavaliers,35,8425,1362,2987,0.456,448,1156,0.388,914,1831,0.499,677,893,0.758,357,1201,1558,771,260,458,628,3849
2341,2017-1-7,Toronto Raptors,35,8425,1395,2985,0.467,331,851,0.389,1064,2134,0.499,730,903,0.808,393,1100,1493,673,321,391,730,3851
2342,2017-1-7,Los Angeles Clippers,39,9410,1521,3268,0.465,402,1061,0.379,1119,2207,0.507,774,1022,0.757,364,1336,1700,863,302,492,801,4218
2343,2017-1-7,Denver Nuggets,36,8715,1421,3141,0.452,349,977,0.357,1072,2164,0.495,699,926,0.755,442,1251,1693,838,236,547,748,3890
2344,2017-1-7,Portland Trail Blazers,38,9195,1490,3247,0.459,395,1090,0.362,1095,2157,0.508,722,923,0.782,358,1238,1596,831,269,505,855,4097
2345,2017-1-7,Oklahoma City Thunder,37,8980,1463,3196,0.458,315,954,0.33,1148,2242,0.512,698,955,0.731,418,1268,1686,793,280,534,762,3939
2346,2017-1-7,Boston Celtics,36,8665,1395,3089,0.452,418,1146,0.365,977,1943,0.503,626,777,0.806,334,1144,1478,906,276,426,748,3834
2347,2017-1-7,San Antonio Spurs,36,8665,1417,2961,0.479,330,797,0.414,1087,2164,0.502,656,800,0.82,343,1212,1555,867,290,463,653,3820
2348,2017-1-7,Charlotte Hornets,37,8955,1406,3178,0.442,351,990,0.355,1055,2188,0.482,751,962,0.781,345,1336,1681,869,244,419,627,3914
2349,2017-1-7,Brooklyn Nets,35,8450,1317,2993,0.44,387,1149,0.337,930,1844,0.504,677,865,0.783,322,1228,1550,729,261,588,735,3698
2350,2017-1-7,Phoenix Suns,37,9005,1447,3270,0.443,300,874,0.343,1147,2396,0.479,715,935,0.765,443,1235,1678,678,320,573,934,3909
2351,2017-1-7,New York Knicks,36,8715,1432,3227,0.444,330,904,0.365,1102,2323,0.474,609,776,0.785,442,1219,1661,784,262,487,755,3803
2352,2017-1-7,Washington Wizards,35,8475,1412,3001,0.471,284,794,0.358,1128,2207,0.511,581,747,0.778,348,1112,1460,802,298,482,755,3689
2353,2017-1-7,Indiana Pacers,37,8980,1451,3165,0.458,304,835,0.364,1147,2330,0.492,692,848,0.816,316,1250,1566,829,307,497,716,3898
2354,2017-1-7,Los Angeles Lakers,40,9600,1550,3463,0.448,372,1041,0.357,1178,2422,0.486,736,956,0.77,474,1291,1765,825,320,588,821,4208
2355,2017-1-7,Milwaukee Bucks,35,8450,1388,2926,0.474,304,834,0.365,1084,2092,0.518,598,792,0.755,324,1181,1505,861,276,461,695,3678
2356,2017-1-7,Minnesota Timberwolves,36,8690,1376,3037,0.453,296,842,0.352,1080,2195,0.492,674,859,0.785,431,1109,1540,803,273,507,743,3722
2357,2017-1-7,Atlanta Hawks,36,8690,1396,3064,0.456,313,930,0.337,1083,2134,0.507,583,812,0.718,376,1209,1585,866,313,553,641,3688
2358,2017-1-7,Sacramento Kings,36,8715,1345,2992,0.45,314,892,0.352,1031,2100,0.491,674,867,0.777,337,1134,1471,784,283,474,735,3678
2359,2017-1-7,New Orleans Pelicans,37,9030,1405,3222,0.436,335,953,0.352,1070,2269,0.472,631,836,0.755,317,1333,1650,846,277,449,682,3776
2360,2017-1-7,Chicago Bulls,36,8640,1361,3119,0.436,227,728,0.312,1134,2391,0.474,693,863,0.803,494,1216,1710,757,277,465,631,3642
2361,2017-1-7,Detroit Pistons,38,9120,1475,3283,0.449,294,860,0.342,1181,2423,0.487,542,726,0.747,385,1294,1679,809,260,432,675,3786
2362,2017-1-7,Memphis Grizzlies,39,9560,1401,3298,0.425,351,1009,0.348,1050,2289,0.459,731,931,0.785,419,1279,1698,807,335,480,936,3884
2363,2017-1-7,Philadelphia 76ers,34,8260,1246,2864,0.435,358,1013,0.353,888,1851,0.48,518,688,0.753,322,1140,1462,769,264,553,751,3368
2364,2017-1-7,Orlando Magic,38,9170,1443,3284,0.439,339,1001,0.339,1104,2283,0.484,538,753,0.714,377,1250,1627,841,253,468,697,3763
2365,2017-1-7,Utah Jazz,37,8880,1333,2862,0.466,356,968,0.368,977,1894,0.516,640,840,0.762,312,1258,1570,703,227,490,710,3662
2366,2017-1-7,Miami Heat,38,9195,1435,3266,0.439,329,959,0.343,1106,2307,0.479,542,810,0.669,417,1266,1683,798,259,473,778,3741
2367,2017-1-7,Dallas Mavericks,36,8690,1273,2953,0.431,377,1082,0.348,896,1871,0.479,518,648,0.799,306,1074,1380,704,283,411,684,3441
2368,2017-1-8,Golden State Warriors,37,8955,1608,3227,0.498,434,1147,0.378,1174,2080,0.564,699,882,0.793,336,1334,1670,1147,344,549,725,4349
2369,2017-1-8,Houston Rockets,38,9195,1547,3299,0.469,570,1515,0.376,977,1784,0.548,678,901,0.752,425,1282,1707,980,307,570,748,4342
2370,2017-1-8,Toronto Raptors,36,8690,1432,3070,0.466,339,882,0.384,1093,2188,0.5,766,946,0.81,399,1135,1534,693,332,401,752,3969
2371,2017-1-8,Cleveland Cavaliers,35,8425,1362,2987,0.456,448,1156,0.388,914,1831,0.499,677,893,0.758,357,1201,1558,771,260,458,628,3849
2372,2017-1-8,Los Angeles Clippers,39,9410,1521,3268,0.465,402,1061,0.379,1119,2207,0.507,774,1022,0.757,364,1336,1700,863,302,492,801,4218
2373,2017-1-8,Denver Nuggets,37,8955,1461,3240,0.451,358,1001,0.358,1103,2239,0.493,716,950,0.754,457,1289,1746,856,243,559,771,3996
2374,2017-1-8,Portland Trail Blazers,38,9195,1490,3247,0.459,395,1090,0.362,1095,2157,0.508,722,923,0.782,358,1238,1596,831,269,505,855,4097
2375,2017-1-8,Oklahoma City Thunder,38,9220,1506,3285,0.458,327,990,0.33,1179,2295,0.514,721,984,0.733,424,1311,1735,816,288,544,782,4060
2376,2017-1-8,Boston Celtics,37,8905,1435,3182,0.451,436,1182,0.369,999,2000,0.5,645,798,0.808,349,1176,1525,932,282,436,770,3951
2377,2017-1-8,San Antonio Spurs,37,8905,1453,3050,0.476,343,831,0.413,1110,2219,0.5,673,820,0.821,352,1246,1598,896,299,470,674,3922
2378,2017-1-8,Indiana Pacers,38,9220,1494,3251,0.46,315,859,0.367,1179,2392,0.493,718,876,0.82,328,1291,1619,854,318,516,739,4021
2379,2017-1-8,Brooklyn Nets,35,8450,1317,2993,0.44,387,1149,0.337,930,1844,0.504,677,865,0.783,322,1228,1550,729,261,588,735,3698
2380,2017-1-8,New York Knicks,37,8955,1472,3314,0.444,342,935,0.366,1130,2379,0.475,626,800,0.783,448,1245,1693,809,271,504,779,3912
2381,2017-1-8,Phoenix Suns,37,9005,1447,3270,0.443,300,874,0.343,1147,2396,0.479,715,935,0.765,443,1235,1678,678,320,573,934,3909
2382,2017-1-8,Washington Wizards,35,8475,1412,3001,0.471,284,794,0.358,1128,2207,0.511,581,747,0.778,348,1112,1460,802,298,482,755,3689
2383,2017-1-8,Los Angeles Lakers,40,9600,1550,3463,0.448,372,1041,0.357,1178,2422,0.486,736,956,0.77,474,1291,1765,825,320,588,821,4208
2384,2017-1-8,Charlotte Hornets,38,9195,1436,3253,0.441,355,1011,0.351,1081,2242,0.482,772,987,0.782,353,1376,1729,887,249,434,641,3999
2385,2017-1-8,Milwaukee Bucks,35,8450,1388,2926,0.474,304,834,0.365,1084,2092,0.518,598,792,0.755,324,1181,1505,861,276,461,695,3678
2386,2017-1-8,Minnesota Timberwolves,37,8930,1411,3117,0.453,303,862,0.352,1108,2255,0.491,689,880,0.783,445,1143,1588,826,276,522,764,3814
2387,2017-1-8,Atlanta Hawks,37,8930,1426,3138,0.454,324,952,0.34,1102,2186,0.504,609,844,0.722,382,1250,1632,885,321,563,656,3785
2388,2017-1-8,New Orleans Pelicans,38,9270,1445,3307,0.437,345,984,0.351,1100,2323,0.474,649,859,0.756,326,1366,1692,868,284,460,702,3884
2389,2017-1-8,Sacramento Kings,36,8715,1345,2992,0.45,314,892,0.352,1031,2100,0.491,674,867,0.777,337,1134,1471,784,283,474,735,3678
2390,2017-1-8,Chicago Bulls,37,8905,1399,3216,0.435,238,756,0.315,1161,2460,0.472,729,902,0.808,511,1259,1770,782,282,479,658,3765
2391,2017-1-8,Detroit Pistons,38,9120,1475,3283,0.449,294,860,0.342,1181,2423,0.487,542,726,0.747,385,1294,1679,809,260,432,675,3786
2392,2017-1-8,Memphis Grizzlies,39,9560,1401,3298,0.425,351,1009,0.348,1050,2289,0.459,731,931,0.785,419,1279,1698,807,335,480,936,3884
2393,2017-1-8,Philadelphia 76ers,34,8260,1246,2864,0.435,358,1013,0.353,888,1851,0.48,518,688,0.753,322,1140,1462,769,264,553,751,3368
2394,2017-1-8,Orlando Magic,38,9170,1443,3284,0.439,339,1001,0.339,1104,2283,0.484,538,753,0.714,377,1250,1627,841,253,468,697,3763
2395,2017-1-8,Utah Jazz,38,9120,1365,2939,0.464,364,991,0.367,1001,1948,0.514,662,868,0.763,322,1287,1609,726,239,498,729,3756
2396,2017-1-8,Miami Heat,38,9195,1435,3266,0.439,329,959,0.343,1106,2307,0.479,542,810,0.669,417,1266,1683,798,259,473,778,3741
2397,2017-1-8,Dallas Mavericks,37,8930,1305,3035,0.43,386,1118,0.345,919,1917,0.479,527,658,0.801,312,1109,1421,722,290,425,709,3523
2398,2017-1-9,Golden State Warriors,38,9195,1653,3316,0.498,444,1176,0.378,1209,2140,0.565,716,902,0.794,349,1367,1716,1180,355,566,747,4466
2399,2017-1-9,Houston Rockets,39,9435,1593,3388,0.47,581,1553,0.374,1012,1835,0.551,704,932,0.755,435,1311,1746,1007,316,585,770,4471
2400,2017-1-9,Toronto Raptors,37,8930,1474,3148,0.468,350,907,0.386,1124,2241,0.502,793,976,0.813,403,1170,1573,712,339,418,777,4091
2401,2017-1-9,Cleveland Cavaliers,36,8665,1406,3069,0.458,463,1190,0.389,943,1879,0.502,694,912,0.761,370,1226,1596,786,268,478,640,3969
2402,2017-1-9,Portland Trail Blazers,39,9485,1541,3345,0.461,410,1125,0.364,1131,2220,0.509,729,935,0.78,365,1273,1638,867,274,521,866,4221
2403,2017-1-9,Denver Nuggets,37,8955,1461,3240,0.451,358,1001,0.358,1103,2239,0.493,716,950,0.754,457,1289,1746,856,243,559,771,3996
2404,2017-1-9,Los Angeles Clippers,40,9650,1557,3354,0.464,411,1091,0.377,1146,2263,0.506,791,1047,0.755,373,1378,1751,890,310,503,821,4316
2405,2017-1-9,Oklahoma City Thunder,38,9220,1506,3285,0.458,327,990,0.33,1179,2295,0.514,721,984,0.733,424,1311,1735,816,288,544,782,4060
2406,2017-1-9,Boston Celtics,37,8905,1435,3182,0.451,436,1182,0.369,999,2000,0.5,645,798,0.808,349,1176,1525,932,282,436,770,3951
2407,2017-1-9,San Antonio Spurs,37,8905,1453,3050,0.476,343,831,0.413,1110,2219,0.5,673,820,0.821,352,1246,1598,896,299,470,674,3922
2408,2017-1-9,Phoenix Suns,38,9245,1493,3357,0.445,309,901,0.343,1184,2456,0.482,730,954,0.765,456,1258,1714,701,332,587,953,4025
2409,2017-1-9,Indiana Pacers,38,9220,1494,3251,0.46,315,859,0.367,1179,2392,0.493,718,876,0.82,328,1291,1619,854,318,516,739,4021
2410,2017-1-9,New York Knicks,37,8955,1472,3314,0.444,342,935,0.366,1130,2379,0.475,626,800,0.783,448,1245,1693,809,271,504,779,3912
2411,2017-1-9,Washington Wizards,36,8715,1453,3085,0.471,294,826,0.356,1159,2259,0.513,596,765,0.779,361,1148,1509,825,308,501,777,3796
2412,2017-1-9,Brooklyn Nets,36,8690,1353,3071,0.441,397,1176,0.338,956,1895,0.504,690,882,0.782,326,1264,1590,750,267,610,758,3793
2413,2017-1-9,Los Angeles Lakers,41,9840,1592,3550,0.448,380,1073,0.354,1212,2477,0.489,755,980,0.77,480,1332,1812,848,328,601,842,4319
2414,2017-1-9,Charlotte Hornets,38,9195,1436,3253,0.441,355,1011,0.351,1081,2242,0.482,772,987,0.782,353,1376,1729,887,249,434,641,3999
2415,2017-1-9,Milwaukee Bucks,36,8690,1425,3006,0.474,313,857,0.365,1112,2149,0.517,616,812,0.759,329,1208,1537,886,290,477,715,3779
2416,2017-1-9,Minnesota Timberwolves,37,8930,1411,3117,0.453,303,862,0.352,1108,2255,0.491,689,880,0.783,445,1143,1588,826,276,522,764,3814
2417,2017-1-9,Atlanta Hawks,37,8930,1426,3138,0.454,324,952,0.34,1102,2186,0.504,609,844,0.722,382,1250,1632,885,321,563,656,3785
2418,2017-1-9,Sacramento Kings,37,8955,1381,3066,0.45,325,920,0.353,1056,2146,0.492,697,896,0.778,338,1164,1502,805,296,492,752,3784
2419,2017-1-9,New Orleans Pelicans,38,9270,1445,3307,0.437,345,984,0.351,1100,2323,0.474,649,859,0.756,326,1366,1692,868,284,460,702,3884
2420,2017-1-9,Chicago Bulls,37,8905,1399,3216,0.435,238,756,0.315,1161,2460,0.472,729,902,0.808,511,1259,1770,782,282,479,658,3765
2421,2017-1-9,Detroit Pistons,39,9410,1529,3388,0.451,302,885,0.341,1227,2503,0.49,551,738,0.747,391,1329,1720,828,274,441,691,3911
2422,2017-1-9,Memphis Grizzlies,40,9800,1435,3376,0.425,360,1033,0.348,1075,2343,0.459,742,945,0.785,424,1311,1735,826,346,493,959,3972
2423,2017-1-9,Philadelphia 76ers,35,8500,1283,2958,0.434,366,1040,0.352,917,1918,0.478,541,715,0.757,328,1180,1508,788,275,566,768,3473
2424,2017-1-9,Orlando Magic,39,9410,1477,3374,0.438,346,1027,0.337,1131,2347,0.482,558,782,0.714,395,1286,1681,865,258,486,717,3858
2425,2017-1-9,Utah Jazz,39,9360,1393,3011,0.463,373,1014,0.368,1020,1997,0.511,676,891,0.759,333,1319,1652,740,247,515,748,3835
2426,2017-1-9,Miami Heat,39,9435,1466,3350,0.438,336,986,0.341,1130,2364,0.478,559,831,0.673,428,1305,1733,812,265,488,799,3827
2427,2017-1-9,Dallas Mavericks,37,8930,1305,3035,0.43,386,1118,0.345,919,1917,0.479,527,658,0.801,312,1109,1421,722,290,425,709,3523
2428,2017-1-10,Golden State Warriors,38,9195,1653,3316,0.498,444,1176,0.378,1209,2140,0.565,716,902,0.794,349,1367,1716,1180,355,566,747,4466
2429,2017-1-10,Houston Rockets,39,9435,1593,3388,0.47,581,1553,0.374,1012,1835,0.551,704,932,0.755,435,1311,1746,1007,316,585,770,4471
2430,2017-1-10,Toronto Raptors,37,8930,1474,3148,0.468,350,907,0.386,1124,2241,0.502,793,976,0.813,403,1170,1573,712,339,418,777,4091
2431,2017-1-10,Cleveland Cavaliers,36,8665,1406,3069,0.458,463,1190,0.389,943,1879,0.502,694,912,0.761,370,1226,1596,786,268,478,640,3969
2432,2017-1-10,Portland Trail Blazers,39,9485,1541,3345,0.461,410,1125,0.364,1131,2220,0.509,729,935,0.78,365,1273,1638,867,274,521,866,4221
2433,2017-1-10,Denver Nuggets,37,8955,1461,3240,0.451,358,1001,0.358,1103,2239,0.493,716,950,0.754,457,1289,1746,856,243,559,771,3996
2434,2017-1-10,Los Angeles Clippers,40,9650,1557,3354,0.464,411,1091,0.377,1146,2263,0.506,791,1047,0.755,373,1378,1751,890,310,503,821,4316
2435,2017-1-10,Oklahoma City Thunder,39,9460,1553,3368,0.461,334,1014,0.329,1219,2354,0.518,729,995,0.733,430,1347,1777,846,293,556,799,4169
2436,2017-1-10,Boston Celtics,37,8905,1435,3182,0.451,436,1182,0.369,999,2000,0.5,645,798,0.808,349,1176,1525,932,282,436,770,3951
2437,2017-1-10,San Antonio Spurs,37,8905,1453,3050,0.476,343,831,0.413,1110,2219,0.5,673,820,0.821,352,1246,1598,896,299,470,674,3922
2438,2017-1-10,Phoenix Suns,38,9245,1493,3357,0.445,309,901,0.343,1184,2456,0.482,730,954,0.765,456,1258,1714,701,332,587,953,4025
2439,2017-1-10,Indiana Pacers,38,9220,1494,3251,0.46,315,859,0.367,1179,2392,0.493,718,876,0.82,328,1291,1619,854,318,516,739,4021
2440,2017-1-10,New York Knicks,38,9195,1508,3399,0.444,353,964,0.366,1155,2435,0.474,639,816,0.783,460,1278,1738,826,276,518,797,4008
2441,2017-1-10,Washington Wizards,36,8715,1453,3085,0.471,294,826,0.356,1159,2259,0.513,596,765,0.779,361,1148,1509,825,308,501,777,3796
2442,2017-1-10,Brooklyn Nets,36,8690,1353,3071,0.441,397,1176,0.338,956,1895,0.504,690,882,0.782,326,1264,1590,750,267,610,758,3793
2443,2017-1-10,Los Angeles Lakers,41,9840,1592,3550,0.448,380,1073,0.354,1212,2477,0.489,755,980,0.77,480,1332,1812,848,328,601,842,4319
2444,2017-1-10,Charlotte Hornets,38,9195,1436,3253,0.441,355,1011,0.351,1081,2242,0.482,772,987,0.782,353,1376,1729,887,249,434,641,3999
2445,2017-1-10,Milwaukee Bucks,36,8690,1425,3006,0.474,313,857,0.365,1112,2149,0.517,616,812,0.759,329,1208,1537,886,290,477,715,3779
2446,2017-1-10,Minnesota Timberwolves,38,9170,1451,3188,0.455,309,878,0.352,1142,2310,0.494,704,901,0.781,454,1176,1630,856,287,540,788,3915
2447,2017-1-10,New Orleans Pelicans,39,9510,1486,3391,0.438,357,1011,0.353,1129,2380,0.474,665,878,0.757,334,1397,1731,892,295,468,716,3994
2448,2017-1-10,Atlanta Hawks,37,8930,1426,3138,0.454,324,952,0.34,1102,2186,0.504,609,844,0.722,382,1250,1632,885,321,563,656,3785
2449,2017-1-10,Sacramento Kings,37,8955,1381,3066,0.45,325,920,0.353,1056,2146,0.492,697,896,0.778,338,1164,1502,805,296,492,752,3784
2450,2017-1-10,Chicago Bulls,38,9145,1433,3299,0.434,245,775,0.316,1188,2524,0.471,748,924,0.81,520,1288,1808,800,289,490,671,3859
2451,2017-1-10,Detroit Pistons,39,9410,1529,3388,0.451,302,885,0.341,1227,2503,0.49,551,738,0.747,391,1329,1720,828,274,441,691,3911
2452,2017-1-10,Memphis Grizzlies,40,9800,1435,3376,0.425,360,1033,0.348,1075,2343,0.459,742,945,0.785,424,1311,1735,826,346,493,959,3972
2453,2017-1-10,Philadelphia 76ers,35,8500,1283,2958,0.434,366,1040,0.352,917,1918,0.478,541,715,0.757,328,1180,1508,788,275,566,768,3473
2454,2017-1-10,Orlando Magic,39,9410,1477,3374,0.438,346,1027,0.337,1131,2347,0.482,558,782,0.714,395,1286,1681,865,258,486,717,3858
2455,2017-1-10,Utah Jazz,39,9360,1393,3011,0.463,373,1014,0.368,1020,1997,0.511,676,891,0.759,333,1319,1652,740,247,515,748,3835
2456,2017-1-10,Miami Heat,39,9435,1466,3350,0.438,336,986,0.341,1130,2364,0.478,559,831,0.673,428,1305,1733,812,265,488,799,3827
2457,2017-1-10,Dallas Mavericks,38,9170,1341,3113,0.431,399,1146,0.348,942,1967,0.479,534,667,0.801,317,1129,1446,746,293,439,730,3615
2458,2017-1-11,Golden State Warriors,39,9435,1692,3402,0.497,455,1203,0.378,1237,2199,0.563,734,924,0.794,354,1410,1764,1208,361,577,763,4573
2459,2017-1-11,Houston Rockets,40,9675,1633,3470,0.471,598,1592,0.376,1035,1878,0.551,728,965,0.754,441,1349,1790,1032,324,595,787,4592
2460,2017-1-11,Toronto Raptors,38,9170,1515,3235,0.468,360,929,0.388,1155,2306,0.501,815,1003,0.813,420,1203,1623,729,348,435,798,4205
2461,2017-1-11,Cleveland Cavaliers,37,8905,1437,3154,0.456,472,1221,0.387,965,1933,0.499,715,937,0.763,383,1255,1638,801,274,494,659,4061
2462,2017-1-11,Portland Trail Blazers,40,9725,1584,3430,0.462,417,1146,0.364,1167,2284,0.511,744,955,0.779,374,1314,1688,892,280,532,887,4329
2463,2017-1-11,Denver Nuggets,37,8955,1461,3240,0.451,358,1001,0.358,1103,2239,0.493,716,950,0.754,457,1289,1746,856,243,559,771,3996
2464,2017-1-11,Los Angeles Clippers,40,9650,1557,3354,0.464,411,1091,0.377,1146,2263,0.506,791,1047,0.755,373,1378,1751,890,310,503,821,4316
2465,2017-1-11,Oklahoma City Thunder,39,9460,1553,3368,0.461,334,1014,0.329,1219,2354,0.518,729,995,0.733,430,1347,1777,846,293,556,799,4169
2466,2017-1-11,Boston Celtics,38,9145,1475,3267,0.451,445,1209,0.368,1030,2058,0.5,662,818,0.809,355,1203,1558,953,289,450,790,4057
2467,2017-1-11,San Antonio Spurs,38,9145,1495,3138,0.476,355,861,0.412,1140,2277,0.501,684,834,0.82,365,1274,1639,918,304,484,684,4029
2468,2017-1-11,Phoenix Suns,38,9245,1493,3357,0.445,309,901,0.343,1184,2456,0.482,730,954,0.765,456,1258,1714,701,332,587,953,4025
2469,2017-1-11,Indiana Pacers,38,9220,1494,3251,0.46,315,859,0.367,1179,2392,0.493,718,876,0.82,328,1291,1619,854,318,516,739,4021
2470,2017-1-11,Charlotte Hornets,39,9435,1480,3345,0.442,374,1054,0.355,1106,2291,0.483,779,996,0.782,358,1414,1772,917,252,445,662,4113
2471,2017-1-11,New York Knicks,38,9195,1508,3399,0.444,353,964,0.366,1155,2435,0.474,639,816,0.783,460,1278,1738,826,276,518,797,4008
2472,2017-1-11,Washington Wizards,37,8955,1495,3168,0.472,305,848,0.36,1190,2320,0.513,602,774,0.778,368,1183,1551,849,316,522,801,3897
2473,2017-1-11,Milwaukee Bucks,37,8930,1469,3090,0.475,323,876,0.369,1146,2214,0.518,627,825,0.76,340,1235,1575,918,298,489,733,3888
2474,2017-1-11,Brooklyn Nets,37,8930,1388,3158,0.44,407,1205,0.338,981,1953,0.502,707,905,0.781,340,1298,1638,772,272,627,782,3890
2475,2017-1-11,Los Angeles Lakers,42,10080,1624,3633,0.447,389,1097,0.355,1235,2536,0.487,769,1006,0.764,489,1361,1850,866,335,611,860,4406
2476,2017-1-11,Minnesota Timberwolves,38,9170,1451,3188,0.455,309,878,0.352,1142,2310,0.494,704,901,0.781,454,1176,1630,856,287,540,788,3915
2477,2017-1-11,Atlanta Hawks,38,9170,1470,3230,0.455,331,975,0.339,1139,2255,0.505,631,882,0.715,397,1288,1685,910,332,575,673,3902
2478,2017-1-11,New Orleans Pelicans,39,9510,1486,3391,0.438,357,1011,0.353,1129,2380,0.474,665,878,0.757,334,1397,1731,892,295,468,716,3994
2479,2017-1-11,Sacramento Kings,38,9195,1413,3139,0.45,338,943,0.358,1075,2196,0.49,720,925,0.778,350,1197,1547,826,302,508,769,3884
2480,2017-1-11,Chicago Bulls,39,9385,1468,3387,0.433,255,802,0.318,1213,2585,0.469,767,945,0.812,532,1320,1852,819,299,507,689,3958
2481,2017-1-11,Detroit Pistons,40,9650,1565,3470,0.451,314,912,0.344,1251,2558,0.489,561,754,0.744,399,1356,1755,842,286,453,715,4005
2482,2017-1-11,Memphis Grizzlies,40,9800,1435,3376,0.425,360,1033,0.348,1075,2343,0.459,742,945,0.785,424,1311,1735,826,346,493,959,3972
2483,2017-1-11,Philadelphia 76ers,35,8500,1283,2958,0.434,366,1040,0.352,917,1918,0.478,541,715,0.757,328,1180,1508,788,275,566,768,3473
2484,2017-1-11,Orlando Magic,39,9410,1477,3374,0.438,346,1027,0.337,1131,2347,0.482,558,782,0.714,395,1286,1681,865,258,486,717,3858
2485,2017-1-11,Utah Jazz,40,9600,1431,3090,0.463,386,1048,0.368,1045,2042,0.512,687,910,0.755,344,1354,1698,762,255,533,769,3935
2486,2017-1-11,Miami Heat,40,9675,1504,3440,0.437,342,1016,0.337,1162,2424,0.479,572,848,0.675,434,1345,1779,837,271,499,821,3922
2487,2017-1-11,Dallas Mavericks,38,9170,1341,3113,0.431,399,1146,0.348,942,1967,0.479,534,667,0.801,317,1129,1446,746,293,439,730,3615
2488,2017-1-12,Golden State Warriors,39,9435,1692,3402,0.497,455,1203,0.378,1237,2199,0.563,734,924,0.794,354,1410,1764,1208,361,577,763,4573
2489,2017-1-12,Houston Rockets,41,9915,1669,3557,0.469,613,1634,0.375,1056,1923,0.549,746,987,0.756,448,1374,1822,1055,331,610,810,4697
2490,2017-1-12,Toronto Raptors,38,9170,1515,3235,0.468,360,929,0.388,1155,2306,0.501,815,1003,0.813,420,1203,1623,729,348,435,798,4205
2491,2017-1-12,Cleveland Cavaliers,38,9145,1465,3236,0.453,481,1251,0.384,984,1985,0.496,736,965,0.763,396,1290,1686,815,279,509,679,4147
2492,2017-1-12,Portland Trail Blazers,41,9965,1624,3523,0.461,427,1176,0.363,1197,2347,0.51,756,971,0.779,387,1352,1739,921,286,541,904,4431
2493,2017-1-12,Denver Nuggets,37,8955,1461,3240,0.451,358,1001,0.358,1103,2239,0.493,716,950,0.754,457,1289,1746,856,243,559,771,3996
2494,2017-1-12,Los Angeles Clippers,41,9890,1596,3430,0.465,420,1117,0.376,1176,2313,0.508,809,1073,0.754,382,1418,1800,913,321,524,841,4421
2495,2017-1-12,Boston Celtics,39,9385,1518,3352,0.453,462,1250,0.37,1056,2102,0.502,676,836,0.809,365,1238,1603,973,294,464,800,4174
2496,2017-1-12,Oklahoma City Thunder,40,9700,1589,3449,0.461,342,1040,0.329,1247,2409,0.518,752,1024,0.734,441,1389,1830,867,298,572,817,4272
2497,2017-1-12,San Antonio Spurs,38,9145,1495,3138,0.476,355,861,0.412,1140,2277,0.501,684,834,0.82,365,1274,1639,918,304,484,684,4029
2498,2017-1-12,Phoenix Suns,38,9245,1493,3357,0.445,309,901,0.343,1184,2456,0.482,730,954,0.765,456,1258,1714,701,332,587,953,4025
2499,2017-1-12,Indiana Pacers,38,9220,1494,3251,0.46,315,859,0.367,1179,2392,0.493,718,876,0.82,328,1291,1619,854,318,516,739,4021
2500,2017-1-12,Charlotte Hornets,39,9435,1480,3345,0.442,374,1054,0.355,1106,2291,0.483,779,996,0.782,358,1414,1772,917,252,445,662,4113
2501,2017-1-12,Washington Wizards,38,9195,1540,3273,0.471,315,874,0.36,1225,2399,0.511,610,786,0.776,384,1211,1595,877,326,529,814,4005
2502,2017-1-12,New York Knicks,39,9435,1550,3485,0.445,357,986,0.362,1193,2499,0.477,648,826,0.785,468,1310,1778,846,283,531,819,4105
2503,2017-1-12,Milwaukee Bucks,37,8930,1469,3090,0.475,323,876,0.369,1146,2214,0.518,627,825,0.76,340,1235,1575,918,298,489,733,3888
2504,2017-1-12,Brooklyn Nets,37,8930,1388,3158,0.44,407,1205,0.338,981,1953,0.502,707,905,0.781,340,1298,1638,772,272,627,782,3890
2505,2017-1-12,Los Angeles Lakers,42,10080,1624,3633,0.447,389,1097,0.355,1235,2536,0.487,769,1006,0.764,489,1361,1850,866,335,611,860,4406
2506,2017-1-12,Minnesota Timberwolves,39,9410,1495,3269,0.457,317,901,0.352,1178,2368,0.497,727,926,0.785,463,1216,1679,887,295,557,807,4034
2507,2017-1-12,Atlanta Hawks,38,9170,1470,3230,0.455,331,975,0.339,1139,2255,0.505,631,882,0.715,397,1288,1685,910,332,575,673,3902
2508,2017-1-12,New Orleans Pelicans,39,9510,1486,3391,0.438,357,1011,0.353,1129,2380,0.474,665,878,0.757,334,1397,1731,892,295,468,716,3994
2509,2017-1-12,Sacramento Kings,38,9195,1413,3139,0.45,338,943,0.358,1075,2196,0.49,720,925,0.778,350,1197,1547,826,302,508,769,3884
2510,2017-1-12,Chicago Bulls,39,9385,1468,3387,0.433,255,802,0.318,1213,2585,0.469,767,945,0.812,532,1320,1852,819,299,507,689,3958
2511,2017-1-12,Detroit Pistons,40,9650,1565,3470,0.451,314,912,0.344,1251,2558,0.489,561,754,0.744,399,1356,1755,842,286,453,715,4005
2512,2017-1-12,Memphis Grizzlies,41,10040,1473,3468,0.425,367,1057,0.347,1106,2411,0.459,754,966,0.781,437,1337,1774,844,357,503,985,4067
2513,2017-1-12,Philadelphia 76ers,36,8740,1320,3053,0.432,373,1068,0.349,947,1985,0.477,558,736,0.758,346,1209,1555,815,282,580,780,3571
2514,2017-1-12,Orlando Magic,40,9650,1516,3466,0.437,352,1054,0.334,1164,2412,0.483,570,800,0.713,401,1315,1716,886,266,499,738,3954
2515,2017-1-12,Utah Jazz,40,9600,1431,3090,0.463,386,1048,0.368,1045,2042,0.512,687,910,0.755,344,1354,1698,762,255,533,769,3935
2516,2017-1-12,Miami Heat,40,9675,1504,3440,0.437,342,1016,0.337,1162,2424,0.479,572,848,0.675,434,1345,1779,837,271,499,821,3922
2517,2017-1-12,Dallas Mavericks,38,9170,1341,3113,0.431,399,1146,0.348,942,1967,0.479,534,667,0.801,317,1129,1446,746,293,439,730,3615
2518,2017-1-13,Golden State Warriors,40,9675,1742,3491,0.499,470,1232,0.381,1272,2259,0.563,746,942,0.792,360,1441,1801,1247,375,595,777,4700
2519,2017-1-13,Houston Rockets,41,9915,1669,3557,0.469,613,1634,0.375,1056,1923,0.549,746,987,0.756,448,1374,1822,1055,331,610,810,4697
2520,2017-1-13,Toronto Raptors,38,9170,1515,3235,0.468,360,929,0.388,1155,2306,0.501,815,1003,0.813,420,1203,1623,729,348,435,798,4205
2521,2017-1-13,Cleveland Cavaliers,38,9145,1465,3236,0.453,481,1251,0.384,984,1985,0.496,736,965,0.763,396,1290,1686,815,279,509,679,4147
2522,2017-1-13,Denver Nuggets,38,9195,1513,3330,0.454,373,1033,0.361,1140,2297,0.496,737,973,0.757,469,1324,1793,893,253,574,787,4136
2523,2017-1-13,Portland Trail Blazers,41,9965,1624,3523,0.461,427,1176,0.363,1197,2347,0.51,756,971,0.779,387,1352,1739,921,286,541,904,4431
2524,2017-1-13,Los Angeles Clippers,41,9890,1596,3430,0.465,420,1117,0.376,1176,2313,0.508,809,1073,0.754,382,1418,1800,913,321,524,841,4421
2525,2017-1-13,Boston Celtics,39,9385,1518,3352,0.453,462,1250,0.37,1056,2102,0.502,676,836,0.809,365,1238,1603,973,294,464,800,4174
2526,2017-1-13,Oklahoma City Thunder,40,9700,1589,3449,0.461,342,1040,0.329,1247,2409,0.518,752,1024,0.734,441,1389,1830,867,298,572,817,4272
2527,2017-1-13,San Antonio Spurs,39,9385,1544,3219,0.48,365,882,0.414,1179,2337,0.504,710,863,0.823,372,1313,1685,950,309,496,704,4163
2528,2017-1-13,Phoenix Suns,39,9485,1531,3435,0.446,319,919,0.347,1212,2516,0.482,752,981,0.767,469,1292,1761,716,334,606,976,4133
2529,2017-1-13,Indiana Pacers,39,9460,1538,3345,0.46,327,888,0.368,1211,2457,0.493,730,889,0.821,340,1313,1653,880,327,532,754,4133
2530,2017-1-13,Charlotte Hornets,39,9435,1480,3345,0.442,374,1054,0.355,1106,2291,0.483,779,996,0.782,358,1414,1772,917,252,445,662,4113
2531,2017-1-13,Washington Wizards,38,9195,1540,3273,0.471,315,874,0.36,1225,2399,0.511,610,786,0.776,384,1211,1595,877,326,529,814,4005
2532,2017-1-13,New York Knicks,40,9675,1594,3577,0.446,364,1009,0.361,1230,2568,0.479,657,837,0.785,485,1341,1826,867,286,543,836,4209
2533,2017-1-13,Milwaukee Bucks,37,8930,1469,3090,0.475,323,876,0.369,1146,2214,0.518,627,825,0.76,340,1235,1575,918,298,489,733,3888
2534,2017-1-13,Brooklyn Nets,38,9170,1428,3255,0.439,416,1247,0.334,1012,2008,0.504,713,916,0.778,347,1341,1688,794,282,643,802,3985
2535,2017-1-13,Los Angeles Lakers,43,10320,1659,3718,0.446,395,1117,0.354,1264,2601,0.486,787,1031,0.763,498,1381,1879,889,341,620,885,4500
2536,2017-1-13,Minnesota Timberwolves,39,9410,1495,3269,0.457,317,901,0.352,1178,2368,0.497,727,926,0.785,463,1216,1679,887,295,557,807,4034
2537,2017-1-13,Atlanta Hawks,38,9170,1470,3230,0.455,331,975,0.339,1139,2255,0.505,631,882,0.715,397,1288,1685,910,332,575,673,3902
2538,2017-1-13,New Orleans Pelicans,40,9750,1524,3481,0.438,368,1043,0.353,1156,2438,0.474,682,903,0.755,343,1438,1781,908,307,484,732,4098
2539,2017-1-13,Sacramento Kings,38,9195,1413,3139,0.45,338,943,0.358,1075,2196,0.49,720,925,0.778,350,1197,1547,826,302,508,769,3884
2540,2017-1-13,Chicago Bulls,40,9625,1503,3476,0.432,258,820,0.315,1245,2656,0.469,783,966,0.811,546,1349,1895,839,304,519,701,4047
2541,2017-1-13,Detroit Pistons,41,9890,1608,3558,0.452,320,940,0.34,1288,2618,0.492,576,774,0.744,408,1387,1795,862,296,472,734,4112
2542,2017-1-13,Memphis Grizzlies,41,10040,1473,3468,0.425,367,1057,0.347,1106,2411,0.459,754,966,0.781,437,1337,1774,844,357,503,985,4067
2543,2017-1-13,Philadelphia 76ers,36,8740,1320,3053,0.432,373,1068,0.349,947,1985,0.477,558,736,0.758,346,1209,1555,815,282,580,780,3571
2544,2017-1-13,Orlando Magic,40,9650,1516,3466,0.437,352,1054,0.334,1164,2412,0.483,570,800,0.713,401,1315,1716,886,266,499,738,3954
2545,2017-1-13,Utah Jazz,40,9600,1431,3090,0.463,386,1048,0.368,1045,2042,0.512,687,910,0.755,344,1354,1698,762,255,533,769,3935
2546,2017-1-13,Miami Heat,40,9675,1504,3440,0.437,342,1016,0.337,1162,2424,0.479,572,848,0.675,434,1345,1779,837,271,499,821,3922
2547,2017-1-13,Dallas Mavericks,39,9410,1384,3202,0.432,414,1180,0.351,970,2022,0.48,546,684,0.798,325,1153,1478,775,304,448,750,3728
2548,2017-1-14,Golden State Warriors,40,9675,1742,3491,0.499,470,1232,0.381,1272,2259,0.563,746,942,0.792,360,1441,1801,1247,375,595,777,4700
2549,2017-1-14,Houston Rockets,42,10155,1702,3639,0.468,623,1675,0.372,1079,1964,0.549,775,1023,0.758,458,1395,1853,1074,340,622,830,4802
2550,2017-1-14,Toronto Raptors,39,9410,1567,3332,0.47,371,957,0.388,1196,2375,0.504,832,1024,0.813,433,1239,1672,750,355,443,815,4337
2551,2017-1-14,Cleveland Cavaliers,39,9385,1509,3323,0.454,496,1288,0.385,1013,2035,0.498,753,987,0.763,406,1319,1725,842,290,521,699,4267
2552,2017-1-14,Denver Nuggets,38,9195,1513,3330,0.454,373,1033,0.361,1140,2297,0.496,737,973,0.757,469,1324,1793,893,253,574,787,4136
2553,2017-1-14,Portland Trail Blazers,42,10205,1663,3620,0.459,437,1210,0.361,1226,2410,0.509,777,996,0.78,399,1383,1782,940,292,550,924,4540
2554,2017-1-14,Los Angeles Clippers,41,9890,1596,3430,0.465,420,1117,0.376,1176,2313,0.508,809,1073,0.754,382,1418,1800,913,321,524,841,4421
2555,2017-1-14,Boston Celtics,40,9625,1554,3435,0.452,479,1294,0.37,1075,2141,0.502,690,855,0.807,374,1272,1646,995,301,476,816,4277
2556,2017-1-14,San Antonio Spurs,39,9385,1544,3219,0.48,365,882,0.414,1179,2337,0.504,710,863,0.823,372,1313,1685,950,309,496,704,4163
2557,2017-1-14,Oklahoma City Thunder,41,9940,1622,3534,0.459,345,1060,0.325,1277,2474,0.516,769,1045,0.736,457,1420,1877,886,308,590,838,4358
2558,2017-1-14,Phoenix Suns,39,9485,1531,3435,0.446,319,919,0.347,1212,2516,0.482,752,981,0.767,469,1292,1761,716,334,606,976,4133
2559,2017-1-14,Indiana Pacers,39,9460,1538,3345,0.46,327,888,0.368,1211,2457,0.493,730,889,0.821,340,1313,1653,880,327,532,754,4133
2560,2017-1-14,Milwaukee Bucks,38,9170,1509,3170,0.476,332,891,0.373,1177,2279,0.516,654,856,0.764,353,1268,1621,946,306,500,751,4004
2561,2017-1-14,Washington Wizards,38,9195,1540,3273,0.471,315,874,0.36,1225,2399,0.511,610,786,0.776,384,1211,1595,877,326,529,814,4005
2562,2017-1-14,Charlotte Hornets,40,9675,1508,3430,0.44,380,1077,0.353,1128,2353,0.479,810,1028,0.788,374,1439,1813,928,264,464,681,4206
2563,2017-1-14,New York Knicks,40,9675,1594,3577,0.446,364,1009,0.361,1230,2568,0.479,657,837,0.785,485,1341,1826,867,286,543,836,4209
2564,2017-1-14,Brooklyn Nets,39,9410,1468,3341,0.439,433,1283,0.337,1035,2058,0.503,729,936,0.779,351,1372,1723,820,287,654,818,4098
2565,2017-1-14,Los Angeles Lakers,43,10320,1659,3718,0.446,395,1117,0.354,1264,2601,0.486,787,1031,0.763,498,1381,1879,889,341,620,885,4500
2566,2017-1-14,Minnesota Timberwolves,40,9650,1534,3355,0.457,322,919,0.35,1212,2436,0.498,740,940,0.787,472,1249,1721,908,306,572,829,4130
2567,2017-1-14,Atlanta Hawks,39,9410,1506,3314,0.454,342,1005,0.34,1164,2309,0.504,649,903,0.719,409,1319,1728,932,337,587,690,4003
2568,2017-1-14,New Orleans Pelicans,40,9750,1524,3481,0.438,368,1043,0.353,1156,2438,0.474,682,903,0.755,343,1438,1781,908,307,484,732,4098
2569,2017-1-14,Sacramento Kings,39,9435,1455,3219,0.452,347,968,0.358,1108,2251,0.492,735,944,0.779,361,1228,1589,849,309,529,791,3992
2570,2017-1-14,Chicago Bulls,40,9625,1503,3476,0.432,258,820,0.315,1245,2656,0.469,783,966,0.811,546,1349,1895,839,304,519,701,4047
2571,2017-1-14,Detroit Pistons,42,10130,1638,3634,0.451,326,957,0.341,1312,2677,0.49,587,790,0.743,411,1419,1830,877,301,485,750,4189
2572,2017-1-14,Memphis Grizzlies,42,10280,1514,3544,0.427,377,1084,0.348,1137,2460,0.462,772,993,0.777,445,1374,1819,869,365,525,1014,4177
2573,2017-1-14,Philadelphia 76ers,37,8980,1356,3129,0.433,387,1106,0.35,969,2023,0.479,574,756,0.759,356,1237,1593,841,294,600,807,3673
2574,2017-1-14,Orlando Magic,41,9890,1557,3549,0.439,362,1072,0.338,1195,2477,0.482,593,826,0.718,410,1351,1761,907,271,514,757,4069
2575,2017-1-14,Utah Jazz,41,9840,1474,3170,0.465,402,1079,0.373,1072,2091,0.513,695,923,0.753,351,1394,1745,784,265,545,783,4045
2576,2017-1-14,Miami Heat,41,9915,1545,3523,0.439,354,1048,0.338,1191,2475,0.481,586,866,0.677,438,1368,1806,870,277,507,842,4030
2577,2017-1-14,Dallas Mavericks,39,9410,1384,3202,0.432,414,1180,0.351,970,2022,0.48,546,684,0.798,325,1153,1478,775,304,448,750,3728
2578,2017-1-15,Golden State Warriors,40,9675,1742,3491,0.499,470,1232,0.381,1272,2259,0.563,746,942,0.792,360,1441,1801,1247,375,595,777,4700
2579,2017-1-15,Houston Rockets,42,10155,1702,3639,0.468,623,1675,0.372,1079,1964,0.549,775,1023,0.758,458,1395,1853,1074,340,622,830,4802
2580,2017-1-15,Toronto Raptors,39,9410,1567,3332,0.47,371,957,0.388,1196,2375,0.504,832,1024,0.813,433,1239,1672,750,355,443,815,4337
2581,2017-1-15,Cleveland Cavaliers,39,9385,1509,3323,0.454,496,1288,0.385,1013,2035,0.498,753,987,0.763,406,1319,1725,842,290,521,699,4267
2582,2017-1-15,Denver Nuggets,38,9195,1513,3330,0.454,373,1033,0.361,1140,2297,0.496,737,973,0.757,469,1324,1793,893,253,574,787,4136
2583,2017-1-15,Portland Trail Blazers,42,10205,1663,3620,0.459,437,1210,0.361,1226,2410,0.509,777,996,0.78,399,1383,1782,940,292,550,924,4540
2584,2017-1-15,Los Angeles Clippers,42,10130,1644,3522,0.467,430,1145,0.376,1214,2377,0.511,816,1081,0.755,389,1453,1842,941,327,531,865,4534
2585,2017-1-15,Boston Celtics,40,9625,1554,3435,0.452,479,1294,0.37,1075,2141,0.502,690,855,0.807,374,1272,1646,995,301,476,816,4277
2586,2017-1-15,San Antonio Spurs,40,9625,1580,3290,0.48,374,902,0.415,1206,2388,0.505,734,897,0.818,378,1340,1718,965,317,512,722,4268
2587,2017-1-15,Oklahoma City Thunder,41,9940,1622,3534,0.459,345,1060,0.325,1277,2474,0.516,769,1045,0.736,457,1420,1877,886,308,590,838,4358
2588,2017-1-15,Phoenix Suns,40,9725,1570,3520,0.446,327,940,0.348,1243,2580,0.482,774,1005,0.77,484,1322,1806,734,344,621,1006,4241
2589,2017-1-15,Indiana Pacers,39,9460,1538,3345,0.46,327,888,0.368,1211,2457,0.493,730,889,0.821,340,1313,1653,880,327,532,754,4133
2590,2017-1-15,Washington Wizards,39,9435,1584,3364,0.471,323,891,0.363,1261,2473,0.51,623,804,0.775,396,1249,1645,895,335,540,832,4114
2591,2017-1-15,Milwaukee Bucks,38,9170,1509,3170,0.476,332,891,0.373,1177,2279,0.516,654,856,0.764,353,1268,1621,946,306,500,751,4004
2592,2017-1-15,Charlotte Hornets,40,9675,1508,3430,0.44,380,1077,0.353,1128,2353,0.479,810,1028,0.788,374,1439,1813,928,264,464,681,4206
2593,2017-1-15,New York Knicks,40,9675,1594,3577,0.446,364,1009,0.361,1230,2568,0.479,657,837,0.785,485,1341,1826,867,286,543,836,4209
2594,2017-1-15,Brooklyn Nets,39,9410,1468,3341,0.439,433,1283,0.337,1035,2058,0.503,729,936,0.779,351,1372,1723,820,287,654,818,4098
2595,2017-1-15,Los Angeles Lakers,44,10560,1695,3798,0.446,405,1138,0.356,1290,2660,0.485,802,1058,0.758,504,1415,1919,910,344,634,905,4597
2596,2017-1-15,Minnesota Timberwolves,40,9650,1534,3355,0.457,322,919,0.35,1212,2436,0.498,740,940,0.787,472,1249,1721,908,306,572,829,4130
2597,2017-1-15,Atlanta Hawks,39,9410,1506,3314,0.454,342,1005,0.34,1164,2309,0.504,649,903,0.719,409,1319,1728,932,337,587,690,4003
2598,2017-1-15,New Orleans Pelicans,41,9990,1563,3565,0.438,375,1066,0.352,1188,2499,0.475,696,924,0.753,349,1474,1823,935,310,495,751,4197
2599,2017-1-15,Sacramento Kings,39,9435,1455,3219,0.452,347,968,0.358,1108,2251,0.492,735,944,0.779,361,1228,1589,849,309,529,791,3992
2600,2017-1-15,Chicago Bulls,41,9865,1546,3577,0.432,266,840,0.317,1280,2737,0.468,796,989,0.805,567,1391,1958,861,314,529,721,4154
2601,2017-1-15,Detroit Pistons,42,10130,1638,3634,0.451,326,957,0.341,1312,2677,0.49,587,790,0.743,411,1419,1830,877,301,485,750,4189
2602,2017-1-15,Memphis Grizzlies,42,10280,1514,3544,0.427,377,1084,0.348,1137,2460,0.462,772,993,0.777,445,1374,1819,869,365,525,1014,4177
2603,2017-1-15,Orlando Magic,42,10130,1595,3631,0.439,374,1106,0.338,1221,2525,0.484,612,853,0.717,417,1384,1801,930,281,528,785,4176
2604,2017-1-15,Philadelphia 76ers,38,9220,1392,3216,0.433,397,1137,0.349,995,2079,0.479,585,777,0.753,371,1271,1642,861,300,616,826,3766
2605,2017-1-15,Utah Jazz,42,10080,1515,3253,0.466,409,1105,0.37,1106,2148,0.515,720,959,0.751,360,1429,1789,812,271,558,803,4159
2606,2017-1-15,Miami Heat,41,9915,1545,3523,0.439,354,1048,0.338,1191,2475,0.481,586,866,0.677,438,1368,1806,870,277,507,842,4030
2607,2017-1-15,Dallas Mavericks,39,9410,1384,3202,0.432,414,1180,0.351,970,2022,0.48,546,684,0.798,325,1153,1478,775,304,448,750,3728
2608,2017-1-16,Golden State Warriors,40,9675,1742,3491,0.499,470,1232,0.381,1272,2259,0.563,746,942,0.792,360,1441,1801,1247,375,595,777,4700
2609,2017-1-16,Houston Rockets,43,10395,1748,3731,0.469,644,1719,0.375,1104,2012,0.549,799,1055,0.757,471,1434,1905,1104,349,635,851,4939
2610,2017-1-16,Toronto Raptors,40,9650,1611,3421,0.471,379,979,0.387,1232,2442,0.505,852,1047,0.814,443,1271,1714,771,364,453,835,4453
2611,2017-1-16,Cleveland Cavaliers,39,9385,1509,3323,0.454,496,1288,0.385,1013,2035,0.498,753,987,0.763,406,1319,1725,842,290,521,699,4267
2612,2017-1-16,Denver Nuggets,38,9195,1513,3330,0.454,373,1033,0.361,1140,2297,0.496,737,973,0.757,469,1324,1793,893,253,574,787,4136
2613,2017-1-16,Portland Trail Blazers,42,10205,1663,3620,0.459,437,1210,0.361,1226,2410,0.509,777,996,0.78,399,1383,1782,940,292,550,924,4540
2614,2017-1-16,Los Angeles Clippers,42,10130,1644,3522,0.467,430,1145,0.376,1214,2377,0.511,816,1081,0.755,389,1453,1842,941,327,531,865,4534
2615,2017-1-16,Boston Celtics,40,9625,1554,3435,0.452,479,1294,0.37,1075,2141,0.502,690,855,0.807,374,1272,1646,995,301,476,816,4277
2616,2017-1-16,San Antonio Spurs,40,9625,1580,3290,0.48,374,902,0.415,1206,2388,0.505,734,897,0.818,378,1340,1718,965,317,512,722,4268
2617,2017-1-16,Oklahoma City Thunder,42,10180,1662,3624,0.459,354,1088,0.325,1308,2536,0.516,802,1086,0.738,474,1447,1921,906,322,609,866,4480
2618,2017-1-16,Phoenix Suns,40,9725,1570,3520,0.446,327,940,0.348,1243,2580,0.482,774,1005,0.77,484,1322,1806,734,344,621,1006,4241
2619,2017-1-16,Indiana Pacers,39,9460,1538,3345,0.46,327,888,0.368,1211,2457,0.493,730,889,0.821,340,1313,1653,880,327,532,754,4133
2620,2017-1-16,Washington Wizards,39,9435,1584,3364,0.471,323,891,0.363,1261,2473,0.51,623,804,0.775,396,1249,1645,895,335,540,832,4114
2621,2017-1-16,Brooklyn Nets,40,9650,1509,3434,0.439,448,1327,0.338,1061,2107,0.504,744,955,0.779,360,1401,1761,849,296,670,843,4210
2622,2017-1-16,Milwaukee Bucks,39,9410,1548,3249,0.476,338,910,0.371,1210,2339,0.517,668,874,0.764,366,1291,1657,971,317,516,776,4102
2623,2017-1-16,Charlotte Hornets,40,9675,1508,3430,0.44,380,1077,0.353,1128,2353,0.479,810,1028,0.788,374,1439,1813,928,264,464,681,4206
2624,2017-1-16,New York Knicks,41,9915,1629,3661,0.445,376,1038,0.362,1253,2623,0.478,676,864,0.782,496,1371,1867,888,293,557,852,4310
2625,2017-1-16,Los Angeles Lakers,45,10800,1731,3881,0.446,411,1164,0.353,1320,2717,0.486,821,1082,0.759,513,1456,1969,929,346,648,923,4694
2626,2017-1-16,Atlanta Hawks,40,9650,1548,3394,0.456,355,1031,0.344,1193,2363,0.505,663,921,0.72,423,1342,1765,961,346,606,710,4114
2627,2017-1-16,Minnesota Timberwolves,41,9890,1569,3435,0.457,327,940,0.348,1242,2495,0.498,752,958,0.785,482,1283,1765,928,313,584,845,4217
2628,2017-1-16,Sacramento Kings,40,9675,1492,3300,0.452,356,993,0.359,1136,2307,0.492,770,984,0.783,375,1258,1633,873,322,551,820,4110
2629,2017-1-16,New Orleans Pelicans,41,9990,1563,3565,0.438,375,1066,0.352,1188,2499,0.475,696,924,0.753,349,1474,1823,935,310,495,751,4197
2630,2017-1-16,Chicago Bulls,42,10105,1586,3655,0.434,270,857,0.315,1316,2798,0.47,820,1024,0.801,573,1432,2005,879,322,541,735,4262
2631,2017-1-16,Detroit Pistons,43,10370,1679,3729,0.45,335,982,0.341,1344,2747,0.489,598,806,0.742,421,1455,1876,901,307,492,772,4291
2632,2017-1-16,Memphis Grizzlies,43,10520,1554,3639,0.427,388,1116,0.348,1166,2523,0.462,785,1006,0.78,458,1411,1869,893,371,535,1036,4281
2633,2017-1-16,Orlando Magic,42,10130,1595,3631,0.439,374,1106,0.338,1221,2525,0.484,612,853,0.717,417,1384,1801,930,281,528,785,4176
2634,2017-1-16,Philadelphia 76ers,38,9220,1392,3216,0.433,397,1137,0.349,995,2079,0.479,585,777,0.753,371,1271,1642,861,300,616,826,3766
2635,2017-1-16,Utah Jazz,42,10080,1515,3253,0.466,409,1105,0.37,1106,2148,0.515,720,959,0.751,360,1429,1789,812,271,558,803,4159
2636,2017-1-16,Miami Heat,41,9915,1545,3523,0.439,354,1048,0.338,1191,2475,0.481,586,866,0.677,438,1368,1806,870,277,507,842,4030
2637,2017-1-16,Dallas Mavericks,40,9650,1420,3279,0.433,426,1209,0.352,994,2070,0.48,560,703,0.797,331,1188,1519,796,312,459,768,3826
2638,2017-1-17,Golden State Warriors,41,9915,1788,3582,0.499,485,1266,0.383,1303,2316,0.563,765,966,0.792,371,1488,1859,1284,385,611,799,4826
2639,2017-1-17,Houston Rockets,43,10395,1748,3731,0.469,644,1719,0.375,1104,2012,0.549,799,1055,0.757,471,1434,1905,1104,349,635,851,4939
2640,2017-1-17,Toronto Raptors,40,9650,1611,3421,0.471,379,979,0.387,1232,2442,0.505,852,1047,0.814,443,1271,1714,771,364,453,835,4453
2641,2017-1-17,Denver Nuggets,39,9435,1565,3419,0.458,382,1060,0.36,1183,2359,0.501,749,988,0.758,478,1354,1832,926,264,588,804,4261
2642,2017-1-17,Cleveland Cavaliers,40,9625,1540,3411,0.451,505,1322,0.382,1035,2089,0.495,773,1014,0.762,413,1347,1760,853,297,536,720,4358
2643,2017-1-17,Los Angeles Clippers,43,10370,1689,3604,0.469,442,1173,0.377,1247,2431,0.513,834,1103,0.756,399,1490,1889,968,336,546,880,4654
2644,2017-1-17,Portland Trail Blazers,43,10445,1700,3708,0.458,445,1236,0.36,1255,2472,0.508,796,1021,0.78,413,1414,1827,962,298,565,944,4641
2645,2017-1-17,Boston Celtics,41,9865,1596,3519,0.454,494,1333,0.371,1102,2186,0.504,699,865,0.808,382,1308,1690,1024,307,488,827,4385
2646,2017-1-17,San Antonio Spurs,40,9625,1580,3290,0.48,374,902,0.415,1206,2388,0.505,734,897,0.818,378,1340,1718,965,317,512,722,4268
2647,2017-1-17,Oklahoma City Thunder,43,10420,1698,3709,0.458,364,1118,0.326,1334,2591,0.515,818,1105,0.74,483,1474,1957,924,332,624,881,4578
2648,2017-1-17,Washington Wizards,40,9675,1626,3450,0.471,336,914,0.368,1290,2536,0.509,646,829,0.779,408,1288,1696,921,345,552,850,4234
2649,2017-1-17,Phoenix Suns,41,9965,1610,3601,0.447,332,962,0.345,1278,2639,0.484,790,1022,0.773,490,1355,1845,747,348,630,1027,4342
2650,2017-1-17,Indiana Pacers,40,9700,1579,3426,0.461,332,907,0.366,1247,2519,0.495,741,905,0.819,345,1353,1698,906,338,548,772,4231
2651,2017-1-17,Brooklyn Nets,40,9650,1509,3434,0.439,448,1327,0.338,1061,2107,0.504,744,955,0.779,360,1401,1761,849,296,670,843,4210
2652,2017-1-17,Milwaukee Bucks,40,9650,1590,3338,0.476,343,924,0.371,1247,2414,0.517,683,896,0.762,376,1319,1695,994,325,528,799,4206
2653,2017-1-17,New York Knicks,42,10155,1671,3746,0.446,384,1064,0.361,1287,2682,0.48,691,887,0.779,511,1409,1920,909,301,575,874,4417
2654,2017-1-17,Charlotte Hornets,41,9915,1546,3516,0.44,388,1102,0.352,1158,2414,0.48,824,1045,0.789,384,1471,1855,953,268,475,696,4304
2655,2017-1-17,Los Angeles Lakers,45,10800,1731,3881,0.446,411,1164,0.353,1320,2717,0.486,821,1082,0.759,513,1456,1969,929,346,648,923,4694
2656,2017-1-17,Atlanta Hawks,41,9890,1588,3481,0.456,367,1063,0.345,1221,2418,0.505,679,944,0.719,431,1370,1801,987,357,616,725,4222
2657,2017-1-17,Minnesota Timberwolves,41,9890,1569,3435,0.457,327,940,0.348,1242,2495,0.498,752,958,0.785,482,1283,1765,928,313,584,845,4217
2658,2017-1-17,Sacramento Kings,40,9675,1492,3300,0.452,356,993,0.359,1136,2307,0.492,770,984,0.783,375,1258,1633,873,322,551,820,4110
2659,2017-1-17,New Orleans Pelicans,42,10230,1599,3648,0.438,385,1091,0.353,1214,2557,0.475,709,942,0.753,357,1504,1861,953,317,509,768,4292
2660,2017-1-17,Chicago Bulls,42,10105,1586,3655,0.434,270,857,0.315,1316,2798,0.47,820,1024,0.801,573,1432,2005,879,322,541,735,4262
2661,2017-1-17,Detroit Pistons,43,10370,1679,3729,0.45,335,982,0.341,1344,2747,0.489,598,806,0.742,421,1455,1876,901,307,492,772,4291
2662,2017-1-17,Orlando Magic,43,10370,1640,3719,0.441,382,1131,0.338,1258,2588,0.486,626,871,0.719,424,1411,1835,958,287,542,795,4288
2663,2017-1-17,Memphis Grizzlies,43,10520,1554,3639,0.427,388,1116,0.348,1166,2523,0.462,785,1006,0.78,458,1411,1869,893,371,535,1036,4281
2664,2017-1-17,Philadelphia 76ers,39,9460,1427,3294,0.433,411,1174,0.35,1016,2120,0.479,614,813,0.755,384,1309,1693,886,308,634,849,3879
2665,2017-1-17,Utah Jazz,43,10320,1556,3342,0.466,417,1128,0.37,1139,2214,0.514,736,983,0.749,374,1461,1835,834,275,566,819,4265
2666,2017-1-17,Miami Heat,41,9915,1545,3523,0.439,354,1048,0.338,1191,2475,0.481,586,866,0.677,438,1368,1806,870,277,507,842,4030
2667,2017-1-17,Dallas Mavericks,40,9650,1420,3279,0.433,426,1209,0.352,994,2070,0.48,560,703,0.797,331,1188,1519,796,312,459,768,3826
2668,2017-1-18,Golden State Warriors,41,9915,1788,3582,0.499,485,1266,0.383,1303,2316,0.563,765,966,0.792,371,1488,1859,1284,385,611,799,4826
2669,2017-1-18,Houston Rockets,44,10635,1784,3821,0.467,653,1758,0.371,1131,2063,0.548,821,1083,0.758,482,1472,1954,1125,357,652,867,5042
2670,2017-1-18,Toronto Raptors,41,9890,1659,3513,0.472,389,998,0.39,1270,2515,0.505,865,1063,0.814,453,1305,1758,789,372,462,854,4572
2671,2017-1-18,Denver Nuggets,40,9675,1615,3507,0.461,393,1086,0.362,1222,2421,0.505,765,1014,0.754,491,1386,1877,955,269,605,821,4388
2672,2017-1-18,Cleveland Cavaliers,40,9625,1540,3411,0.451,505,1322,0.382,1035,2089,0.495,773,1014,0.762,413,1347,1760,853,297,536,720,4358
2673,2017-1-18,Los Angeles Clippers,43,10370,1689,3604,0.469,442,1173,0.377,1247,2431,0.513,834,1103,0.756,399,1490,1889,968,336,546,880,4654
2674,2017-1-18,Portland Trail Blazers,43,10445,1700,3708,0.458,445,1236,0.36,1255,2472,0.508,796,1021,0.78,413,1414,1827,962,298,565,944,4641
2675,2017-1-18,San Antonio Spurs,41,9865,1623,3374,0.481,382,920,0.415,1241,2454,0.506,762,932,0.818,384,1368,1752,992,326,519,751,4390
2676,2017-1-18,Boston Celtics,41,9865,1596,3519,0.454,494,1333,0.371,1102,2186,0.504,699,865,0.808,382,1308,1690,1024,307,488,827,4385
2677,2017-1-18,Oklahoma City Thunder,43,10420,1698,3709,0.458,364,1118,0.326,1334,2591,0.515,818,1105,0.74,483,1474,1957,924,332,624,881,4578
2678,2017-1-18,Washington Wizards,40,9675,1626,3450,0.471,336,914,0.368,1290,2536,0.509,646,829,0.779,408,1288,1696,921,345,552,850,4234
2679,2017-1-18,Phoenix Suns,41,9965,1610,3601,0.447,332,962,0.345,1278,2639,0.484,790,1022,0.773,490,1355,1845,747,348,630,1027,4342
2680,2017-1-18,Indiana Pacers,40,9700,1579,3426,0.461,332,907,0.366,1247,2519,0.495,741,905,0.819,345,1353,1698,906,338,548,772,4231
2681,2017-1-18,Brooklyn Nets,41,9890,1549,3523,0.44,455,1353,0.336,1094,2170,0.504,766,979,0.782,371,1431,1802,869,303,683,862,4319
2682,2017-1-18,Milwaukee Bucks,40,9650,1590,3338,0.476,343,924,0.371,1247,2414,0.517,683,896,0.762,376,1319,1695,994,325,528,799,4206
2683,2017-1-18,New York Knicks,42,10155,1671,3746,0.446,384,1064,0.361,1287,2682,0.48,691,887,0.779,511,1409,1920,909,301,575,874,4417
2684,2017-1-18,Charlotte Hornets,41,9915,1546,3516,0.44,388,1102,0.352,1158,2414,0.48,824,1045,0.789,384,1471,1855,953,268,475,696,4304
2685,2017-1-18,Los Angeles Lakers,46,11040,1778,3989,0.446,422,1194,0.353,1356,2795,0.485,837,1100,0.761,533,1479,2012,957,357,660,944,4815
2686,2017-1-18,Minnesota Timberwolves,42,10130,1605,3508,0.458,333,953,0.349,1272,2555,0.498,788,999,0.789,488,1316,1804,954,318,602,867,4331
2687,2017-1-18,Atlanta Hawks,41,9890,1588,3481,0.456,367,1063,0.345,1221,2418,0.505,679,944,0.719,431,1370,1801,987,357,616,725,4222
2688,2017-1-18,Sacramento Kings,40,9675,1492,3300,0.452,356,993,0.359,1136,2307,0.492,770,984,0.783,375,1258,1633,873,322,551,820,4110
2689,2017-1-18,New Orleans Pelicans,42,10230,1599,3648,0.438,385,1091,0.353,1214,2557,0.475,709,942,0.753,357,1504,1861,953,317,509,768,4292
2690,2017-1-18,Chicago Bulls,43,10345,1623,3737,0.434,276,871,0.317,1347,2866,0.47,838,1046,0.801,584,1464,2048,902,328,554,757,4360
2691,2017-1-18,Detroit Pistons,43,10370,1679,3729,0.45,335,982,0.341,1344,2747,0.489,598,806,0.742,421,1455,1876,901,307,492,772,4291
2692,2017-1-18,Orlando Magic,43,10370,1640,3719,0.441,382,1131,0.338,1258,2588,0.486,626,871,0.719,424,1411,1835,958,287,542,795,4288
2693,2017-1-18,Memphis Grizzlies,43,10520,1554,3639,0.427,388,1116,0.348,1166,2523,0.462,785,1006,0.78,458,1411,1869,893,371,535,1036,4281
2694,2017-1-18,Philadelphia 76ers,39,9460,1427,3294,0.433,411,1174,0.35,1016,2120,0.479,614,813,0.755,384,1309,1693,886,308,634,849,3879
2695,2017-1-18,Utah Jazz,43,10320,1556,3342,0.466,417,1128,0.37,1139,2214,0.514,736,983,0.749,374,1461,1835,834,275,566,819,4265
2696,2017-1-18,Miami Heat,42,10155,1587,3613,0.439,363,1077,0.337,1224,2536,0.483,602,890,0.676,449,1409,1858,891,288,522,866,4139
2697,2017-1-18,Dallas Mavericks,41,9890,1457,3357,0.434,437,1237,0.353,1020,2120,0.481,574,721,0.796,337,1218,1555,823,317,471,789,3925
2698,2017-1-19,Golden State Warriors,42,10155,1834,3667,0.5,495,1287,0.385,1339,2380,0.563,784,993,0.79,382,1523,1905,1319,396,629,815,4947
2699,2017-1-19,Houston Rockets,45,10875,1827,3916,0.467,667,1802,0.37,1160,2114,0.549,832,1098,0.758,495,1505,2000,1150,366,662,884,5153
2700,2017-1-19,Toronto Raptors,42,10130,1693,3599,0.47,395,1022,0.386,1298,2577,0.504,880,1086,0.81,465,1336,1801,806,382,471,878,4661
2701,2017-1-19,Denver Nuggets,40,9675,1615,3507,0.461,393,1086,0.362,1222,2421,0.505,765,1014,0.754,491,1386,1877,955,269,605,821,4388
2702,2017-1-19,Cleveland Cavaliers,40,9625,1540,3411,0.451,505,1322,0.382,1035,2089,0.495,773,1014,0.762,413,1347,1760,853,297,536,720,4358
2703,2017-1-19,Los Angeles Clippers,43,10370,1689,3604,0.469,442,1173,0.377,1247,2431,0.513,834,1103,0.756,399,1490,1889,968,336,546,880,4654
2704,2017-1-19,Portland Trail Blazers,44,10685,1733,3802,0.456,453,1267,0.358,1280,2535,0.505,807,1032,0.782,428,1449,1877,980,308,580,955,4726
2705,2017-1-19,San Antonio Spurs,41,9865,1623,3374,0.481,382,920,0.415,1241,2454,0.506,762,932,0.818,384,1368,1752,992,326,519,751,4390
2706,2017-1-19,Boston Celtics,42,10105,1631,3610,0.452,503,1366,0.368,1128,2244,0.503,726,894,0.812,391,1332,1723,1049,315,491,842,4491
2707,2017-1-19,Oklahoma City Thunder,44,10660,1736,3799,0.457,372,1146,0.325,1364,2653,0.514,834,1124,0.742,496,1497,1993,947,343,642,903,4678
2708,2017-1-19,Phoenix Suns,41,9965,1610,3601,0.447,332,962,0.345,1278,2639,0.484,790,1022,0.773,490,1355,1845,747,348,630,1027,4342
2709,2017-1-19,Washington Wizards,41,9915,1662,3530,0.471,344,943,0.365,1318,2587,0.509,670,855,0.784,420,1321,1741,948,352,563,875,4338
2710,2017-1-19,Indiana Pacers,41,9940,1618,3501,0.462,339,928,0.365,1279,2573,0.497,762,930,0.819,353,1377,1730,928,349,562,793,4337
2711,2017-1-19,New York Knicks,43,10395,1717,3837,0.447,394,1089,0.362,1323,2748,0.481,706,905,0.78,529,1448,1977,936,303,589,898,4534
2712,2017-1-19,Brooklyn Nets,41,9890,1549,3523,0.44,455,1353,0.336,1094,2170,0.504,766,979,0.782,371,1431,1802,869,303,683,862,4319
2713,2017-1-19,Charlotte Hornets,42,10155,1587,3603,0.44,399,1128,0.354,1188,2475,0.48,838,1062,0.789,392,1514,1906,981,279,487,709,4411
2714,2017-1-19,Milwaukee Bucks,41,9890,1627,3431,0.474,350,952,0.368,1277,2479,0.515,694,910,0.763,391,1354,1745,1020,333,546,813,4298
2715,2017-1-19,Los Angeles Lakers,46,11040,1778,3989,0.446,422,1194,0.353,1356,2795,0.485,837,1100,0.761,533,1479,2012,957,357,660,944,4815
2716,2017-1-19,Minnesota Timberwolves,42,10130,1605,3508,0.458,333,953,0.349,1272,2555,0.498,788,999,0.789,488,1316,1804,954,318,602,867,4331
2717,2017-1-19,Atlanta Hawks,42,10130,1618,3559,0.455,373,1088,0.343,1245,2471,0.504,708,981,0.722,439,1394,1833,1009,358,628,746,4317
2718,2017-1-19,Sacramento Kings,41,9915,1527,3372,0.453,365,1014,0.36,1162,2358,0.493,791,1011,0.782,385,1284,1669,901,331,572,842,4210
2719,2017-1-19,New Orleans Pelicans,43,10470,1645,3741,0.44,400,1127,0.355,1245,2614,0.476,720,957,0.752,363,1543,1906,981,328,517,781,4410
2720,2017-1-19,Chicago Bulls,43,10345,1623,3737,0.434,276,871,0.317,1347,2866,0.47,838,1046,0.801,584,1464,2048,902,328,554,757,4360
2721,2017-1-19,Detroit Pistons,44,10610,1724,3820,0.451,345,1007,0.343,1379,2813,0.49,616,834,0.739,439,1497,1936,928,313,504,801,4409
2722,2017-1-19,Orlando Magic,44,10610,1679,3807,0.441,393,1163,0.338,1286,2644,0.486,635,882,0.72,428,1454,1882,976,293,560,809,4386
2723,2017-1-19,Memphis Grizzlies,44,10760,1587,3722,0.426,396,1141,0.347,1191,2581,0.461,812,1040,0.781,475,1439,1914,913,379,547,1056,4382
2724,2017-1-19,Philadelphia 76ers,40,9700,1458,3363,0.434,419,1198,0.35,1039,2165,0.48,638,845,0.755,389,1350,1739,906,313,656,870,3973
2725,2017-1-19,Utah Jazz,43,10320,1556,3342,0.466,417,1128,0.37,1139,2214,0.514,736,983,0.749,374,1461,1835,834,275,566,819,4265
2726,2017-1-19,Miami Heat,42,10155,1587,3613,0.439,363,1077,0.337,1224,2536,0.483,602,890,0.676,449,1409,1858,891,288,522,866,4139
2727,2017-1-19,Dallas Mavericks,41,9890,1457,3357,0.434,437,1237,0.353,1020,2120,0.481,574,721,0.796,337,1218,1555,823,317,471,789,3925
2728,2017-1-20,Golden State Warriors,42,10155,1834,3667,0.5,495,1287,0.385,1339,2380,0.563,784,993,0.79,382,1523,1905,1319,396,629,815,4947
2729,2017-1-20,Houston Rockets,45,10875,1827,3916,0.467,667,1802,0.37,1160,2114,0.549,832,1098,0.758,495,1505,2000,1150,366,662,884,5153
2730,2017-1-20,Toronto Raptors,42,10130,1693,3599,0.47,395,1022,0.386,1298,2577,0.504,880,1086,0.81,465,1336,1801,806,382,471,878,4661
2731,2017-1-20,Denver Nuggets,41,9915,1652,3598,0.459,403,1117,0.361,1249,2481,0.503,785,1040,0.755,502,1418,1920,982,274,620,840,4492
2732,2017-1-20,Cleveland Cavaliers,41,9865,1583,3496,0.453,524,1364,0.384,1059,2132,0.497,786,1033,0.761,417,1379,1796,882,304,548,744,4476
2733,2017-1-20,Los Angeles Clippers,44,10610,1731,3691,0.469,446,1195,0.373,1285,2496,0.515,847,1127,0.752,413,1517,1930,992,345,557,901,4755
2734,2017-1-20,Portland Trail Blazers,44,10685,1733,3802,0.456,453,1267,0.358,1280,2535,0.505,807,1032,0.782,428,1449,1877,980,308,580,955,4726
2735,2017-1-20,San Antonio Spurs,42,10105,1667,3460,0.482,391,942,0.415,1276,2518,0.507,783,957,0.818,390,1405,1795,1020,338,526,770,4508
2736,2017-1-20,Boston Celtics,42,10105,1631,3610,0.452,503,1366,0.368,1128,2244,0.503,726,894,0.812,391,1332,1723,1049,315,491,842,4491
2737,2017-1-20,Oklahoma City Thunder,44,10660,1736,3799,0.457,372,1146,0.325,1364,2653,0.514,834,1124,0.742,496,1497,1993,947,343,642,903,4678
2738,2017-1-20,Washington Wizards,42,10155,1706,3618,0.472,357,975,0.366,1349,2643,0.51,682,869,0.785,430,1351,1781,977,359,578,894,4451
2739,2017-1-20,Phoenix Suns,42,10205,1647,3686,0.447,336,981,0.343,1311,2705,0.485,815,1053,0.774,505,1386,1891,770,358,644,1049,4445
2740,2017-1-20,Indiana Pacers,41,9940,1618,3501,0.462,339,928,0.365,1279,2573,0.497,762,930,0.819,353,1377,1730,928,349,562,793,4337
2741,2017-1-20,New York Knicks,44,10635,1759,3927,0.448,401,1113,0.36,1358,2814,0.483,725,927,0.782,543,1475,2018,956,310,599,912,4644
2742,2017-1-20,Brooklyn Nets,41,9890,1549,3523,0.44,455,1353,0.336,1094,2170,0.504,766,979,0.782,371,1431,1802,869,303,683,862,4319
2743,2017-1-20,Charlotte Hornets,42,10155,1587,3603,0.44,399,1128,0.354,1188,2475,0.48,838,1062,0.789,392,1514,1906,981,279,487,709,4411
2744,2017-1-20,Milwaukee Bucks,41,9890,1627,3431,0.474,350,952,0.368,1277,2479,0.515,694,910,0.763,391,1354,1745,1020,333,546,813,4298
2745,2017-1-20,Los Angeles Lakers,46,11040,1778,3989,0.446,422,1194,0.353,1356,2795,0.485,837,1100,0.761,533,1479,2012,957,357,660,944,4815
2746,2017-1-20,Minnesota Timberwolves,43,10370,1645,3592,0.458,338,969,0.349,1307,2623,0.498,807,1024,0.788,501,1346,1847,979,321,615,888,4435
2747,2017-1-20,Atlanta Hawks,42,10130,1618,3559,0.455,373,1088,0.343,1245,2471,0.504,708,981,0.722,439,1394,1833,1009,358,628,746,4317
2748,2017-1-20,Sacramento Kings,41,9915,1527,3372,0.453,365,1014,0.36,1162,2358,0.493,791,1011,0.782,385,1284,1669,901,331,572,842,4210
2749,2017-1-20,New Orleans Pelicans,43,10470,1645,3741,0.44,400,1127,0.355,1245,2614,0.476,720,957,0.752,363,1543,1906,981,328,517,781,4410
2750,2017-1-20,Chicago Bulls,43,10345,1623,3737,0.434,276,871,0.317,1347,2866,0.47,838,1046,0.801,584,1464,2048,902,328,554,757,4360
2751,2017-1-20,Detroit Pistons,44,10610,1724,3820,0.451,345,1007,0.343,1379,2813,0.49,616,834,0.739,439,1497,1936,928,313,504,801,4409
2752,2017-1-20,Orlando Magic,44,10610,1679,3807,0.441,393,1163,0.338,1286,2644,0.486,635,882,0.72,428,1454,1882,976,293,560,809,4386
2753,2017-1-20,Memphis Grizzlies,44,10760,1587,3722,0.426,396,1141,0.347,1191,2581,0.461,812,1040,0.781,475,1439,1914,913,379,547,1056,4382
2754,2017-1-20,Philadelphia 76ers,40,9700,1458,3363,0.434,419,1198,0.35,1039,2165,0.48,638,845,0.755,389,1350,1739,906,313,656,870,3973
2755,2017-1-20,Utah Jazz,43,10320,1556,3342,0.466,417,1128,0.37,1139,2214,0.514,736,983,0.749,374,1461,1835,834,275,566,819,4265
2756,2017-1-20,Miami Heat,43,10395,1622,3686,0.44,372,1097,0.339,1250,2589,0.483,622,919,0.677,455,1443,1898,907,292,535,881,4238
2757,2017-1-20,Dallas Mavericks,42,10130,1494,3439,0.434,451,1273,0.354,1043,2166,0.482,581,732,0.794,342,1246,1588,840,321,480,809,4020
2758,2017-1-21,Golden State Warriors,43,10395,1881,3756,0.501,510,1325,0.385,1371,2431,0.564,800,1014,0.789,390,1556,1946,1349,404,643,833,5072
2759,2017-1-21,Houston Rockets,46,11115,1870,4012,0.466,674,1837,0.367,1196,2175,0.55,847,1116,0.759,508,1533,2041,1176,374,676,901,5261
2760,2017-1-21,Toronto Raptors,43,10370,1722,3685,0.467,402,1052,0.382,1320,2633,0.501,893,1100,0.812,473,1361,1834,816,389,483,898,4739
2761,2017-1-21,Denver Nuggets,41,9915,1652,3598,0.459,403,1117,0.361,1249,2481,0.503,785,1040,0.755,502,1418,1920,982,274,620,840,4492
2762,2017-1-21,Cleveland Cavaliers,41,9865,1583,3496,0.453,524,1364,0.384,1059,2132,0.497,786,1033,0.761,417,1379,1796,882,304,548,744,4476
2763,2017-1-21,Los Angeles Clippers,44,10610,1731,3691,0.469,446,1195,0.373,1285,2496,0.515,847,1127,0.752,413,1517,1930,992,345,557,901,4755
2764,2017-1-21,San Antonio Spurs,42,10105,1667,3460,0.482,391,942,0.415,1276,2518,0.507,783,957,0.818,390,1405,1795,1020,338,526,770,4508
2765,2017-1-21,Portland Trail Blazers,45,10925,1766,3891,0.454,459,1286,0.357,1307,2605,0.502,827,1060,0.78,440,1483,1923,996,316,593,975,4818
2766,2017-1-21,Boston Celtics,42,10105,1631,3610,0.452,503,1366,0.368,1128,2244,0.503,726,894,0.812,391,1332,1723,1049,315,491,842,4491
2767,2017-1-21,Oklahoma City Thunder,44,10660,1736,3799,0.457,372,1146,0.325,1364,2653,0.514,834,1124,0.742,496,1497,1993,947,343,642,903,4678
2768,2017-1-21,Brooklyn Nets,42,10130,1597,3606,0.443,470,1383,0.34,1127,2223,0.507,798,1014,0.787,380,1474,1854,893,308,699,882,4462
2769,2017-1-21,Washington Wizards,42,10155,1706,3618,0.472,357,975,0.366,1349,2643,0.51,682,869,0.785,430,1351,1781,977,359,578,894,4451
2770,2017-1-21,Phoenix Suns,42,10205,1647,3686,0.447,336,981,0.343,1311,2705,0.485,815,1053,0.774,505,1386,1891,770,358,644,1049,4445
2771,2017-1-21,Indiana Pacers,42,10180,1652,3581,0.461,348,951,0.366,1304,2630,0.496,780,955,0.817,361,1406,1767,952,366,582,805,4432
2772,2017-1-21,New York Knicks,44,10635,1759,3927,0.448,401,1113,0.36,1358,2814,0.483,725,927,0.782,543,1475,2018,956,310,599,912,4644
2773,2017-1-21,Charlotte Hornets,43,10395,1627,3683,0.442,411,1153,0.356,1216,2530,0.481,859,1087,0.79,403,1554,1957,1005,288,501,722,4524
2774,2017-1-21,Los Angeles Lakers,47,11280,1819,4076,0.446,436,1227,0.355,1383,2849,0.485,849,1115,0.761,549,1514,2063,984,372,683,964,4923
2775,2017-1-21,Milwaukee Bucks,42,10130,1661,3514,0.473,360,977,0.368,1301,2537,0.513,712,936,0.761,401,1384,1785,1041,339,558,838,4394
2776,2017-1-21,Minnesota Timberwolves,43,10370,1645,3592,0.458,338,969,0.349,1307,2623,0.498,807,1024,0.788,501,1346,1847,979,321,615,888,4435
2777,2017-1-21,Atlanta Hawks,43,10370,1657,3641,0.455,382,1110,0.344,1275,2531,0.504,723,1000,0.723,449,1424,1873,1032,374,647,765,4419
2778,2017-1-21,New Orleans Pelicans,44,10710,1688,3846,0.439,411,1161,0.354,1277,2685,0.476,737,980,0.752,381,1572,1953,1002,336,526,805,4524
2779,2017-1-21,Sacramento Kings,42,10155,1558,3448,0.452,371,1043,0.356,1187,2405,0.494,814,1043,0.78,390,1314,1704,919,340,582,863,4301
2780,2017-1-21,Chicago Bulls,44,10585,1657,3818,0.434,283,899,0.315,1374,2919,0.471,856,1065,0.804,596,1493,2089,920,340,578,774,4453
2781,2017-1-21,Detroit Pistons,44,10610,1724,3820,0.451,345,1007,0.343,1379,2813,0.49,616,834,0.739,439,1497,1936,928,313,504,801,4409
2782,2017-1-21,Orlando Magic,45,10850,1719,3894,0.441,401,1191,0.337,1318,2703,0.488,659,913,0.722,442,1493,1935,1001,302,569,833,4498
2783,2017-1-21,Memphis Grizzlies,45,11000,1625,3805,0.427,407,1169,0.348,1218,2636,0.462,832,1065,0.781,490,1482,1972,934,385,562,1080,4489
2784,2017-1-21,Utah Jazz,44,10585,1594,3425,0.465,425,1151,0.369,1169,2274,0.514,764,1022,0.748,389,1499,1888,851,283,580,845,4377
2785,2017-1-21,Philadelphia 76ers,41,9940,1494,3455,0.432,431,1227,0.351,1063,2228,0.477,647,861,0.751,402,1390,1792,931,319,675,891,4066
2786,2017-1-21,Miami Heat,43,10395,1622,3686,0.44,372,1097,0.339,1250,2589,0.483,622,919,0.677,455,1443,1898,907,292,535,881,4238
2787,2017-1-21,Dallas Mavericks,43,10395,1533,3526,0.435,459,1296,0.354,1074,2230,0.482,602,760,0.792,351,1280,1631,861,325,492,835,4127
2788,2017-1-22,Golden State Warriors,43,10395,1881,3756,0.501,510,1325,0.385,1371,2431,0.564,800,1014,0.789,390,1556,1946,1349,404,643,833,5072
2789,2017-1-22,Houston Rockets,47,11355,1911,4092,0.467,690,1879,0.367,1221,2213,0.552,868,1141,0.761,514,1573,2087,1203,385,688,926,5380
2790,2017-1-22,Toronto Raptors,43,10370,1722,3685,0.467,402,1052,0.382,1320,2633,0.501,893,1100,0.812,473,1361,1834,816,389,483,898,4739
2791,2017-1-22,Denver Nuggets,42,10155,1698,3685,0.461,413,1141,0.362,1285,2544,0.505,806,1066,0.756,512,1453,1965,1012,278,630,856,4615
2792,2017-1-22,Cleveland Cavaliers,42,10130,1628,3587,0.454,537,1398,0.384,1091,2189,0.498,798,1055,0.756,428,1415,1843,907,311,566,760,4591
2793,2017-1-22,Los Angeles Clippers,45,10850,1771,3787,0.468,456,1227,0.372,1315,2560,0.514,855,1135,0.753,423,1542,1965,1015,350,564,924,4853
2794,2017-1-22,San Antonio Spurs,43,10370,1715,3556,0.482,401,968,0.414,1314,2588,0.508,795,971,0.819,400,1441,1841,1052,344,539,792,4626
2795,2017-1-22,Portland Trail Blazers,46,11190,1809,3983,0.454,469,1311,0.358,1340,2672,0.501,858,1096,0.783,449,1511,1960,1022,328,607,1001,4945
2796,2017-1-22,Boston Celtics,43,10370,1673,3702,0.452,516,1401,0.368,1157,2301,0.503,752,925,0.813,405,1365,1770,1075,321,512,871,4614
2797,2017-1-22,Oklahoma City Thunder,44,10660,1736,3799,0.457,372,1146,0.325,1364,2653,0.514,834,1124,0.742,496,1497,1993,947,343,642,903,4678
2798,2017-1-22,Brooklyn Nets,43,10370,1635,3694,0.443,487,1424,0.342,1148,2270,0.506,810,1029,0.787,384,1510,1894,923,317,711,899,4567
2799,2017-1-22,Washington Wizards,43,10395,1745,3709,0.47,365,1001,0.365,1380,2708,0.51,708,902,0.785,443,1385,1828,1000,371,589,916,4563
2800,2017-1-22,Phoenix Suns,43,10445,1684,3771,0.447,345,1005,0.343,1339,2766,0.484,839,1080,0.777,519,1416,1935,785,367,657,1067,4552
2801,2017-1-22,New York Knicks,45,10875,1799,4016,0.448,412,1134,0.363,1387,2882,0.481,739,943,0.784,558,1506,2064,976,316,611,932,4749
2802,2017-1-22,Charlotte Hornets,44,10635,1666,3765,0.442,425,1183,0.359,1241,2582,0.481,879,1109,0.793,409,1594,2003,1031,295,514,740,4636
2803,2017-1-22,Indiana Pacers,43,10420,1691,3658,0.462,358,971,0.369,1333,2687,0.496,792,972,0.815,365,1438,1803,969,376,598,828,4532
2804,2017-1-22,Los Angeles Lakers,47,11280,1819,4076,0.446,436,1227,0.355,1383,2849,0.485,849,1115,0.761,549,1514,2063,984,372,683,964,4923
2805,2017-1-22,Milwaukee Bucks,43,10370,1694,3593,0.471,366,995,0.368,1328,2598,0.511,737,968,0.761,413,1413,1826,1058,345,569,856,4491
2806,2017-1-22,Minnesota Timberwolves,43,10370,1645,3592,0.458,338,969,0.349,1307,2623,0.498,807,1024,0.788,501,1346,1847,979,321,615,888,4435
2807,2017-1-22,Atlanta Hawks,44,10610,1702,3732,0.456,389,1130,0.344,1313,2602,0.505,736,1023,0.719,460,1460,1920,1056,382,660,783,4529
2808,2017-1-22,New Orleans Pelicans,44,10710,1688,3846,0.439,411,1161,0.354,1277,2685,0.476,737,980,0.752,381,1572,1953,1002,336,526,805,4524
2809,2017-1-22,Sacramento Kings,43,10395,1595,3532,0.452,380,1069,0.355,1215,2463,0.493,830,1064,0.78,399,1345,1744,939,347,591,886,4400
2810,2017-1-22,Chicago Bulls,45,10825,1691,3901,0.433,289,916,0.316,1402,2985,0.47,884,1098,0.805,610,1527,2137,942,347,589,792,4555
2811,2017-1-22,Detroit Pistons,45,10850,1767,3907,0.452,356,1035,0.344,1411,2872,0.491,632,856,0.738,452,1533,1985,953,322,524,828,4522
2812,2017-1-22,Orlando Magic,45,10850,1719,3894,0.441,401,1191,0.337,1318,2703,0.488,659,913,0.722,442,1493,1935,1001,302,569,833,4498
2813,2017-1-22,Utah Jazz,45,10825,1633,3509,0.465,431,1175,0.367,1202,2334,0.515,789,1054,0.749,399,1531,1930,875,294,594,860,4486
2814,2017-1-22,Memphis Grizzlies,46,11240,1658,3894,0.426,416,1203,0.346,1242,2691,0.462,852,1093,0.78,504,1509,2013,953,395,574,1097,4584
2815,2017-1-22,Philadelphia 76ers,42,10180,1527,3533,0.432,443,1256,0.353,1084,2277,0.476,662,879,0.753,409,1422,1831,958,327,697,910,4159
2816,2017-1-22,Miami Heat,44,10635,1663,3763,0.442,385,1127,0.342,1278,2636,0.485,636,941,0.676,460,1477,1937,925,300,546,905,4347
2817,2017-1-22,Dallas Mavericks,43,10395,1533,3526,0.435,459,1296,0.354,1074,2230,0.482,602,760,0.792,351,1280,1631,861,325,492,835,4127
2818,2017-1-23,Golden State Warriors,44,10635,1923,3845,0.5,529,1367,0.387,1394,2478,0.563,815,1033,0.789,403,1595,1998,1376,412,661,848,5190
2819,2017-1-23,Houston Rockets,47,11355,1911,4092,0.467,690,1879,0.367,1221,2213,0.552,868,1141,0.761,514,1573,2087,1203,385,688,926,5380
2820,2017-1-23,Toronto Raptors,44,10610,1755,3768,0.466,409,1079,0.379,1346,2689,0.501,923,1135,0.813,480,1389,1869,835,398,492,918,4842
2821,2017-1-23,Denver Nuggets,43,10395,1740,3767,0.462,420,1165,0.361,1320,2602,0.507,823,1087,0.757,524,1482,2006,1038,284,647,875,4723
2822,2017-1-23,Cleveland Cavaliers,42,10130,1628,3587,0.454,537,1398,0.384,1091,2189,0.498,798,1055,0.756,428,1415,1843,907,311,566,760,4591
2823,2017-1-23,Los Angeles Clippers,45,10850,1771,3787,0.468,456,1227,0.372,1315,2560,0.514,855,1135,0.753,423,1542,1965,1015,350,564,924,4853
2824,2017-1-23,San Antonio Spurs,43,10370,1715,3556,0.482,401,968,0.414,1314,2588,0.508,795,971,0.819,400,1441,1841,1052,344,539,792,4626
2825,2017-1-23,Portland Trail Blazers,46,11190,1809,3983,0.454,469,1311,0.358,1340,2672,0.501,858,1096,0.783,449,1511,1960,1022,328,607,1001,4945
2826,2017-1-23,Boston Celtics,43,10370,1673,3702,0.452,516,1401,0.368,1157,2301,0.503,752,925,0.813,405,1365,1770,1075,321,512,871,4614
2827,2017-1-23,Oklahoma City Thunder,44,10660,1736,3799,0.457,372,1146,0.325,1364,2653,0.514,834,1124,0.742,496,1497,1993,947,343,642,903,4678
2828,2017-1-23,Brooklyn Nets,43,10370,1635,3694,0.443,487,1424,0.342,1148,2270,0.506,810,1029,0.787,384,1510,1894,923,317,711,899,4567
2829,2017-1-23,Washington Wizards,43,10395,1745,3709,0.47,365,1001,0.365,1380,2708,0.51,708,902,0.785,443,1385,1828,1000,371,589,916,4563
2830,2017-1-23,Phoenix Suns,44,10685,1724,3850,0.448,354,1027,0.345,1370,2823,0.485,865,1108,0.781,526,1454,1980,805,373,672,1095,4667
2831,2017-1-23,New York Knicks,45,10875,1799,4016,0.448,412,1134,0.363,1387,2882,0.481,739,943,0.784,558,1506,2064,976,316,611,932,4749
2832,2017-1-23,Charlotte Hornets,44,10635,1666,3765,0.442,425,1183,0.359,1241,2582,0.481,879,1109,0.793,409,1594,2003,1031,295,514,740,4636
2833,2017-1-23,Indiana Pacers,43,10420,1691,3658,0.462,358,971,0.369,1333,2687,0.496,792,972,0.815,365,1438,1803,969,376,598,828,4532
2834,2017-1-23,Milwaukee Bucks,43,10370,1694,3593,0.471,366,995,0.368,1328,2598,0.511,737,968,0.761,413,1413,1826,1058,345,569,856,4491
2835,2017-1-23,Los Angeles Lakers,48,11520,1847,4149,0.445,439,1248,0.352,1408,2901,0.485,863,1132,0.762,554,1541,2095,995,375,700,984,4996
2836,2017-1-23,Minnesota Timberwolves,44,10610,1690,3677,0.46,344,984,0.35,1346,2693,0.5,822,1045,0.787,509,1374,1883,1008,332,629,912,4546
2837,2017-1-23,Atlanta Hawks,44,10610,1702,3732,0.456,389,1130,0.344,1313,2602,0.505,736,1023,0.719,460,1460,1920,1056,382,660,783,4529
2838,2017-1-23,New Orleans Pelicans,44,10710,1688,3846,0.439,411,1161,0.354,1277,2685,0.476,737,980,0.752,381,1572,1953,1002,336,526,805,4524
2839,2017-1-23,Sacramento Kings,43,10395,1595,3532,0.452,380,1069,0.355,1215,2463,0.493,830,1064,0.78,399,1345,1744,939,347,591,886,4400
2840,2017-1-23,Chicago Bulls,45,10825,1691,3901,0.433,289,916,0.316,1402,2985,0.47,884,1098,0.805,610,1527,2137,942,347,589,792,4555
2841,2017-1-23,Detroit Pistons,45,10850,1767,3907,0.452,356,1035,0.344,1411,2872,0.491,632,856,0.738,452,1533,1985,953,322,524,828,4522
2842,2017-1-23,Orlando Magic,46,11090,1761,3990,0.441,408,1219,0.335,1353,2771,0.488,666,929,0.717,454,1522,1976,1026,311,581,854,4596
2843,2017-1-23,Utah Jazz,45,10825,1633,3509,0.465,431,1175,0.367,1202,2334,0.515,789,1054,0.749,399,1531,1930,875,294,594,860,4486
2844,2017-1-23,Memphis Grizzlies,46,11240,1658,3894,0.426,416,1203,0.346,1242,2691,0.462,852,1093,0.78,504,1509,2013,953,395,574,1097,4584
2845,2017-1-23,Philadelphia 76ers,42,10180,1527,3533,0.432,443,1256,0.353,1084,2277,0.476,662,879,0.753,409,1422,1831,958,327,697,910,4159
2846,2017-1-23,Miami Heat,44,10635,1663,3763,0.442,385,1127,0.342,1278,2636,0.485,636,941,0.676,460,1477,1937,925,300,546,905,4347
2847,2017-1-23,Dallas Mavericks,44,10635,1576,3613,0.436,476,1335,0.357,1100,2278,0.483,621,779,0.797,364,1316,1680,888,334,502,850,4249
2848,2017-1-24,Golden State Warriors,45,10875,1964,3933,0.499,537,1397,0.384,1427,2536,0.563,827,1053,0.785,410,1631,2041,1403,421,675,868,5292
2849,2017-1-24,Houston Rockets,48,11595,1950,4169,0.468,704,1914,0.368,1246,2255,0.553,890,1169,0.761,519,1596,2115,1229,396,709,948,5494
2850,2017-1-24,Toronto Raptors,44,10610,1755,3768,0.466,409,1079,0.379,1346,2689,0.501,923,1135,0.813,480,1389,1869,835,398,492,918,4842
2851,2017-1-24,Denver Nuggets,43,10395,1740,3767,0.462,420,1165,0.361,1320,2602,0.507,823,1087,0.757,524,1482,2006,1038,284,647,875,4723
2852,2017-1-24,Cleveland Cavaliers,43,10370,1671,3680,0.454,552,1435,0.385,1119,2245,0.498,819,1080,0.758,439,1449,1888,931,317,577,780,4713
2853,2017-1-24,Los Angeles Clippers,46,11090,1813,3871,0.468,470,1251,0.376,1343,2620,0.513,872,1157,0.754,433,1578,2011,1038,354,575,943,4968
2854,2017-1-24,San Antonio Spurs,44,10610,1760,3651,0.482,410,990,0.414,1350,2661,0.507,808,987,0.819,413,1478,1891,1074,351,547,809,4738
2855,2017-1-24,Portland Trail Blazers,46,11190,1809,3983,0.454,469,1311,0.358,1340,2672,0.501,858,1096,0.783,449,1511,1960,1022,328,607,1001,4945
2856,2017-1-24,Boston Celtics,43,10370,1673,3702,0.452,516,1401,0.368,1157,2301,0.503,752,925,0.813,405,1365,1770,1075,321,512,871,4614
2857,2017-1-24,Washington Wizards,44,10635,1788,3789,0.472,375,1026,0.365,1413,2763,0.511,721,919,0.785,448,1427,1875,1022,376,603,939,4672
2858,2017-1-24,Phoenix Suns,44,10685,1724,3850,0.448,354,1027,0.345,1370,2823,0.485,865,1108,0.781,526,1454,1980,805,373,672,1095,4667
2859,2017-1-24,Oklahoma City Thunder,45,10900,1772,3882,0.456,378,1166,0.324,1394,2716,0.513,853,1149,0.742,504,1534,2038,964,349,652,926,4775
2860,2017-1-24,Brooklyn Nets,44,10610,1667,3775,0.442,492,1449,0.34,1175,2326,0.505,827,1047,0.79,389,1543,1932,937,319,727,917,4653
2861,2017-1-24,New York Knicks,46,11115,1834,4092,0.448,420,1156,0.363,1414,2936,0.482,770,978,0.787,564,1543,2107,995,324,625,953,4858
2862,2017-1-24,Indiana Pacers,44,10660,1729,3744,0.462,365,997,0.366,1364,2747,0.497,812,997,0.814,372,1468,1840,987,383,609,848,4635
2863,2017-1-24,Charlotte Hornets,45,10875,1701,3855,0.441,433,1215,0.356,1268,2640,0.48,900,1134,0.794,421,1625,2046,1055,302,522,759,4735
2864,2017-1-24,Milwaukee Bucks,44,10610,1741,3673,0.474,377,1018,0.37,1364,2655,0.514,759,995,0.763,420,1443,1863,1089,362,588,876,4618
2865,2017-1-24,Los Angeles Lakers,48,11520,1847,4149,0.445,439,1248,0.352,1408,2901,0.485,863,1132,0.762,554,1541,2095,995,375,700,984,4996
2866,2017-1-24,New Orleans Pelicans,45,10950,1731,3933,0.44,427,1200,0.356,1304,2733,0.477,759,1010,0.751,388,1607,1995,1028,344,534,827,4648
2867,2017-1-24,Minnesota Timberwolves,44,10610,1690,3677,0.46,344,984,0.35,1346,2693,0.5,822,1045,0.787,509,1374,1883,1008,332,629,912,4546
2868,2017-1-24,Atlanta Hawks,45,10850,1739,3820,0.455,398,1159,0.343,1341,2661,0.504,758,1049,0.723,468,1492,1960,1084,390,668,800,4634
2869,2017-1-24,Sacramento Kings,44,10635,1635,3614,0.452,389,1090,0.357,1246,2524,0.494,850,1090,0.78,409,1378,1787,964,357,605,901,4509
2870,2017-1-24,Chicago Bulls,45,10825,1691,3901,0.433,289,916,0.316,1402,2985,0.47,884,1098,0.805,610,1527,2137,942,347,589,792,4555
2871,2017-1-24,Detroit Pistons,46,11090,1808,3989,0.453,366,1063,0.344,1442,2926,0.493,644,873,0.738,458,1565,2023,980,330,539,849,4626
2872,2017-1-24,Orlando Magic,46,11090,1761,3990,0.441,408,1219,0.335,1353,2771,0.488,666,929,0.717,454,1522,1976,1026,311,581,854,4596
2873,2017-1-24,Memphis Grizzlies,46,11240,1658,3894,0.426,416,1203,0.346,1242,2691,0.462,852,1093,0.78,504,1509,2013,953,395,574,1097,4584
2874,2017-1-24,Utah Jazz,46,11065,1669,3593,0.465,436,1196,0.365,1233,2397,0.514,807,1080,0.747,407,1565,1972,891,304,604,878,4581
2875,2017-1-24,Philadelphia 76ers,42,10180,1527,3533,0.432,443,1256,0.353,1084,2277,0.476,662,879,0.753,409,1422,1831,958,327,697,910,4159
2876,2017-1-24,Miami Heat,45,10875,1701,3849,0.442,398,1157,0.344,1303,2692,0.484,652,968,0.674,471,1511,1982,945,309,559,924,4452
2877,2017-1-24,Dallas Mavericks,44,10635,1576,3613,0.436,476,1335,0.357,1100,2278,0.483,621,779,0.797,364,1316,1680,888,334,502,850,4249
2878,2017-1-25,Golden State Warriors,45,10875,1964,3933,0.499,537,1397,0.384,1427,2536,0.563,827,1053,0.785,410,1631,2041,1403,421,675,868,5292
2879,2017-1-25,Houston Rockets,48,11595,1950,4169,0.468,704,1914,0.368,1246,2255,0.553,890,1169,0.761,519,1596,2115,1229,396,709,948,5494
2880,2017-1-25,Toronto Raptors,45,10850,1793,3852,0.465,415,1104,0.376,1378,2748,0.501,947,1163,0.814,490,1424,1914,845,407,505,943,4948
2881,2017-1-25,Denver Nuggets,44,10635,1775,3843,0.462,430,1191,0.361,1345,2652,0.507,846,1118,0.757,531,1518,2049,1066,291,661,890,4826
2882,2017-1-25,Cleveland Cavaliers,43,10370,1671,3680,0.454,552,1435,0.385,1119,2245,0.498,819,1080,0.758,439,1449,1888,931,317,577,780,4713
2883,2017-1-25,Los Angeles Clippers,47,11330,1846,3942,0.468,488,1285,0.38,1358,2657,0.511,898,1198,0.75,444,1613,2057,1055,358,592,965,5078
2884,2017-1-25,San Antonio Spurs,45,10850,1798,3736,0.481,417,1014,0.411,1381,2722,0.507,833,1020,0.817,419,1508,1927,1094,358,559,827,4846
2885,2017-1-25,Portland Trail Blazers,46,11190,1809,3983,0.454,469,1311,0.358,1340,2672,0.501,858,1096,0.783,449,1511,1960,1022,328,607,1001,4945
2886,2017-1-25,Boston Celtics,44,10610,1711,3786,0.452,526,1434,0.367,1185,2352,0.504,774,949,0.816,413,1389,1802,1099,331,525,891,4722
2887,2017-1-25,Washington Wizards,45,10875,1836,3873,0.474,384,1046,0.367,1452,2827,0.514,739,940,0.786,456,1462,1918,1043,383,618,957,4795
2888,2017-1-25,Phoenix Suns,45,10925,1762,3936,0.448,361,1046,0.345,1401,2890,0.485,893,1140,0.783,539,1485,2024,825,380,687,1118,4778
2889,2017-1-25,Oklahoma City Thunder,45,10900,1772,3882,0.456,378,1166,0.324,1394,2716,0.513,853,1149,0.742,504,1534,2038,964,349,652,926,4775
2890,2017-1-25,Brooklyn Nets,44,10610,1667,3775,0.442,492,1449,0.34,1175,2326,0.505,827,1047,0.79,389,1543,1932,937,319,727,917,4653
2891,2017-1-25,New York Knicks,46,11115,1834,4092,0.448,420,1156,0.363,1414,2936,0.482,770,978,0.787,564,1543,2107,995,324,625,953,4858
2892,2017-1-25,Indiana Pacers,44,10660,1729,3744,0.462,365,997,0.366,1364,2747,0.497,812,997,0.814,372,1468,1840,987,383,609,848,4635
2893,2017-1-25,Charlotte Hornets,45,10875,1701,3855,0.441,433,1215,0.356,1268,2640,0.48,900,1134,0.794,421,1625,2046,1055,302,522,759,4735
2894,2017-1-25,Milwaukee Bucks,44,10610,1741,3673,0.474,377,1018,0.37,1364,2655,0.514,759,995,0.763,420,1443,1863,1089,362,588,876,4618
2895,2017-1-25,Los Angeles Lakers,48,11520,1847,4149,0.445,439,1248,0.352,1408,2901,0.485,863,1132,0.762,554,1541,2095,995,375,700,984,4996
2896,2017-1-25,Minnesota Timberwolves,45,10850,1734,3761,0.461,350,1001,0.35,1384,2760,0.501,840,1069,0.786,519,1406,1925,1032,340,644,933,4658
2897,2017-1-25,New Orleans Pelicans,45,10950,1731,3933,0.44,427,1200,0.356,1304,2733,0.477,759,1010,0.751,388,1607,1995,1028,344,534,827,4648
2898,2017-1-25,Atlanta Hawks,45,10850,1739,3820,0.455,398,1159,0.343,1341,2661,0.504,758,1049,0.723,468,1492,1960,1084,390,668,800,4634
2899,2017-1-25,Sacramento Kings,44,10635,1635,3614,0.452,389,1090,0.357,1246,2524,0.494,850,1090,0.78,409,1378,1787,964,357,605,901,4509
2900,2017-1-25,Chicago Bulls,46,11065,1726,3978,0.434,296,938,0.316,1430,3040,0.47,907,1128,0.804,616,1565,2181,954,360,602,811,4655
2901,2017-1-25,Detroit Pistons,46,11090,1808,3989,0.453,366,1063,0.344,1442,2926,0.493,644,873,0.738,458,1565,2023,980,330,539,849,4626
2902,2017-1-25,Orlando Magic,47,11330,1796,4075,0.441,415,1241,0.334,1381,2834,0.487,681,949,0.718,466,1558,2024,1044,318,600,872,4688
2903,2017-1-25,Memphis Grizzlies,46,11240,1658,3894,0.426,416,1203,0.346,1242,2691,0.462,852,1093,0.78,504,1509,2013,953,395,574,1097,4584
2904,2017-1-25,Philadelphia 76ers,43,10420,1572,3623,0.434,453,1285,0.353,1119,2338,0.479,683,901,0.758,415,1454,1869,993,335,702,937,4280
2905,2017-1-25,Utah Jazz,47,11305,1704,3678,0.463,443,1218,0.364,1261,2460,0.513,823,1101,0.748,415,1597,2012,910,310,615,899,4674
2906,2017-1-25,Miami Heat,45,10875,1701,3849,0.442,398,1157,0.344,1303,2692,0.484,652,968,0.674,471,1511,1982,945,309,559,924,4452
2907,2017-1-25,Dallas Mavericks,44,10635,1576,3613,0.436,476,1335,0.357,1100,2278,0.483,621,779,0.797,364,1316,1680,888,334,502,850,4249
2908,2017-1-26,Golden State Warriors,46,11115,2003,4015,0.499,548,1425,0.385,1455,2590,0.562,851,1080,0.788,415,1667,2082,1426,428,687,887,5405
2909,2017-1-26,Houston Rockets,49,11835,1986,4246,0.468,714,1945,0.367,1272,2301,0.553,917,1207,0.76,525,1620,2145,1257,404,726,966,5603
2910,2017-1-26,Cleveland Cavaliers,44,10635,1711,3762,0.455,567,1473,0.385,1144,2289,0.5,836,1114,0.75,452,1483,1935,960,326,595,801,4825
2911,2017-1-26,Denver Nuggets,44,10635,1775,3843,0.462,430,1191,0.361,1345,2652,0.507,846,1118,0.757,531,1518,2049,1066,291,661,890,4826
2912,2017-1-26,Toronto Raptors,46,11090,1832,3944,0.465,425,1138,0.373,1407,2806,0.501,958,1182,0.81,503,1456,1959,861,413,513,965,5047
2913,2017-1-26,Los Angeles Clippers,47,11330,1846,3942,0.468,488,1285,0.38,1358,2657,0.511,898,1198,0.75,444,1613,2057,1055,358,592,965,5078
2914,2017-1-26,San Antonio Spurs,45,10850,1798,3736,0.481,417,1014,0.411,1381,2722,0.507,833,1020,0.817,419,1508,1927,1094,358,559,827,4846
2915,2017-1-26,Boston Celtics,45,10850,1758,3877,0.453,537,1466,0.366,1221,2411,0.506,789,965,0.818,425,1425,1850,1132,341,543,918,4842
2916,2017-1-26,Portland Trail Blazers,47,11430,1852,4073,0.455,473,1326,0.357,1379,2747,0.502,873,1116,0.782,458,1551,2009,1039,333,618,1013,5050
2917,2017-1-26,Washington Wizards,45,10875,1836,3873,0.474,384,1046,0.367,1452,2827,0.514,739,940,0.786,456,1462,1918,1043,383,618,957,4795
2918,2017-1-26,Oklahoma City Thunder,46,11140,1814,3973,0.457,388,1193,0.325,1426,2780,0.513,873,1177,0.742,516,1577,2093,988,355,668,944,4889
2919,2017-1-26,Phoenix Suns,45,10925,1762,3936,0.448,361,1046,0.345,1401,2890,0.485,893,1140,0.783,539,1485,2024,825,380,687,1118,4778
2920,2017-1-26,Brooklyn Nets,45,10850,1702,3855,0.442,505,1484,0.34,1197,2371,0.505,850,1073,0.792,393,1572,1965,957,322,742,942,4759
2921,2017-1-26,New York Knicks,47,11355,1873,4184,0.448,427,1179,0.362,1446,3005,0.481,780,990,0.788,582,1580,2162,1012,328,643,974,4953
2922,2017-1-26,Indiana Pacers,44,10660,1729,3744,0.462,365,997,0.366,1364,2747,0.497,812,997,0.814,372,1468,1840,987,383,609,848,4635
2923,2017-1-26,Charlotte Hornets,46,11115,1739,3947,0.441,440,1238,0.355,1299,2709,0.48,920,1155,0.797,433,1656,2089,1081,308,536,777,4838
2924,2017-1-26,Milwaukee Bucks,45,10850,1783,3764,0.474,384,1046,0.367,1399,2718,0.515,777,1018,0.763,435,1465,1900,1115,373,607,898,4727
2925,2017-1-26,Los Angeles Lakers,49,11760,1884,4243,0.444,450,1278,0.352,1434,2965,0.484,876,1146,0.764,568,1578,2146,1011,380,713,1001,5094
2926,2017-1-26,Minnesota Timberwolves,45,10850,1734,3761,0.461,350,1001,0.35,1384,2760,0.501,840,1069,0.786,519,1406,1925,1032,340,644,933,4658
2927,2017-1-26,Atlanta Hawks,46,11090,1782,3903,0.457,415,1189,0.349,1367,2714,0.504,774,1068,0.725,474,1525,1999,1113,395,681,820,4753
2928,2017-1-26,New Orleans Pelicans,46,11190,1772,4029,0.44,438,1227,0.357,1334,2802,0.476,771,1029,0.749,397,1644,2041,1051,351,546,850,4753
2929,2017-1-26,Sacramento Kings,45,10900,1678,3709,0.452,400,1121,0.357,1278,2588,0.494,869,1112,0.781,420,1414,1834,993,370,616,929,4625
2930,2017-1-26,Chicago Bulls,47,11305,1769,4072,0.434,304,965,0.315,1465,3107,0.472,927,1154,0.803,628,1594,2222,972,366,608,827,4769
2931,2017-1-26,Detroit Pistons,46,11090,1808,3989,0.453,366,1063,0.344,1442,2926,0.493,644,873,0.738,458,1565,2023,980,330,539,849,4626
2932,2017-1-26,Philadelphia 76ers,44,10660,1612,3698,0.436,465,1311,0.355,1147,2387,0.481,705,926,0.761,424,1488,1912,1025,344,723,958,4394
2933,2017-1-26,Orlando Magic,47,11330,1796,4075,0.441,415,1241,0.334,1381,2834,0.487,681,949,0.718,466,1558,2024,1044,318,600,872,4688
2934,2017-1-26,Memphis Grizzlies,47,11480,1694,3972,0.426,426,1225,0.348,1268,2747,0.462,871,1118,0.779,513,1545,2058,971,398,583,1114,4685
2935,2017-1-26,Utah Jazz,47,11305,1704,3678,0.463,443,1218,0.364,1261,2460,0.513,823,1101,0.748,415,1597,2012,910,310,615,899,4674
2936,2017-1-26,Miami Heat,46,11115,1741,3932,0.443,409,1180,0.347,1332,2752,0.484,670,993,0.675,477,1545,2022,968,316,569,949,4561
2937,2017-1-26,Dallas Mavericks,45,10875,1615,3696,0.437,482,1361,0.354,1133,2335,0.485,640,803,0.797,371,1345,1716,907,344,509,862,4352
2938,2017-1-27,Golden State Warriors,46,11115,2003,4015,0.499,548,1425,0.385,1455,2590,0.562,851,1080,0.788,415,1667,2082,1426,428,687,887,5405
2939,2017-1-27,Houston Rockets,49,11835,1986,4246,0.468,714,1945,0.367,1272,2301,0.553,917,1207,0.76,525,1620,2145,1257,404,726,966,5603
2940,2017-1-27,Denver Nuggets,45,10875,1819,3929,0.463,439,1214,0.362,1380,2715,0.508,876,1153,0.76,550,1545,2095,1095,296,673,905,4953
2941,2017-1-27,Cleveland Cavaliers,44,10635,1711,3762,0.455,567,1473,0.385,1144,2289,0.5,836,1114,0.75,452,1483,1935,960,326,595,801,4825
2942,2017-1-27,Toronto Raptors,46,11090,1832,3944,0.465,425,1138,0.373,1407,2806,0.501,958,1182,0.81,503,1456,1959,861,413,513,965,5047
2943,2017-1-27,Los Angeles Clippers,47,11330,1846,3942,0.468,488,1285,0.38,1358,2657,0.511,898,1198,0.75,444,1613,2057,1055,358,592,965,5078
2944,2017-1-27,San Antonio Spurs,45,10850,1798,3736,0.481,417,1014,0.411,1381,2722,0.507,833,1020,0.817,419,1508,1927,1094,358,559,827,4846
2945,2017-1-27,Boston Celtics,45,10850,1758,3877,0.453,537,1466,0.366,1221,2411,0.506,789,965,0.818,425,1425,1850,1132,341,543,918,4842
2946,2017-1-27,Portland Trail Blazers,47,11430,1852,4073,0.455,473,1326,0.357,1379,2747,0.502,873,1116,0.782,458,1551,2009,1039,333,618,1013,5050
2947,2017-1-27,Washington Wizards,45,10875,1836,3873,0.474,384,1046,0.367,1452,2827,0.514,739,940,0.786,456,1462,1918,1043,383,618,957,4795
2948,2017-1-27,Phoenix Suns,46,11165,1810,4025,0.45,371,1070,0.347,1439,2955,0.487,907,1157,0.784,547,1505,2052,846,388,698,1144,4898
2949,2017-1-27,Oklahoma City Thunder,47,11380,1851,4045,0.458,397,1215,0.327,1454,2830,0.514,899,1213,0.741,523,1613,2136,1001,362,684,961,4998
2950,2017-1-27,Brooklyn Nets,45,10850,1702,3855,0.442,505,1484,0.34,1197,2371,0.505,850,1073,0.792,393,1572,1965,957,322,742,942,4759
2951,2017-1-27,Indiana Pacers,45,10900,1771,3825,0.463,375,1015,0.369,1396,2810,0.497,827,1014,0.816,378,1506,1884,1008,390,627,870,4744
2952,2017-1-27,New York Knicks,47,11355,1873,4184,0.448,427,1179,0.362,1446,3005,0.481,780,990,0.788,582,1580,2162,1012,328,643,974,4953
2953,2017-1-27,Charlotte Hornets,46,11115,1739,3947,0.441,440,1238,0.355,1299,2709,0.48,920,1155,0.797,433,1656,2089,1081,308,536,777,4838
2954,2017-1-27,Milwaukee Bucks,45,10850,1783,3764,0.474,384,1046,0.367,1399,2718,0.515,777,1018,0.763,435,1465,1900,1115,373,607,898,4727
2955,2017-1-27,Los Angeles Lakers,50,12000,1920,4327,0.444,454,1292,0.351,1466,3035,0.483,888,1159,0.766,578,1616,2194,1024,385,725,1025,5182
2956,2017-1-27,Minnesota Timberwolves,46,11090,1770,3842,0.461,360,1028,0.35,1410,2814,0.501,861,1096,0.786,525,1434,1959,1059,353,655,953,4761
2957,2017-1-27,Atlanta Hawks,46,11090,1782,3903,0.457,415,1189,0.349,1367,2714,0.504,774,1068,0.725,474,1525,1999,1113,395,681,820,4753
2958,2017-1-27,New Orleans Pelicans,46,11190,1772,4029,0.44,438,1227,0.357,1334,2802,0.476,771,1029,0.749,397,1644,2041,1051,351,546,850,4753
2959,2017-1-27,Sacramento Kings,45,10900,1678,3709,0.452,400,1121,0.357,1278,2588,0.494,869,1112,0.781,420,1414,1834,993,370,616,929,4625
2960,2017-1-27,Chicago Bulls,47,11305,1769,4072,0.434,304,965,0.315,1465,3107,0.472,927,1154,0.803,628,1594,2222,972,366,608,827,4769
2961,2017-1-27,Detroit Pistons,46,11090,1808,3989,0.453,366,1063,0.344,1442,2926,0.493,644,873,0.738,458,1565,2023,980,330,539,849,4626
2962,2017-1-27,Philadelphia 76ers,44,10660,1612,3698,0.436,465,1311,0.355,1147,2387,0.481,705,926,0.761,424,1488,1912,1025,344,723,958,4394
2963,2017-1-27,Orlando Magic,47,11330,1796,4075,0.441,415,1241,0.334,1381,2834,0.487,681,949,0.718,466,1558,2024,1044,318,600,872,4688
2964,2017-1-27,Memphis Grizzlies,47,11480,1694,3972,0.426,426,1225,0.348,1268,2747,0.462,871,1118,0.779,513,1545,2058,971,398,583,1114,4685
2965,2017-1-27,Utah Jazz,48,11545,1737,3759,0.462,449,1244,0.361,1288,2515,0.512,847,1129,0.75,425,1631,2056,923,317,623,909,4770
2966,2017-1-27,Miami Heat,46,11115,1741,3932,0.443,409,1180,0.347,1332,2752,0.484,670,993,0.675,477,1545,2022,968,316,569,949,4561
2967,2017-1-27,Dallas Mavericks,46,11115,1653,3780,0.437,493,1387,0.355,1160,2393,0.485,651,816,0.798,379,1373,1752,924,354,521,888,4450
2968,2017-1-28,Golden State Warriors,46,11115,2003,4015,0.499,548,1425,0.385,1455,2590,0.562,851,1080,0.788,415,1667,2082,1426,428,687,887,5405
2969,2017-1-28,Houston Rockets,50,12075,2028,4327,0.469,726,1976,0.367,1302,2351,0.554,944,1235,0.764,531,1655,2186,1282,414,749,995,5726
2970,2017-1-28,Denver Nuggets,45,10875,1819,3929,0.463,439,1214,0.362,1380,2715,0.508,876,1153,0.76,550,1545,2095,1095,296,673,905,4953
2971,2017-1-28,Cleveland Cavaliers,45,10875,1760,3854,0.457,580,1509,0.384,1180,2345,0.503,849,1134,0.749,461,1521,1982,986,330,609,815,4949
2972,2017-1-28,Toronto Raptors,47,11330,1869,4028,0.464,435,1163,0.374,1434,2865,0.501,976,1205,0.81,515,1491,2006,881,422,527,984,5149
2973,2017-1-28,Los Angeles Clippers,47,11330,1846,3942,0.468,488,1285,0.38,1358,2657,0.511,898,1198,0.75,444,1613,2057,1055,358,592,965,5078
2974,2017-1-28,Boston Celtics,46,11090,1808,3966,0.456,553,1500,0.369,1255,2466,0.509,801,980,0.817,432,1465,1897,1171,349,553,935,4970
2975,2017-1-28,San Antonio Spurs,46,11090,1831,3821,0.479,429,1042,0.412,1402,2779,0.504,858,1049,0.818,431,1540,1971,1114,368,571,840,4949
2976,2017-1-28,Portland Trail Blazers,48,11670,1890,4154,0.455,489,1361,0.359,1401,2793,0.502,893,1137,0.785,466,1576,2042,1063,335,630,1039,5162
2977,2017-1-28,Washington Wizards,46,11115,1879,3962,0.474,397,1077,0.369,1482,2885,0.514,752,959,0.784,469,1501,1970,1069,395,636,981,4907
2978,2017-1-28,Phoenix Suns,46,11165,1810,4025,0.45,371,1070,0.347,1439,2955,0.487,907,1157,0.784,547,1505,2052,846,388,698,1144,4898
2979,2017-1-28,Oklahoma City Thunder,47,11380,1851,4045,0.458,397,1215,0.327,1454,2830,0.514,899,1213,0.741,523,1613,2136,1001,362,684,961,4998
2980,2017-1-28,Brooklyn Nets,46,11090,1745,3942,0.443,521,1517,0.343,1224,2425,0.505,864,1089,0.793,397,1605,2002,980,331,752,957,4875
2981,2017-1-28,Indiana Pacers,46,11165,1809,3903,0.463,385,1043,0.369,1424,2860,0.498,856,1047,0.818,385,1528,1913,1027,404,637,894,4859
2982,2017-1-28,New York Knicks,48,11595,1919,4280,0.448,436,1206,0.362,1483,3074,0.482,789,1003,0.787,593,1617,2210,1034,336,653,992,5063
2983,2017-1-28,Charlotte Hornets,47,11355,1779,4037,0.441,453,1275,0.355,1326,2762,0.48,934,1170,0.798,442,1694,2136,1099,313,549,793,4945
2984,2017-1-28,Milwaukee Bucks,46,11090,1814,3844,0.472,391,1069,0.366,1423,2775,0.513,794,1042,0.762,447,1496,1943,1134,379,626,920,4813
2985,2017-1-28,New Orleans Pelicans,47,11430,1820,4122,0.442,451,1257,0.359,1369,2865,0.478,781,1043,0.749,411,1683,2094,1080,359,560,870,4872
2986,2017-1-28,Los Angeles Lakers,50,12000,1920,4327,0.444,454,1292,0.351,1466,3035,0.483,888,1159,0.766,578,1616,2194,1024,385,725,1025,5182
2987,2017-1-28,Minnesota Timberwolves,46,11090,1770,3842,0.461,360,1028,0.35,1410,2814,0.501,861,1096,0.786,525,1434,1959,1059,353,655,953,4761
2988,2017-1-28,Atlanta Hawks,47,11330,1812,3986,0.455,424,1220,0.348,1388,2766,0.502,791,1093,0.724,482,1558,2040,1131,404,700,836,4839
2989,2017-1-28,Sacramento Kings,46,11165,1713,3779,0.453,413,1146,0.36,1300,2633,0.494,897,1148,0.781,430,1447,1877,1015,377,635,959,4736
2990,2017-1-28,Chicago Bulls,48,11545,1802,4150,0.434,307,978,0.314,1495,3172,0.471,946,1179,0.802,637,1628,2265,991,373,629,839,4857
2991,2017-1-28,Detroit Pistons,46,11090,1808,3989,0.453,366,1063,0.344,1442,2926,0.493,644,873,0.738,458,1565,2023,980,330,539,849,4626
2992,2017-1-28,Philadelphia 76ers,45,10900,1654,3776,0.438,475,1336,0.356,1179,2440,0.483,729,958,0.761,427,1514,1941,1054,358,745,983,4512
2993,2017-1-28,Memphis Grizzlies,48,11720,1731,4049,0.428,435,1251,0.348,1296,2798,0.463,897,1151,0.779,523,1577,2100,995,404,594,1133,4794
2994,2017-1-28,Orlando Magic,48,11570,1834,4162,0.441,424,1266,0.335,1410,2896,0.487,694,967,0.718,473,1589,2062,1073,325,611,887,4786
2995,2017-1-28,Utah Jazz,48,11545,1737,3759,0.462,449,1244,0.361,1288,2515,0.512,847,1129,0.75,425,1631,2056,923,317,623,909,4770
2996,2017-1-28,Miami Heat,47,11355,1782,4021,0.443,418,1204,0.347,1364,2817,0.484,679,1004,0.676,484,1578,2062,993,330,579,966,4661
2997,2017-1-28,Dallas Mavericks,46,11115,1653,3780,0.437,493,1387,0.355,1160,2393,0.485,651,816,0.798,379,1373,1752,924,354,521,888,4450
2998,2017-1-29,Golden State Warriors,47,11355,2060,4107,0.502,565,1459,0.387,1495,2648,0.565,864,1096,0.788,424,1706,2130,1461,437,698,904,5549
2999,2017-1-29,Houston Rockets,50,12075,2028,4327,0.469,726,1976,0.367,1302,2351,0.554,944,1235,0.764,531,1655,2186,1282,414,749,995,5726
3000,2017-1-29,Denver Nuggets,46,11115,1858,4009,0.463,447,1239,0.361,1411,2770,0.509,913,1195,0.764,559,1584,2143,1112,303,687,930,5076
3001,2017-1-29,Cleveland Cavaliers,45,10875,1760,3854,0.457,580,1509,0.384,1180,2345,0.503,849,1134,0.749,461,1521,1982,986,330,609,815,4949
3002,2017-1-29,Toronto Raptors,47,11330,1869,4028,0.464,435,1163,0.374,1434,2865,0.501,976,1205,0.81,515,1491,2006,881,422,527,984,5149
3003,2017-1-29,Boston Celtics,47,11355,1845,4055,0.455,567,1541,0.368,1278,2514,0.508,825,1010,0.817,441,1500,1941,1197,355,566,958,5082
3004,2017-1-29,Los Angeles Clippers,48,11570,1882,4024,0.468,500,1313,0.381,1382,2711,0.51,912,1220,0.748,452,1637,2089,1079,365,606,983,5176
3005,2017-1-29,San Antonio Spurs,46,11090,1831,3821,0.479,429,1042,0.412,1402,2779,0.504,858,1049,0.818,431,1540,1971,1114,368,571,840,4949
3006,2017-1-29,Portland Trail Blazers,48,11670,1890,4154,0.455,489,1361,0.359,1401,2793,0.502,893,1137,0.785,466,1576,2042,1063,335,630,1039,5162
3007,2017-1-29,Washington Wizards,46,11115,1879,3962,0.474,397,1077,0.369,1482,2885,0.514,752,959,0.784,469,1501,1970,1069,395,636,981,4907
3008,2017-1-29,Phoenix Suns,47,11405,1851,4116,0.45,377,1091,0.346,1474,3025,0.487,931,1189,0.783,558,1537,2095,866,397,708,1180,5010
3009,2017-1-29,Oklahoma City Thunder,47,11380,1851,4045,0.458,397,1215,0.327,1454,2830,0.514,899,1213,0.741,523,1613,2136,1001,362,684,961,4998
3010,2017-1-29,Brooklyn Nets,47,11330,1786,4027,0.444,528,1538,0.343,1258,2489,0.505,884,1114,0.794,402,1640,2042,1000,337,766,975,4984
3011,2017-1-29,Indiana Pacers,46,11165,1809,3903,0.463,385,1043,0.369,1424,2860,0.498,856,1047,0.818,385,1528,1913,1027,404,637,894,4859
3012,2017-1-29,New York Knicks,48,11595,1919,4280,0.448,436,1206,0.362,1483,3074,0.482,789,1003,0.787,593,1617,2210,1034,336,653,992,5063
3013,2017-1-29,Charlotte Hornets,48,11595,1815,4112,0.441,465,1312,0.354,1350,2800,0.482,956,1194,0.801,449,1721,2170,1123,317,560,818,5051
3014,2017-1-29,Milwaukee Bucks,47,11355,1851,3931,0.471,400,1090,0.367,1451,2841,0.511,819,1074,0.763,456,1534,1990,1157,385,641,945,4921
3015,2017-1-29,Minnesota Timberwolves,47,11330,1817,3935,0.462,369,1048,0.352,1448,2887,0.502,887,1128,0.786,538,1470,2008,1086,361,666,974,4890
3016,2017-1-29,New Orleans Pelicans,47,11430,1820,4122,0.442,451,1257,0.359,1369,2865,0.478,781,1043,0.749,411,1683,2094,1080,359,560,870,4872
3017,2017-1-29,Los Angeles Lakers,50,12000,1920,4327,0.444,454,1292,0.351,1466,3035,0.483,888,1159,0.766,578,1616,2194,1024,385,725,1025,5182
3018,2017-1-29,Sacramento Kings,47,11405,1754,3858,0.455,424,1173,0.361,1330,2685,0.495,913,1174,0.778,438,1477,1915,1042,383,644,982,4845
3019,2017-1-29,Atlanta Hawks,47,11330,1812,3986,0.455,424,1220,0.348,1388,2766,0.502,791,1093,0.724,482,1558,2040,1131,404,700,836,4839
3020,2017-1-29,Chicago Bulls,48,11545,1802,4150,0.434,307,978,0.314,1495,3172,0.471,946,1179,0.802,637,1628,2265,991,373,629,839,4857
3021,2017-1-29,Detroit Pistons,47,11330,1854,4078,0.455,370,1075,0.344,1484,3003,0.494,651,885,0.736,471,1594,2065,991,336,551,865,4729
3022,2017-1-29,Philadelphia 76ers,45,10900,1654,3776,0.438,475,1336,0.356,1179,2440,0.483,729,958,0.761,427,1514,1941,1054,358,745,983,4512
3023,2017-1-29,Memphis Grizzlies,49,11960,1772,4129,0.429,446,1277,0.349,1326,2852,0.465,906,1161,0.78,530,1601,2131,1008,412,601,1156,4896
3024,2017-1-29,Orlando Magic,48,11570,1834,4162,0.441,424,1266,0.335,1410,2896,0.487,694,967,0.718,473,1589,2062,1073,325,611,887,4786
3025,2017-1-29,Miami Heat,48,11595,1824,4101,0.445,432,1232,0.351,1392,2869,0.485,697,1027,0.679,493,1607,2100,1011,336,590,985,4777
3026,2017-1-29,Utah Jazz,49,11785,1766,3821,0.462,459,1269,0.362,1307,2552,0.512,874,1158,0.755,429,1658,2087,942,320,636,927,4865
3027,2017-1-29,Dallas Mavericks,46,11115,1653,3780,0.437,493,1387,0.355,1160,2393,0.485,651,816,0.798,379,1373,1752,924,354,521,888,4450
3028,2017-1-30,Golden State Warriors,48,11595,2096,4186,0.501,573,1485,0.386,1523,2701,0.564,897,1135,0.79,432,1737,2169,1489,450,716,922,5662
3029,2017-1-30,Houston Rockets,51,12315,2062,4410,0.468,737,2015,0.366,1325,2395,0.553,966,1260,0.767,542,1685,2227,1303,421,764,1019,5827
3030,2017-1-30,Denver Nuggets,46,11115,1858,4009,0.463,447,1239,0.361,1411,2770,0.509,913,1195,0.764,559,1584,2143,1112,303,687,930,5076
3031,2017-1-30,Cleveland Cavaliers,46,11115,1801,3946,0.456,588,1538,0.382,1213,2408,0.504,866,1156,0.749,469,1564,2033,1008,339,619,831,5056
3032,2017-1-30,Toronto Raptors,48,11570,1905,4107,0.464,447,1191,0.375,1458,2916,0.5,1005,1241,0.81,524,1522,2046,900,430,538,1004,5262
3033,2017-1-30,Boston Celtics,47,11355,1845,4055,0.455,567,1541,0.368,1278,2514,0.508,825,1010,0.817,441,1500,1941,1197,355,566,958,5082
3034,2017-1-30,Los Angeles Clippers,48,11570,1882,4024,0.468,500,1313,0.381,1382,2711,0.51,912,1220,0.748,452,1637,2089,1079,365,606,983,5176
3035,2017-1-30,Portland Trail Blazers,49,11910,1936,4247,0.456,499,1388,0.36,1437,2859,0.503,902,1149,0.785,475,1609,2084,1089,346,648,1063,5273
3036,2017-1-30,San Antonio Spurs,47,11330,1870,3904,0.479,437,1064,0.411,1433,2840,0.505,873,1072,0.814,436,1580,2016,1140,370,582,860,5050
3037,2017-1-30,Washington Wizards,47,11355,1924,4051,0.475,407,1098,0.371,1517,2953,0.514,759,969,0.783,479,1536,2015,1097,404,646,998,5014
3038,2017-1-30,Phoenix Suns,47,11405,1851,4116,0.45,377,1091,0.346,1474,3025,0.487,931,1189,0.783,558,1537,2095,866,397,708,1180,5010
3039,2017-1-30,New York Knicks,49,11935,1970,4408,0.447,454,1257,0.361,1516,3151,0.481,808,1026,0.788,608,1665,2273,1066,345,665,1031,5202
3040,2017-1-30,Brooklyn Nets,47,11330,1786,4027,0.444,528,1538,0.343,1258,2489,0.505,884,1114,0.794,402,1640,2042,1000,337,766,975,4984
3041,2017-1-30,Oklahoma City Thunder,48,11620,1888,4145,0.455,403,1241,0.325,1485,2904,0.511,910,1229,0.74,536,1655,2191,1021,367,700,980,5089
3042,2017-1-30,Indiana Pacers,47,11405,1856,3990,0.465,390,1064,0.367,1466,2926,0.501,877,1073,0.817,392,1563,1955,1055,413,647,915,4979
3043,2017-1-30,Charlotte Hornets,48,11595,1815,4112,0.441,465,1312,0.354,1350,2800,0.482,956,1194,0.801,449,1721,2170,1123,317,560,818,5051
3044,2017-1-30,Milwaukee Bucks,47,11355,1851,3931,0.471,400,1090,0.367,1451,2841,0.511,819,1074,0.763,456,1534,1990,1157,385,641,945,4921
3045,2017-1-30,Minnesota Timberwolves,47,11330,1817,3935,0.462,369,1048,0.352,1448,2887,0.502,887,1128,0.786,538,1470,2008,1086,361,666,974,4890
3046,2017-1-30,Atlanta Hawks,48,11670,1864,4105,0.454,434,1251,0.347,1430,2854,0.501,819,1133,0.723,499,1605,2104,1167,408,714,860,4981
3047,2017-1-30,Los Angeles Lakers,50,12000,1920,4327,0.444,454,1292,0.351,1466,3035,0.483,888,1159,0.766,578,1616,2194,1024,385,725,1025,5182
3048,2017-1-30,New Orleans Pelicans,48,11670,1858,4206,0.442,461,1289,0.358,1397,2917,0.479,789,1058,0.746,421,1715,2136,1105,367,574,882,4966
3049,2017-1-30,Sacramento Kings,47,11405,1754,3858,0.455,424,1173,0.361,1330,2685,0.495,913,1174,0.778,438,1477,1915,1042,383,644,982,4845
3050,2017-1-30,Chicago Bulls,49,11785,1847,4239,0.436,315,992,0.318,1532,3247,0.472,969,1207,0.803,647,1667,2314,1020,381,639,850,4978
3051,2017-1-30,Detroit Pistons,47,11330,1854,4078,0.455,370,1075,0.344,1484,3003,0.494,651,885,0.736,471,1594,2065,991,336,551,865,4729
3052,2017-1-30,Philadelphia 76ers,46,11140,1698,3875,0.438,485,1364,0.356,1213,2511,0.483,739,972,0.76,438,1546,1984,1080,366,757,1005,4620
3053,2017-1-30,Orlando Magic,49,11810,1876,4241,0.442,434,1289,0.337,1442,2952,0.488,714,993,0.719,479,1619,2098,1098,331,623,915,4900
3054,2017-1-30,Memphis Grizzlies,49,11960,1772,4129,0.429,446,1277,0.349,1326,2852,0.465,906,1161,0.78,530,1601,2131,1008,412,601,1156,4896
3055,2017-1-30,Miami Heat,48,11595,1824,4101,0.445,432,1232,0.351,1392,2869,0.485,697,1027,0.679,493,1607,2100,1011,336,590,985,4777
3056,2017-1-30,Utah Jazz,49,11785,1766,3821,0.462,459,1269,0.362,1307,2552,0.512,874,1158,0.755,429,1658,2087,942,320,636,927,4865
3057,2017-1-30,Dallas Mavericks,47,11355,1692,3867,0.438,505,1421,0.355,1187,2446,0.485,666,832,0.8,385,1408,1793,944,360,527,907,4555
3058,2017-2-1,Golden State Warriors,48,11595,2096,4186,0.501,573,1485,0.386,1523,2701,0.564,897,1135,0.79,432,1737,2169,1489,450,716,922,5662
3059,2017-2-1,Houston Rockets,52,12555,2100,4495,0.467,751,2060,0.365,1349,2435,0.554,981,1282,0.765,553,1734,2287,1331,425,778,1043,5932
3060,2017-2-1,Denver Nuggets,47,11355,1899,4108,0.462,462,1266,0.365,1437,2842,0.506,932,1218,0.765,579,1615,2194,1138,315,698,948,5192
3061,2017-2-1,Cleveland Cavaliers,47,11355,1836,4021,0.457,600,1570,0.382,1236,2451,0.504,881,1177,0.749,475,1600,2075,1025,345,636,848,5153
3062,2017-2-1,Toronto Raptors,49,11835,1948,4201,0.464,457,1222,0.374,1491,2979,0.501,1017,1256,0.81,537,1563,2100,919,435,552,1023,5370
3063,2017-2-1,Boston Celtics,48,11595,1881,4137,0.455,580,1573,0.369,1301,2564,0.507,853,1043,0.818,447,1538,1985,1220,361,575,976,5195
3064,2017-2-1,Portland Trail Blazers,50,12150,1978,4340,0.456,510,1419,0.359,1468,2921,0.503,922,1172,0.787,486,1649,2135,1112,354,656,1081,5388
3065,2017-2-1,Los Angeles Clippers,48,11570,1882,4024,0.468,500,1313,0.381,1382,2711,0.51,912,1220,0.748,452,1637,2089,1079,365,606,983,5176
3066,2017-2-1,San Antonio Spurs,48,11570,1907,3990,0.478,444,1085,0.409,1463,2905,0.504,900,1110,0.811,446,1620,2066,1156,382,599,885,5158
3067,2017-2-1,Washington Wizards,48,11595,1973,4139,0.477,414,1120,0.37,1559,3019,0.516,771,984,0.784,488,1573,2061,1124,408,658,1023,5131
3068,2017-2-1,Phoenix Suns,48,11645,1882,4190,0.449,382,1110,0.344,1500,3080,0.487,960,1228,0.782,571,1566,2137,877,405,725,1199,5106
3069,2017-2-1,New York Knicks,50,12175,2004,4501,0.445,459,1281,0.358,1545,3220,0.48,836,1061,0.788,630,1694,2324,1084,353,677,1048,5303
3070,2017-2-1,Indiana Pacers,47,11405,1856,3990,0.465,390,1064,0.367,1466,2926,0.501,877,1073,0.817,392,1563,1955,1055,413,647,915,4979
3071,2017-2-1,Brooklyn Nets,48,11570,1823,4114,0.443,532,1564,0.34,1291,2550,0.506,902,1136,0.794,417,1678,2095,1016,344,782,998,5080
3072,2017-2-1,Oklahoma City Thunder,49,11860,1918,4230,0.453,410,1269,0.323,1508,2961,0.509,937,1261,0.743,548,1693,2241,1042,379,720,1010,5183
3073,2017-2-1,Charlotte Hornets,49,11835,1848,4195,0.441,476,1343,0.354,1372,2852,0.481,977,1219,0.801,452,1760,2212,1143,320,569,831,5149
3074,2017-2-1,Milwaukee Bucks,47,11355,1851,3931,0.471,400,1090,0.367,1451,2841,0.511,819,1074,0.763,456,1534,1990,1157,385,641,945,4921
3075,2017-2-1,Minnesota Timberwolves,48,11595,1857,4026,0.461,381,1077,0.354,1476,2949,0.501,906,1154,0.785,547,1511,2058,1115,364,677,994,5001
3076,2017-2-1,Los Angeles Lakers,51,12240,1967,4416,0.445,466,1318,0.354,1501,3098,0.485,902,1177,0.766,588,1650,2238,1049,392,740,1041,5302
3077,2017-2-1,Atlanta Hawks,48,11670,1864,4105,0.454,434,1251,0.347,1430,2854,0.501,819,1133,0.723,499,1605,2104,1167,408,714,860,4981
3078,2017-2-1,New Orleans Pelicans,49,11935,1898,4300,0.441,473,1319,0.359,1425,2981,0.478,803,1077,0.746,434,1749,2183,1122,378,585,898,5072
3079,2017-2-1,Sacramento Kings,49,11885,1825,4018,0.454,445,1231,0.361,1380,2787,0.495,952,1229,0.775,457,1536,1993,1095,399,675,1027,5047
3080,2017-2-1,Chicago Bulls,49,11785,1847,4239,0.436,315,992,0.318,1532,3247,0.472,969,1207,0.803,647,1667,2314,1020,381,639,850,4978
3081,2017-2-1,Philadelphia 76ers,47,11380,1743,3958,0.44,496,1395,0.356,1247,2563,0.487,760,998,0.762,447,1566,2013,1112,379,771,1023,4742
3082,2017-2-1,Detroit Pistons,48,11570,1897,4175,0.454,373,1102,0.338,1524,3073,0.496,671,914,0.734,483,1633,2116,1009,342,558,888,4838
3083,2017-2-1,Memphis Grizzlies,50,12200,1811,4209,0.43,462,1305,0.354,1349,2904,0.465,927,1185,0.782,540,1635,2175,1033,425,618,1183,5011
3084,2017-2-1,Orlando Magic,50,12075,1917,4337,0.442,444,1324,0.335,1473,3013,0.489,727,1012,0.718,490,1656,2146,1120,338,634,940,5005
3085,2017-2-1,Miami Heat,49,11835,1863,4183,0.445,443,1258,0.352,1420,2925,0.485,712,1050,0.678,498,1636,2134,1033,345,601,1003,4881
3086,2017-2-1,Utah Jazz,49,11785,1766,3821,0.462,459,1269,0.362,1307,2552,0.512,874,1158,0.755,429,1658,2087,942,320,636,927,4865
3087,2017-2-1,Dallas Mavericks,48,11595,1731,3953,0.438,514,1453,0.354,1217,2500,0.487,683,850,0.804,394,1439,1833,963,371,536,924,4659
3088,2017-2-2,Golden State Warriors,49,11835,2143,4282,0.5,594,1533,0.387,1549,2749,0.563,908,1149,0.79,441,1775,2216,1524,459,726,940,5788
3089,2017-2-2,Houston Rockets,52,12555,2100,4495,0.467,751,2060,0.365,1349,2435,0.554,981,1282,0.765,553,1734,2287,1331,425,778,1043,5932
3090,2017-2-2,Denver Nuggets,48,11595,1931,4188,0.461,471,1291,0.365,1460,2897,0.504,958,1253,0.765,590,1649,2239,1163,322,715,965,5291
3091,2017-2-2,Cleveland Cavaliers,48,11595,1884,4110,0.458,615,1607,0.383,1269,2503,0.507,895,1199,0.746,487,1636,2123,1062,355,646,861,5278
3092,2017-2-2,Toronto Raptors,50,12075,1989,4279,0.465,465,1253,0.371,1524,3026,0.504,1031,1281,0.805,545,1596,2141,936,441,567,1052,5474
3093,2017-2-2,Los Angeles Clippers,49,11810,1926,4109,0.469,505,1332,0.379,1421,2777,0.512,943,1258,0.75,460,1675,2135,1099,374,616,1011,5300
3094,2017-2-2,Boston Celtics,49,11835,1917,4224,0.454,592,1609,0.368,1325,2615,0.507,878,1073,0.818,459,1565,2024,1244,367,584,997,5304
3095,2017-2-2,Portland Trail Blazers,50,12150,1978,4340,0.456,510,1419,0.359,1468,2921,0.503,922,1172,0.787,486,1649,2135,1112,354,656,1081,5388
3096,2017-2-2,San Antonio Spurs,48,11570,1907,3990,0.478,444,1085,0.409,1463,2905,0.504,900,1110,0.811,446,1620,2066,1156,382,599,885,5158
3097,2017-2-2,Washington Wizards,48,11595,1973,4139,0.477,414,1120,0.37,1559,3019,0.516,771,984,0.784,488,1573,2061,1124,408,658,1023,5131
3098,2017-2-2,Phoenix Suns,49,11885,1921,4286,0.448,389,1130,0.344,1532,3156,0.485,989,1263,0.783,588,1593,2181,898,410,737,1226,5220
3099,2017-2-2,Indiana Pacers,48,11645,1889,4059,0.465,399,1084,0.368,1490,2975,0.501,900,1099,0.819,397,1596,1993,1080,418,664,938,5077
3100,2017-2-2,New York Knicks,51,12415,2039,4600,0.443,465,1308,0.356,1574,3292,0.478,855,1092,0.783,651,1731,2382,1107,369,690,1066,5398
3101,2017-2-2,Oklahoma City Thunder,50,12100,1956,4330,0.452,420,1306,0.322,1536,3024,0.508,951,1278,0.744,559,1719,2278,1059,385,729,1033,5283
3102,2017-2-2,Brooklyn Nets,49,11810,1860,4202,0.443,537,1589,0.338,1323,2613,0.506,913,1152,0.793,429,1715,2144,1033,348,802,1022,5170
3103,2017-2-2,Charlotte Hornets,50,12075,1887,4283,0.441,485,1374,0.353,1402,2909,0.482,1001,1245,0.804,458,1799,2257,1176,324,579,845,5260
3104,2017-2-2,Milwaukee Bucks,48,11595,1883,4004,0.47,409,1113,0.367,1474,2891,0.51,834,1099,0.759,465,1564,2029,1176,395,658,966,5009
3105,2017-2-2,Los Angeles Lakers,51,12240,1967,4416,0.445,466,1318,0.354,1501,3098,0.485,902,1177,0.766,588,1650,2238,1049,392,740,1041,5302
3106,2017-2-2,Minnesota Timberwolves,49,11835,1898,4120,0.461,388,1098,0.353,1510,3022,0.5,914,1164,0.785,559,1537,2096,1141,371,690,1013,5098
3107,2017-2-2,Atlanta Hawks,49,11910,1898,4191,0.453,441,1277,0.345,1457,2914,0.5,837,1154,0.725,508,1639,2147,1180,418,729,874,5074
3108,2017-2-2,New Orleans Pelicans,50,12175,1939,4382,0.442,478,1340,0.357,1461,3042,0.48,814,1091,0.746,437,1781,2218,1143,384,599,913,5170
3109,2017-2-2,Sacramento Kings,49,11885,1825,4018,0.454,445,1231,0.361,1380,2787,0.495,952,1229,0.775,457,1536,1993,1095,399,675,1027,5047
3110,2017-2-2,Chicago Bulls,50,12025,1896,4320,0.439,321,1007,0.319,1575,3313,0.475,993,1237,0.803,651,1705,2356,1045,388,648,869,5106
3111,2017-2-2,Detroit Pistons,49,11810,1945,4263,0.456,383,1128,0.34,1562,3135,0.498,683,931,0.734,488,1670,2158,1037,351,568,901,4956
3112,2017-2-2,Philadelphia 76ers,48,11620,1778,4035,0.441,502,1417,0.354,1276,2618,0.487,779,1024,0.761,452,1600,2052,1133,384,784,1044,4837
3113,2017-2-2,Memphis Grizzlies,51,12440,1856,4301,0.432,476,1335,0.357,1380,2966,0.465,942,1205,0.782,551,1670,2221,1061,431,626,1207,5130
3114,2017-2-2,Orlando Magic,51,12315,1948,4414,0.441,450,1348,0.334,1498,3066,0.489,747,1040,0.718,497,1684,2181,1137,350,648,962,5093
3115,2017-2-2,Miami Heat,50,12075,1908,4276,0.446,455,1290,0.353,1453,2986,0.487,726,1069,0.679,508,1673,2181,1056,355,613,1021,4997
3116,2017-2-2,Utah Jazz,50,12025,1802,3899,0.462,470,1298,0.362,1332,2601,0.512,895,1185,0.755,440,1693,2133,964,331,651,950,4969
3117,2017-2-2,Dallas Mavericks,49,11835,1771,4039,0.438,524,1479,0.354,1247,2560,0.487,706,878,0.804,409,1475,1884,985,381,547,943,4772
3118,2017-2-3,Golden State Warriors,50,12075,2195,4381,0.501,608,1567,0.388,1587,2814,0.564,923,1167,0.791,456,1806,2262,1562,469,737,966,5921
3119,2017-2-3,Houston Rockets,53,12795,2135,4588,0.465,764,2111,0.362,1371,2477,0.553,1006,1315,0.765,560,1764,2324,1350,436,787,1063,6040
3120,2017-2-3,Denver Nuggets,48,11595,1931,4188,0.461,471,1291,0.365,1460,2897,0.504,958,1253,0.765,590,1649,2239,1163,322,715,965,5291
3121,2017-2-3,Cleveland Cavaliers,48,11595,1884,4110,0.458,615,1607,0.383,1269,2503,0.507,895,1199,0.746,487,1636,2123,1062,355,646,861,5278
3122,2017-2-3,Toronto Raptors,50,12075,1989,4279,0.465,465,1253,0.371,1524,3026,0.504,1031,1281,0.805,545,1596,2141,936,441,567,1052,5474
3123,2017-2-3,Los Angeles Clippers,50,12050,1966,4189,0.469,515,1357,0.38,1451,2832,0.512,973,1297,0.75,469,1703,2172,1123,381,631,1029,5420
3124,2017-2-3,Boston Celtics,49,11835,1917,4224,0.454,592,1609,0.368,1325,2615,0.507,878,1073,0.818,459,1565,2024,1244,367,584,997,5304
3125,2017-2-3,Portland Trail Blazers,50,12150,1978,4340,0.456,510,1419,0.359,1468,2921,0.503,922,1172,0.787,486,1649,2135,1112,354,656,1081,5388
3126,2017-2-3,San Antonio Spurs,49,11810,1945,4079,0.477,450,1106,0.407,1495,2973,0.503,920,1137,0.809,460,1665,2125,1182,395,618,905,5260
3127,2017-2-3,Washington Wizards,49,11835,2017,4235,0.476,426,1153,0.369,1591,3082,0.516,787,1005,0.783,500,1606,2106,1151,419,668,1042,5247
3128,2017-2-3,Phoenix Suns,49,11885,1921,4286,0.448,389,1130,0.344,1532,3156,0.485,989,1263,0.783,588,1593,2181,898,410,737,1226,5220
3129,2017-2-3,Indiana Pacers,48,11645,1889,4059,0.465,399,1084,0.368,1490,2975,0.501,900,1099,0.819,397,1596,1993,1080,418,664,938,5077
3130,2017-2-3,New York Knicks,51,12415,2039,4600,0.443,465,1308,0.356,1574,3292,0.478,855,1092,0.783,651,1731,2382,1107,369,690,1066,5398
3131,2017-2-3,Oklahoma City Thunder,50,12100,1956,4330,0.452,420,1306,0.322,1536,3024,0.508,951,1278,0.744,559,1719,2278,1059,385,729,1033,5283
3132,2017-2-3,Brooklyn Nets,49,11810,1860,4202,0.443,537,1589,0.338,1323,2613,0.506,913,1152,0.793,429,1715,2144,1033,348,802,1022,5170
3133,2017-2-3,Charlotte Hornets,50,12075,1887,4283,0.441,485,1374,0.353,1402,2909,0.482,1001,1245,0.804,458,1799,2257,1176,324,579,845,5260
3134,2017-2-3,Milwaukee Bucks,48,11595,1883,4004,0.47,409,1113,0.367,1474,2891,0.51,834,1099,0.759,465,1564,2029,1176,395,658,966,5009
3135,2017-2-3,Los Angeles Lakers,52,12480,2007,4503,0.446,478,1357,0.352,1529,3146,0.486,918,1199,0.766,600,1685,2285,1068,398,760,1064,5410
3136,2017-2-3,Minnesota Timberwolves,49,11835,1898,4120,0.461,388,1098,0.353,1510,3022,0.5,914,1164,0.785,559,1537,2096,1141,371,690,1013,5098
3137,2017-2-3,Atlanta Hawks,50,12150,1942,4276,0.454,449,1307,0.344,1493,2969,0.503,854,1177,0.726,516,1687,2203,1206,426,749,894,5187
3138,2017-2-3,New Orleans Pelicans,50,12175,1939,4382,0.442,478,1340,0.357,1461,3042,0.48,814,1091,0.746,437,1781,2218,1143,384,599,913,5170
3139,2017-2-3,Sacramento Kings,49,11885,1825,4018,0.454,445,1231,0.361,1380,2787,0.495,952,1229,0.775,457,1536,1993,1095,399,675,1027,5047
3140,2017-2-3,Chicago Bulls,50,12025,1896,4320,0.439,321,1007,0.319,1575,3313,0.475,993,1237,0.803,651,1705,2356,1045,388,648,869,5106
3141,2017-2-3,Detroit Pistons,49,11810,1945,4263,0.456,383,1128,0.34,1562,3135,0.498,683,931,0.734,488,1670,2158,1037,351,568,901,4956
3142,2017-2-3,Memphis Grizzlies,51,12440,1856,4301,0.432,476,1335,0.357,1380,2966,0.465,942,1205,0.782,551,1670,2221,1061,431,626,1207,5130
3143,2017-2-3,Philadelphia 76ers,49,11860,1808,4123,0.439,511,1442,0.354,1297,2681,0.484,796,1047,0.76,464,1634,2098,1154,394,805,1067,4923
3144,2017-2-3,Orlando Magic,51,12315,1948,4414,0.441,450,1348,0.334,1498,3066,0.489,747,1040,0.718,497,1684,2181,1137,350,648,962,5093
3145,2017-2-3,Miami Heat,50,12075,1908,4276,0.446,455,1290,0.353,1453,2986,0.487,726,1069,0.679,508,1673,2181,1056,355,613,1021,4997
3146,2017-2-3,Utah Jazz,50,12025,1802,3899,0.462,470,1298,0.362,1332,2601,0.512,895,1185,0.755,440,1693,2133,964,331,651,950,4969
3147,2017-2-3,Dallas Mavericks,49,11835,1771,4039,0.438,524,1479,0.354,1247,2560,0.487,706,878,0.804,409,1475,1884,985,381,547,943,4772
3148,2017-2-4,Golden State Warriors,50,12075,2195,4381,0.501,608,1567,0.388,1587,2814,0.564,923,1167,0.791,456,1806,2262,1562,469,737,966,5921
3149,2017-2-4,Houston Rockets,54,13060,2179,4686,0.465,780,2154,0.362,1399,2532,0.553,1023,1340,0.763,568,1804,2372,1374,443,798,1086,6161
3150,2017-2-4,Denver Nuggets,49,11835,1971,4277,0.461,480,1319,0.364,1491,2958,0.504,990,1297,0.763,608,1679,2287,1194,330,729,978,5412
3151,2017-2-4,Cleveland Cavaliers,48,11595,1884,4110,0.458,615,1607,0.383,1269,2503,0.507,895,1199,0.746,487,1636,2123,1062,355,646,861,5278
3152,2017-2-4,Toronto Raptors,51,12315,2023,4366,0.463,475,1281,0.371,1548,3085,0.502,1047,1302,0.804,558,1627,2185,951,446,578,1073,5568
3153,2017-2-4,Los Angeles Clippers,50,12050,1966,4189,0.469,515,1357,0.38,1451,2832,0.512,973,1297,0.75,469,1703,2172,1123,381,631,1029,5420
3154,2017-2-4,Boston Celtics,50,12075,1956,4306,0.454,605,1644,0.368,1351,2662,0.508,900,1101,0.817,466,1605,2071,1272,375,600,1016,5417
3155,2017-2-4,Portland Trail Blazers,51,12390,2018,4428,0.456,519,1449,0.358,1499,2979,0.503,937,1192,0.786,498,1681,2179,1128,357,665,1100,5492
3156,2017-2-4,San Antonio Spurs,49,11810,1945,4079,0.477,450,1106,0.407,1495,2973,0.503,920,1137,0.809,460,1665,2125,1182,395,618,905,5260
3157,2017-2-4,Washington Wizards,49,11835,2017,4235,0.476,426,1153,0.369,1591,3082,0.516,787,1005,0.783,500,1606,2106,1151,419,668,1042,5247
3158,2017-2-4,Phoenix Suns,50,12125,1953,4363,0.448,401,1159,0.346,1552,3204,0.484,1018,1298,0.784,594,1626,2220,909,417,748,1247,5325
3159,2017-2-4,Oklahoma City Thunder,51,12340,1994,4410,0.452,433,1332,0.325,1561,3078,0.507,976,1311,0.744,575,1750,2325,1080,392,749,1054,5397
3160,2017-2-4,Indiana Pacers,49,11885,1926,4145,0.465,407,1104,0.369,1519,3041,0.5,924,1130,0.818,409,1633,2042,1100,429,678,957,5183
3161,2017-2-4,New York Knicks,51,12415,2039,4600,0.443,465,1308,0.356,1574,3292,0.478,855,1092,0.783,651,1731,2382,1107,369,690,1066,5398
3162,2017-2-4,Brooklyn Nets,50,12050,1892,4288,0.441,548,1617,0.339,1344,2671,0.503,935,1175,0.796,438,1750,2188,1053,355,821,1044,5267
3163,2017-2-4,Charlotte Hornets,50,12075,1887,4283,0.441,485,1374,0.353,1402,2909,0.482,1001,1245,0.804,458,1799,2257,1176,324,579,845,5260
3164,2017-2-4,Milwaukee Bucks,49,11835,1928,4087,0.472,418,1137,0.368,1510,2950,0.512,852,1122,0.759,471,1596,2067,1202,404,676,992,5126
3165,2017-2-4,Los Angeles Lakers,53,12720,2044,4597,0.445,492,1395,0.353,1552,3202,0.485,937,1225,0.765,615,1722,2337,1092,407,772,1087,5517
3166,2017-2-4,Minnesota Timberwolves,50,12075,1942,4209,0.461,393,1115,0.352,1549,3094,0.501,929,1183,0.785,570,1566,2136,1166,376,703,1032,5206
3167,2017-2-4,Atlanta Hawks,50,12150,1942,4276,0.454,449,1307,0.344,1493,2969,0.503,854,1177,0.726,516,1687,2203,1206,426,749,894,5187
3168,2017-2-4,New Orleans Pelicans,50,12175,1939,4382,0.442,478,1340,0.357,1461,3042,0.48,814,1091,0.746,437,1781,2218,1143,384,599,913,5170
3169,2017-2-4,Sacramento Kings,50,12125,1863,4103,0.454,455,1258,0.362,1408,2845,0.495,969,1251,0.775,463,1573,2036,1118,404,688,1052,5150
3170,2017-2-4,Chicago Bulls,51,12290,1944,4420,0.44,329,1032,0.319,1615,3388,0.477,1006,1255,0.802,665,1744,2409,1075,395,662,892,5223
3171,2017-2-4,Detroit Pistons,50,12050,1989,4361,0.456,394,1154,0.341,1595,3207,0.497,700,953,0.735,506,1701,2207,1061,358,578,915,5072
3172,2017-2-4,Memphis Grizzlies,52,12680,1896,4384,0.432,479,1354,0.354,1417,3030,0.468,961,1227,0.783,559,1691,2250,1082,441,638,1235,5232
3173,2017-2-4,Philadelphia 76ers,49,11860,1808,4123,0.439,511,1442,0.354,1297,2681,0.484,796,1047,0.76,464,1634,2098,1154,394,805,1067,4923
3174,2017-2-4,Orlando Magic,52,12555,1985,4494,0.442,455,1362,0.334,1530,3132,0.489,770,1072,0.718,508,1719,2227,1159,354,659,978,5195
3175,2017-2-4,Miami Heat,50,12075,1908,4276,0.446,455,1290,0.353,1453,2986,0.487,726,1069,0.679,508,1673,2181,1056,355,613,1021,4997
3176,2017-2-4,Utah Jazz,50,12025,1802,3899,0.462,470,1298,0.362,1332,2601,0.512,895,1185,0.755,440,1693,2133,964,331,651,950,4969
3177,2017-2-4,Dallas Mavericks,50,12075,1807,4115,0.439,541,1510,0.358,1266,2605,0.486,725,901,0.805,411,1509,1920,1000,384,551,967,4880
3178,2017-2-5,Golden State Warriors,51,12340,2231,4468,0.499,623,1611,0.387,1608,2857,0.563,942,1191,0.791,463,1839,2302,1584,479,754,983,6027
3179,2017-2-5,Houston Rockets,54,13060,2179,4686,0.465,780,2154,0.362,1399,2532,0.553,1023,1340,0.763,568,1804,2372,1374,443,798,1086,6161
3180,2017-2-5,Denver Nuggets,50,12075,2012,4369,0.461,490,1345,0.364,1522,3024,0.503,995,1307,0.761,624,1705,2329,1216,337,750,997,5509
3181,2017-2-5,Cleveland Cavaliers,49,11835,1925,4194,0.459,631,1647,0.383,1294,2547,0.508,908,1217,0.746,499,1673,2172,1082,358,661,880,5389
3182,2017-2-5,Toronto Raptors,51,12315,2023,4366,0.463,475,1281,0.371,1548,3085,0.502,1047,1302,0.804,558,1627,2185,951,446,578,1073,5568
3183,2017-2-5,Los Angeles Clippers,50,12050,1966,4189,0.469,515,1357,0.38,1451,2832,0.512,973,1297,0.75,469,1703,2172,1123,381,631,1029,5420
3184,2017-2-5,Boston Celtics,50,12075,1956,4306,0.454,605,1644,0.368,1351,2662,0.508,900,1101,0.817,466,1605,2071,1272,375,600,1016,5417
3185,2017-2-5,Portland Trail Blazers,51,12390,2018,4428,0.456,519,1449,0.358,1499,2979,0.503,937,1192,0.786,498,1681,2179,1128,357,665,1100,5492
3186,2017-2-5,San Antonio Spurs,50,12050,1990,4158,0.479,460,1127,0.408,1530,3031,0.505,941,1163,0.809,467,1696,2163,1211,408,632,920,5381
3187,2017-2-5,Washington Wizards,50,12075,2055,4318,0.476,436,1184,0.368,1619,3134,0.517,806,1027,0.785,507,1645,2152,1171,429,680,1061,5352
3188,2017-2-5,Phoenix Suns,51,12365,1991,4454,0.447,412,1187,0.347,1579,3267,0.483,1043,1328,0.785,608,1652,2260,931,426,764,1275,5437
3189,2017-2-5,Oklahoma City Thunder,51,12340,1994,4410,0.452,433,1332,0.325,1561,3078,0.507,976,1311,0.744,575,1750,2325,1080,392,749,1054,5397
3190,2017-2-5,Indiana Pacers,50,12125,1970,4236,0.465,414,1128,0.367,1556,3108,0.501,934,1145,0.816,416,1667,2083,1122,440,684,974,5288
3191,2017-2-5,New York Knicks,52,12655,2078,4686,0.443,477,1339,0.356,1601,3347,0.478,869,1120,0.776,664,1760,2424,1130,378,700,1086,5502
3192,2017-2-5,Milwaukee Bucks,50,12075,1980,4169,0.475,425,1154,0.368,1555,3015,0.516,878,1157,0.759,480,1631,2111,1231,413,692,1017,5263
3193,2017-2-5,Brooklyn Nets,50,12050,1892,4288,0.441,548,1617,0.339,1344,2671,0.503,935,1175,0.796,438,1750,2188,1053,355,821,1044,5267
3194,2017-2-5,Charlotte Hornets,51,12315,1922,4365,0.44,498,1407,0.354,1424,2958,0.481,1016,1263,0.804,461,1834,2295,1196,331,588,865,5358
3195,2017-2-5,Los Angeles Lakers,53,12720,2044,4597,0.445,492,1395,0.353,1552,3202,0.485,937,1225,0.765,615,1722,2337,1092,407,772,1087,5517
3196,2017-2-5,Minnesota Timberwolves,51,12315,1977,4293,0.461,403,1141,0.353,1574,3152,0.499,948,1207,0.785,586,1595,2181,1188,380,715,1059,5305
3197,2017-2-5,Atlanta Hawks,51,12390,1983,4354,0.455,459,1335,0.344,1524,3019,0.505,875,1204,0.727,526,1725,2251,1234,434,764,914,5300
3198,2017-2-5,New Orleans Pelicans,51,12415,1976,4466,0.442,483,1357,0.356,1493,3109,0.48,826,1113,0.742,446,1814,2260,1161,388,614,929,5261
3199,2017-2-5,Sacramento Kings,51,12390,1906,4191,0.455,462,1281,0.361,1444,2910,0.496,985,1270,0.776,471,1611,2082,1143,415,704,1070,5259
3200,2017-2-5,Chicago Bulls,51,12290,1944,4420,0.44,329,1032,0.319,1615,3388,0.477,1006,1255,0.802,665,1744,2409,1075,395,662,892,5223
3201,2017-2-5,Detroit Pistons,51,12290,2020,4436,0.455,400,1171,0.342,1620,3265,0.496,716,973,0.736,514,1736,2250,1079,360,599,928,5156
3202,2017-2-5,Memphis Grizzlies,53,12920,1928,4461,0.432,489,1382,0.354,1439,3079,0.467,994,1266,0.785,572,1720,2292,1099,448,647,1260,5339
3203,2017-2-5,Philadelphia 76ers,50,12100,1843,4207,0.438,517,1465,0.353,1326,2742,0.484,822,1078,0.763,470,1661,2131,1174,404,820,1088,5025
3204,2017-2-5,Miami Heat,51,12315,1956,4358,0.449,467,1312,0.356,1489,3046,0.489,743,1092,0.68,518,1712,2230,1084,361,634,1045,5122
3205,2017-2-5,Orlando Magic,53,12795,2012,4572,0.44,462,1389,0.333,1550,3183,0.487,795,1100,0.723,515,1745,2260,1176,362,672,997,5281
3206,2017-2-5,Utah Jazz,51,12265,1840,3980,0.462,483,1331,0.363,1357,2649,0.512,911,1209,0.754,451,1733,2184,980,336,664,968,5074
3207,2017-2-5,Dallas Mavericks,50,12075,1807,4115,0.439,541,1510,0.358,1266,2605,0.486,725,901,0.805,411,1509,1920,1000,384,551,967,4880
3208,2017-2-6,Golden State Warriors,51,12340,2231,4468,0.499,623,1611,0.387,1608,2857,0.563,942,1191,0.791,463,1839,2302,1584,479,754,983,6027
3209,2017-2-6,Houston Rockets,54,13060,2179,4686,0.465,780,2154,0.362,1399,2532,0.553,1023,1340,0.763,568,1804,2372,1374,443,798,1086,6161
3210,2017-2-6,Denver Nuggets,50,12075,2012,4369,0.461,490,1345,0.364,1522,3024,0.503,995,1307,0.761,624,1705,2329,1216,337,750,997,5509
3211,2017-2-6,Cleveland Cavaliers,49,11835,1925,4194,0.459,631,1647,0.383,1294,2547,0.508,908,1217,0.746,499,1673,2172,1082,358,661,880,5389
3212,2017-2-6,Toronto Raptors,52,12555,2063,4453,0.463,480,1300,0.369,1583,3153,0.502,1065,1322,0.806,566,1664,2230,972,454,589,1091,5671
3213,2017-2-6,Los Angeles Clippers,51,12290,2001,4273,0.468,525,1386,0.379,1476,2887,0.511,995,1325,0.751,477,1741,2218,1145,385,644,1042,5522
3214,2017-2-6,Boston Celtics,51,12315,1993,4394,0.454,621,1696,0.366,1372,2698,0.509,917,1121,0.818,475,1641,2116,1296,384,611,1037,5524
3215,2017-2-6,San Antonio Spurs,50,12050,1990,4158,0.479,460,1127,0.408,1530,3031,0.505,941,1163,0.809,467,1696,2163,1211,408,632,920,5381
3216,2017-2-6,Portland Trail Blazers,52,12630,2053,4515,0.455,529,1477,0.358,1524,3038,0.502,956,1213,0.788,509,1714,2223,1143,363,677,1122,5591
3217,2017-2-6,Washington Wizards,50,12075,2055,4318,0.476,436,1184,0.368,1619,3134,0.517,806,1027,0.785,507,1645,2152,1171,429,680,1061,5352
3218,2017-2-6,Phoenix Suns,51,12365,1991,4454,0.447,412,1187,0.347,1579,3267,0.483,1043,1328,0.785,608,1652,2260,931,426,764,1275,5437
3219,2017-2-6,Oklahoma City Thunder,52,12580,2034,4508,0.451,437,1350,0.324,1597,3158,0.506,997,1339,0.745,592,1789,2381,1098,401,761,1071,5502
3220,2017-2-6,Indiana Pacers,50,12125,1970,4236,0.465,414,1128,0.367,1556,3108,0.501,934,1145,0.816,416,1667,2083,1122,440,684,974,5288
3221,2017-2-6,New York Knicks,52,12655,2078,4686,0.443,477,1339,0.356,1601,3347,0.478,869,1120,0.776,664,1760,2424,1130,378,700,1086,5502
3222,2017-2-6,Milwaukee Bucks,50,12075,1980,4169,0.475,425,1154,0.368,1555,3015,0.516,878,1157,0.759,480,1631,2111,1231,413,692,1017,5263
3223,2017-2-6,Brooklyn Nets,51,12290,1924,4364,0.441,561,1651,0.34,1363,2713,0.502,953,1196,0.797,445,1785,2230,1072,363,842,1063,5362
3224,2017-2-6,Charlotte Hornets,51,12315,1922,4365,0.44,498,1407,0.354,1424,2958,0.481,1016,1263,0.804,461,1834,2295,1196,331,588,865,5358
3225,2017-2-6,Los Angeles Lakers,53,12720,2044,4597,0.445,492,1395,0.353,1552,3202,0.485,937,1225,0.765,615,1722,2337,1092,407,772,1087,5517
3226,2017-2-6,Minnesota Timberwolves,51,12315,1977,4293,0.461,403,1141,0.353,1574,3152,0.499,948,1207,0.785,586,1595,2181,1188,380,715,1059,5305
3227,2017-2-6,Atlanta Hawks,51,12390,1983,4354,0.455,459,1335,0.344,1524,3019,0.505,875,1204,0.727,526,1725,2251,1234,434,764,914,5300
3228,2017-2-6,New Orleans Pelicans,51,12415,1976,4466,0.442,483,1357,0.356,1493,3109,0.48,826,1113,0.742,446,1814,2260,1161,388,614,929,5261
3229,2017-2-6,Sacramento Kings,51,12390,1906,4191,0.455,462,1281,0.361,1444,2910,0.496,985,1270,0.776,471,1611,2082,1143,415,704,1070,5259
3230,2017-2-6,Chicago Bulls,51,12290,1944,4420,0.44,329,1032,0.319,1615,3388,0.477,1006,1255,0.802,665,1744,2409,1075,395,662,892,5223
3231,2017-2-6,Detroit Pistons,51,12290,2020,4436,0.455,400,1171,0.342,1620,3265,0.496,716,973,0.736,514,1736,2250,1079,360,599,928,5156
3232,2017-2-6,Memphis Grizzlies,53,12920,1928,4461,0.432,489,1382,0.354,1439,3079,0.467,994,1266,0.785,572,1720,2292,1099,448,647,1260,5339
3233,2017-2-6,Philadelphia 76ers,50,12100,1843,4207,0.438,517,1465,0.353,1326,2742,0.484,822,1078,0.763,470,1661,2131,1174,404,820,1088,5025
3234,2017-2-6,Miami Heat,51,12315,1956,4358,0.449,467,1312,0.356,1489,3046,0.489,743,1092,0.68,518,1712,2230,1084,361,634,1045,5122
3235,2017-2-6,Orlando Magic,53,12795,2012,4572,0.44,462,1389,0.333,1550,3183,0.487,795,1100,0.723,515,1745,2260,1176,362,672,997,5281
3236,2017-2-6,Utah Jazz,51,12265,1840,3980,0.462,483,1331,0.363,1357,2649,0.512,911,1209,0.754,451,1733,2184,980,336,664,968,5074
3237,2017-2-6,Dallas Mavericks,50,12075,1807,4115,0.439,541,1510,0.358,1266,2605,0.486,725,901,0.805,411,1509,1920,1000,384,551,967,4880
3238,2017-2-7,Golden State Warriors,51,12340,2231,4468,0.499,623,1611,0.387,1608,2857,0.563,942,1191,0.791,463,1839,2302,1584,479,754,983,6027
3239,2017-2-7,Houston Rockets,54,13060,2179,4686,0.465,780,2154,0.362,1399,2532,0.553,1023,1340,0.763,568,1804,2372,1374,443,798,1086,6161
3240,2017-2-7,Cleveland Cavaliers,50,12100,1974,4286,0.461,650,1685,0.386,1324,2601,0.509,931,1245,0.748,511,1707,2218,1113,365,681,906,5529
3241,2017-2-7,Denver Nuggets,51,12315,2054,4453,0.461,501,1373,0.365,1553,3080,0.504,1010,1323,0.763,634,1744,2378,1244,344,765,1016,5619
3242,2017-2-7,Toronto Raptors,53,12795,2104,4537,0.464,490,1324,0.37,1614,3213,0.502,1091,1351,0.808,577,1700,2277,992,460,598,1114,5789
3243,2017-2-7,Los Angeles Clippers,52,12530,2043,4363,0.468,538,1421,0.379,1505,2942,0.512,1007,1343,0.75,486,1771,2257,1169,392,653,1061,5631
3244,2017-2-7,Boston Celtics,51,12315,1993,4394,0.454,621,1696,0.366,1372,2698,0.509,917,1121,0.818,475,1641,2116,1296,384,611,1037,5524
3245,2017-2-7,Washington Wizards,51,12340,2105,4417,0.477,448,1213,0.369,1657,3204,0.517,829,1053,0.787,518,1677,2195,1200,438,692,1086,5487
3246,2017-2-7,Portland Trail Blazers,52,12630,2053,4515,0.455,529,1477,0.358,1524,3038,0.502,956,1213,0.788,509,1714,2223,1143,363,677,1122,5591
3247,2017-2-7,San Antonio Spurs,51,12290,2020,4240,0.476,464,1146,0.405,1556,3094,0.503,951,1181,0.805,478,1729,2207,1222,416,648,940,5455
3248,2017-2-7,Phoenix Suns,52,12605,2031,4547,0.447,417,1214,0.343,1614,3333,0.484,1064,1353,0.786,617,1692,2309,957,433,780,1298,5543
3249,2017-2-7,New York Knicks,53,12895,2115,4768,0.444,484,1360,0.356,1631,3408,0.479,895,1153,0.776,670,1794,2464,1146,382,716,1110,5609
3250,2017-2-7,Oklahoma City Thunder,53,12820,2068,4596,0.45,444,1378,0.322,1624,3218,0.505,1012,1360,0.744,612,1830,2442,1115,407,777,1092,5592
3251,2017-2-7,Indiana Pacers,51,12365,2003,4323,0.463,422,1154,0.366,1581,3169,0.499,953,1174,0.812,429,1691,2120,1141,447,694,991,5381
3252,2017-2-7,Milwaukee Bucks,50,12075,1980,4169,0.475,425,1154,0.368,1555,3015,0.516,878,1157,0.759,480,1631,2111,1231,413,692,1017,5263
3253,2017-2-7,Brooklyn Nets,51,12290,1924,4364,0.441,561,1651,0.34,1363,2713,0.502,953,1196,0.797,445,1785,2230,1072,363,842,1063,5362
3254,2017-2-7,Charlotte Hornets,51,12315,1922,4365,0.44,498,1407,0.354,1424,2958,0.481,1016,1263,0.804,461,1834,2295,1196,331,588,865,5358
3255,2017-2-7,Los Angeles Lakers,54,12960,2088,4699,0.444,500,1423,0.351,1588,3276,0.485,962,1256,0.766,635,1757,2392,1111,416,779,1115,5638
3256,2017-2-7,Minnesota Timberwolves,52,12555,2020,4373,0.462,408,1152,0.354,1612,3221,0.5,970,1235,0.785,594,1621,2215,1213,393,725,1074,5418
3257,2017-2-7,Atlanta Hawks,52,12630,2016,4428,0.455,465,1352,0.344,1551,3076,0.504,898,1236,0.727,533,1748,2281,1250,440,776,932,5395
3258,2017-2-7,New Orleans Pelicans,52,12655,2018,4558,0.443,492,1383,0.356,1526,3175,0.481,844,1135,0.744,455,1853,2308,1181,399,627,954,5372
3259,2017-2-7,Sacramento Kings,52,12630,1947,4270,0.456,473,1309,0.361,1474,2961,0.498,999,1286,0.777,480,1642,2122,1170,419,719,1095,5366
3260,2017-2-7,Chicago Bulls,52,12530,1987,4501,0.441,335,1051,0.319,1652,3450,0.479,1026,1286,0.798,673,1771,2444,1096,405,670,909,5335
3261,2017-2-7,Detroit Pistons,52,12530,2066,4535,0.456,405,1193,0.339,1661,3342,0.497,732,990,0.739,533,1777,2310,1101,368,611,947,5269
3262,2017-2-7,Miami Heat,52,12555,2001,4444,0.45,482,1340,0.36,1519,3104,0.489,753,1106,0.681,531,1737,2268,1111,366,651,1066,5237
3263,2017-2-7,Memphis Grizzlies,54,13160,1960,4542,0.432,493,1401,0.352,1467,3141,0.467,1015,1291,0.786,587,1755,2342,1117,456,660,1277,5428
3264,2017-2-7,Philadelphia 76ers,51,12340,1879,4292,0.438,522,1493,0.35,1357,2799,0.485,841,1106,0.76,481,1691,2172,1193,412,833,1105,5121
3265,2017-2-7,Utah Jazz,52,12505,1889,4060,0.465,493,1357,0.363,1396,2703,0.516,923,1227,0.752,460,1768,2228,1011,345,676,991,5194
3266,2017-2-7,Orlando Magic,53,12795,2012,4572,0.44,462,1389,0.333,1550,3183,0.487,795,1100,0.723,515,1745,2260,1176,362,672,997,5281
3267,2017-2-7,Dallas Mavericks,51,12315,1841,4194,0.439,549,1536,0.357,1292,2658,0.486,736,918,0.802,414,1535,1949,1025,392,561,985,4967
3268,2017-2-8,Golden State Warriors,51,12340,2231,4468,0.499,623,1611,0.387,1608,2857,0.563,942,1191,0.791,463,1839,2302,1584,479,754,983,6027
3269,2017-2-8,Houston Rockets,55,13300,2223,4775,0.466,796,2192,0.363,1427,2583,0.552,1047,1376,0.761,578,1836,2414,1405,452,808,1101,6289
3270,2017-2-8,Cleveland Cavaliers,50,12100,1974,4286,0.461,650,1685,0.386,1324,2601,0.509,931,1245,0.748,511,1707,2218,1113,365,681,906,5529
3271,2017-2-8,Denver Nuggets,51,12315,2054,4453,0.461,501,1373,0.365,1553,3080,0.504,1010,1323,0.763,634,1744,2378,1244,344,765,1016,5619
3272,2017-2-8,Toronto Raptors,53,12795,2104,4537,0.464,490,1324,0.37,1614,3213,0.502,1091,1351,0.808,577,1700,2277,992,460,598,1114,5789
3273,2017-2-8,Los Angeles Clippers,52,12530,2043,4363,0.468,538,1421,0.379,1505,2942,0.512,1007,1343,0.75,486,1771,2257,1169,392,653,1061,5631
3274,2017-2-8,Boston Celtics,51,12315,1993,4394,0.454,621,1696,0.366,1372,2698,0.509,917,1121,0.818,475,1641,2116,1296,384,611,1037,5524
3275,2017-2-8,Portland Trail Blazers,53,12870,2095,4601,0.455,540,1505,0.359,1555,3096,0.502,975,1237,0.788,527,1751,2278,1160,369,692,1148,5705
3276,2017-2-8,Washington Wizards,51,12340,2105,4417,0.477,448,1213,0.369,1657,3204,0.517,829,1053,0.787,518,1677,2195,1200,438,692,1086,5487
3277,2017-2-8,San Antonio Spurs,51,12290,2020,4240,0.476,464,1146,0.405,1556,3094,0.503,951,1181,0.805,478,1729,2207,1222,416,648,940,5455
3278,2017-2-8,Phoenix Suns,52,12605,2031,4547,0.447,417,1214,0.343,1614,3333,0.484,1064,1353,0.786,617,1692,2309,957,433,780,1298,5543
3279,2017-2-8,New York Knicks,53,12895,2115,4768,0.444,484,1360,0.356,1631,3408,0.479,895,1153,0.776,670,1794,2464,1146,382,716,1110,5609
3280,2017-2-8,Oklahoma City Thunder,53,12820,2068,4596,0.45,444,1378,0.322,1624,3218,0.505,1012,1360,0.744,612,1830,2442,1115,407,777,1092,5592
3281,2017-2-8,Indiana Pacers,51,12365,2003,4323,0.463,422,1154,0.366,1581,3169,0.499,953,1174,0.812,429,1691,2120,1141,447,694,991,5381
3282,2017-2-8,Milwaukee Bucks,50,12075,1980,4169,0.475,425,1154,0.368,1555,3015,0.516,878,1157,0.759,480,1631,2111,1231,413,692,1017,5263
3283,2017-2-8,Brooklyn Nets,52,12530,1963,4450,0.441,573,1687,0.34,1390,2763,0.503,970,1217,0.797,449,1826,2275,1098,366,857,1086,5469
3284,2017-2-8,Charlotte Hornets,52,12555,1962,4467,0.439,505,1433,0.352,1457,3034,0.48,1040,1292,0.805,473,1873,2346,1215,337,595,882,5469
3285,2017-2-8,Los Angeles Lakers,54,12960,2088,4699,0.444,500,1423,0.351,1588,3276,0.485,962,1256,0.766,635,1757,2392,1111,416,779,1115,5638
3286,2017-2-8,Minnesota Timberwolves,52,12555,2020,4373,0.462,408,1152,0.354,1612,3221,0.5,970,1235,0.785,594,1621,2215,1213,393,725,1074,5418
3287,2017-2-8,Atlanta Hawks,52,12630,2016,4428,0.455,465,1352,0.344,1551,3076,0.504,898,1236,0.727,533,1748,2281,1250,440,776,932,5395
3288,2017-2-8,New Orleans Pelicans,52,12655,2018,4558,0.443,492,1383,0.356,1526,3175,0.481,844,1135,0.744,455,1853,2308,1181,399,627,954,5372
3289,2017-2-8,Sacramento Kings,52,12630,1947,4270,0.456,473,1309,0.361,1474,2961,0.498,999,1286,0.777,480,1642,2122,1170,419,719,1095,5366
3290,2017-2-8,Chicago Bulls,52,12530,1987,4501,0.441,335,1051,0.319,1652,3450,0.479,1026,1286,0.798,673,1771,2444,1096,405,670,909,5335
3291,2017-2-8,Detroit Pistons,52,12530,2066,4535,0.456,405,1193,0.339,1661,3342,0.497,732,990,0.739,533,1777,2310,1101,368,611,947,5269
3292,2017-2-8,Miami Heat,52,12555,2001,4444,0.45,482,1340,0.36,1519,3104,0.489,753,1106,0.681,531,1737,2268,1111,366,651,1066,5237
3293,2017-2-8,Memphis Grizzlies,54,13160,1960,4542,0.432,493,1401,0.352,1467,3141,0.467,1015,1291,0.786,587,1755,2342,1117,456,660,1277,5428
3294,2017-2-8,Philadelphia 76ers,51,12340,1879,4292,0.438,522,1493,0.35,1357,2799,0.485,841,1106,0.76,481,1691,2172,1193,412,833,1105,5121
3295,2017-2-8,Utah Jazz,52,12505,1889,4060,0.465,493,1357,0.363,1396,2703,0.516,923,1227,0.752,460,1768,2228,1011,345,676,991,5194
3296,2017-2-8,Orlando Magic,54,13035,2054,4660,0.441,468,1414,0.331,1586,3246,0.489,809,1120,0.722,525,1782,2307,1204,369,688,1020,5385
3297,2017-2-8,Dallas Mavericks,52,12555,1878,4269,0.44,561,1564,0.359,1317,2705,0.487,763,950,0.803,416,1563,1979,1041,398,568,1007,5080
3298,2017-2-9,Golden State Warriors,52,12580,2279,4553,0.501,638,1639,0.389,1641,2914,0.563,954,1204,0.792,468,1879,2347,1621,488,766,1000,6150
3299,2017-2-9,Houston Rockets,55,13300,2223,4775,0.466,796,2192,0.363,1427,2583,0.552,1047,1376,0.761,578,1836,2414,1405,452,808,1101,6289
3300,2017-2-9,Cleveland Cavaliers,51,12340,2020,4370,0.462,666,1721,0.387,1354,2649,0.511,955,1271,0.751,516,1741,2257,1137,372,690,922,5661
3301,2017-2-9,Denver Nuggets,52,12555,2094,4553,0.46,514,1417,0.363,1580,3136,0.504,1023,1344,0.761,655,1772,2427,1269,352,775,1036,5725
3302,2017-2-9,Toronto Raptors,54,13035,2146,4616,0.465,501,1352,0.371,1645,3264,0.504,1105,1371,0.806,587,1726,2313,1011,466,611,1136,5898
3303,2017-2-9,Los Angeles Clippers,53,12770,2088,4455,0.469,548,1446,0.379,1540,3009,0.512,1026,1371,0.748,500,1804,2304,1191,400,664,1081,5750
3304,2017-2-9,Boston Celtics,52,12555,2022,4467,0.453,631,1728,0.365,1391,2739,0.508,941,1148,0.82,482,1673,2155,1314,392,628,1056,5616
3305,2017-2-9,Washington Wizards,52,12605,2145,4514,0.475,457,1238,0.369,1688,3276,0.515,854,1086,0.786,535,1714,2249,1221,447,704,1112,5601
3306,2017-2-9,Portland Trail Blazers,53,12870,2095,4601,0.455,540,1505,0.359,1555,3096,0.502,975,1237,0.788,527,1751,2278,1160,369,692,1148,5705
3307,2017-2-9,San Antonio Spurs,52,12530,2059,4314,0.477,475,1168,0.407,1584,3146,0.503,973,1206,0.807,484,1771,2255,1246,418,663,962,5566
3308,2017-2-9,Phoenix Suns,53,12845,2060,4634,0.445,422,1237,0.341,1638,3397,0.482,1092,1387,0.787,635,1720,2355,970,445,795,1325,5634
3309,2017-2-9,New York Knicks,54,13135,2161,4860,0.445,492,1387,0.355,1669,3473,0.481,910,1171,0.777,682,1823,2505,1171,391,727,1132,5724
3310,2017-2-9,Indiana Pacers,52,12605,2044,4405,0.464,435,1179,0.369,1609,3226,0.499,975,1200,0.813,436,1722,2158,1165,454,706,1009,5498
3311,2017-2-9,Oklahoma City Thunder,53,12820,2068,4596,0.45,444,1378,0.322,1624,3218,0.505,1012,1360,0.744,612,1830,2442,1115,407,777,1092,5592
3312,2017-2-9,Brooklyn Nets,53,12795,2001,4541,0.441,582,1720,0.338,1419,2821,0.503,995,1253,0.794,464,1866,2330,1118,372,873,1110,5579
3313,2017-2-9,Charlotte Hornets,52,12555,1962,4467,0.439,505,1433,0.352,1457,3034,0.48,1040,1292,0.805,473,1873,2346,1215,337,595,882,5469
3314,2017-2-9,Milwaukee Bucks,51,12315,2013,4240,0.475,431,1169,0.369,1582,3071,0.515,894,1185,0.754,485,1659,2144,1249,423,704,1035,5351
3315,2017-2-9,Los Angeles Lakers,55,13200,2125,4785,0.444,506,1446,0.35,1619,3339,0.485,984,1282,0.768,642,1791,2433,1132,423,800,1136,5740
3316,2017-2-9,Minnesota Timberwolves,53,12795,2059,4453,0.462,415,1171,0.354,1644,3282,0.501,997,1265,0.788,605,1646,2251,1235,401,733,1094,5530
3317,2017-2-9,Atlanta Hawks,53,12870,2063,4521,0.456,473,1379,0.343,1590,3142,0.506,913,1254,0.728,545,1784,2329,1281,446,786,950,5512
3318,2017-2-9,Sacramento Kings,53,12870,1989,4354,0.457,483,1334,0.362,1506,3020,0.499,1013,1301,0.779,484,1678,2162,1194,430,733,1113,5474
3319,2017-2-9,New Orleans Pelicans,53,12895,2053,4635,0.443,497,1407,0.353,1556,3228,0.482,863,1160,0.744,462,1883,2345,1198,405,640,971,5466
3320,2017-2-9,Chicago Bulls,53,12770,2024,4593,0.441,339,1075,0.315,1685,3518,0.479,1040,1305,0.797,688,1800,2488,1121,412,684,926,5427
3321,2017-2-9,Detroit Pistons,53,12770,2117,4632,0.457,409,1209,0.338,1708,3423,0.499,747,1014,0.737,547,1815,2362,1133,379,625,961,5390
3322,2017-2-9,Miami Heat,53,12795,2042,4530,0.451,493,1373,0.359,1549,3157,0.491,766,1124,0.681,545,1771,2316,1134,371,666,1087,5343
3323,2017-2-9,Memphis Grizzlies,55,13400,1995,4614,0.432,507,1425,0.356,1488,3189,0.467,1041,1325,0.786,598,1785,2383,1141,462,682,1302,5538
3324,2017-2-9,Philadelphia 76ers,52,12580,1913,4376,0.437,535,1527,0.35,1378,2849,0.484,863,1135,0.76,488,1719,2207,1216,420,838,1124,5224
3325,2017-2-9,Utah Jazz,53,12745,1937,4148,0.467,507,1389,0.365,1430,2759,0.518,940,1248,0.753,472,1804,2276,1036,354,684,1010,5321
3326,2017-2-9,Orlando Magic,54,13035,2054,4660,0.441,468,1414,0.331,1586,3246,0.489,809,1120,0.722,525,1782,2307,1204,369,688,1020,5385
3327,2017-2-9,Dallas Mavericks,52,12555,1878,4269,0.44,561,1564,0.359,1317,2705,0.487,763,950,0.803,416,1563,1979,1041,398,568,1007,5080
3328,2017-2-10,Golden State Warriors,52,12580,2279,4553,0.501,638,1639,0.389,1641,2914,0.563,954,1204,0.792,468,1879,2347,1621,488,766,1000,6150
3329,2017-2-10,Houston Rockets,56,13540,2262,4862,0.465,809,2232,0.362,1453,2630,0.552,1063,1396,0.761,587,1869,2456,1427,465,825,1120,6396
3330,2017-2-10,Cleveland Cavaliers,52,12580,2058,4449,0.463,676,1742,0.388,1382,2707,0.511,978,1301,0.752,521,1771,2292,1151,381,706,936,5770
3331,2017-2-10,Denver Nuggets,52,12555,2094,4553,0.46,514,1417,0.363,1580,3136,0.504,1023,1344,0.761,655,1772,2427,1269,352,775,1036,5725
3332,2017-2-10,Toronto Raptors,54,13035,2146,4616,0.465,501,1352,0.371,1645,3264,0.504,1105,1371,0.806,587,1726,2313,1011,466,611,1136,5898
3333,2017-2-10,Los Angeles Clippers,53,12770,2088,4455,0.469,548,1446,0.379,1540,3009,0.512,1026,1371,0.748,500,1804,2304,1191,400,664,1081,5750
3334,2017-2-10,Boston Celtics,53,12795,2066,4558,0.453,641,1758,0.365,1425,2800,0.509,963,1175,0.82,496,1702,2198,1337,400,636,1077,5736
3335,2017-2-10,Portland Trail Blazers,54,13110,2134,4678,0.456,549,1531,0.359,1585,3147,0.504,999,1268,0.788,537,1782,2319,1183,373,707,1171,5816
3336,2017-2-10,Washington Wizards,52,12605,2145,4514,0.475,457,1238,0.369,1688,3276,0.515,854,1086,0.786,535,1714,2249,1221,447,704,1112,5601
3337,2017-2-10,San Antonio Spurs,52,12530,2059,4314,0.477,475,1168,0.407,1584,3146,0.503,973,1206,0.807,484,1771,2255,1246,418,663,962,5566
3338,2017-2-10,Phoenix Suns,53,12845,2060,4634,0.445,422,1237,0.341,1638,3397,0.482,1092,1387,0.787,635,1720,2355,970,445,795,1325,5634
3339,2017-2-10,New York Knicks,54,13135,2161,4860,0.445,492,1387,0.355,1669,3473,0.481,910,1171,0.777,682,1823,2505,1171,391,727,1132,5724
3340,2017-2-10,Oklahoma City Thunder,54,13060,2118,4702,0.45,452,1405,0.322,1666,3297,0.505,1022,1373,0.744,629,1864,2493,1139,417,790,1115,5710
3341,2017-2-10,Indiana Pacers,52,12605,2044,4405,0.464,435,1179,0.369,1609,3226,0.499,975,1200,0.813,436,1722,2158,1165,454,706,1009,5498
3342,2017-2-10,Brooklyn Nets,53,12795,2001,4541,0.441,582,1720,0.338,1419,2821,0.503,995,1253,0.794,464,1866,2330,1118,372,873,1110,5579
3343,2017-2-10,Charlotte Hornets,53,12795,1999,4552,0.439,513,1459,0.352,1486,3093,0.48,1053,1306,0.806,483,1910,2393,1241,345,616,899,5564
3344,2017-2-10,Milwaukee Bucks,51,12315,2013,4240,0.475,431,1169,0.369,1582,3071,0.515,894,1185,0.754,485,1659,2144,1249,423,704,1035,5351
3345,2017-2-10,Los Angeles Lakers,55,13200,2125,4785,0.444,506,1446,0.35,1619,3339,0.485,984,1282,0.768,642,1791,2433,1132,423,800,1136,5740
3346,2017-2-10,Minnesota Timberwolves,53,12795,2059,4453,0.462,415,1171,0.354,1644,3282,0.501,997,1265,0.788,605,1646,2251,1235,401,733,1094,5530
3347,2017-2-10,Atlanta Hawks,53,12870,2063,4521,0.456,473,1379,0.343,1590,3142,0.506,913,1254,0.728,545,1784,2329,1281,446,786,950,5512
3348,2017-2-10,Sacramento Kings,53,12870,1989,4354,0.457,483,1334,0.362,1506,3020,0.499,1013,1301,0.779,484,1678,2162,1194,430,733,1113,5474
3349,2017-2-10,New Orleans Pelicans,53,12895,2053,4635,0.443,497,1407,0.353,1556,3228,0.482,863,1160,0.744,462,1883,2345,1198,405,640,971,5466
3350,2017-2-10,Chicago Bulls,53,12770,2024,4593,0.441,339,1075,0.315,1685,3518,0.479,1040,1305,0.797,688,1800,2488,1121,412,684,926,5427
3351,2017-2-10,Detroit Pistons,53,12770,2117,4632,0.457,409,1209,0.338,1708,3423,0.499,747,1014,0.737,547,1815,2362,1133,379,625,961,5390
3352,2017-2-10,Miami Heat,53,12795,2042,4530,0.451,493,1373,0.359,1549,3157,0.491,766,1124,0.681,545,1771,2316,1134,371,666,1087,5343
3353,2017-2-10,Memphis Grizzlies,55,13400,1995,4614,0.432,507,1425,0.356,1488,3189,0.467,1041,1325,0.786,598,1785,2383,1141,462,682,1302,5538
3354,2017-2-10,Philadelphia 76ers,53,12820,1953,4471,0.437,546,1555,0.351,1407,2916,0.483,884,1162,0.761,501,1751,2252,1241,433,853,1143,5336
3355,2017-2-10,Utah Jazz,54,13010,1976,4233,0.467,520,1418,0.367,1456,2815,0.517,954,1265,0.754,483,1836,2319,1062,362,705,1036,5426
3356,2017-2-10,Orlando Magic,55,13275,2095,4744,0.442,478,1435,0.333,1617,3309,0.489,828,1144,0.724,532,1822,2354,1231,373,709,1040,5496
3357,2017-2-10,Dallas Mavericks,53,12820,1922,4356,0.441,566,1584,0.357,1356,2772,0.489,782,975,0.802,422,1594,2016,1062,410,579,1026,5192
3358,2017-2-11,Golden State Warriors,53,12820,2318,4630,0.501,653,1672,0.391,1665,2958,0.563,983,1242,0.791,473,1908,2381,1652,502,778,1026,6272
3359,2017-2-11,Houston Rockets,56,13540,2262,4862,0.465,809,2232,0.362,1453,2630,0.552,1063,1396,0.761,587,1869,2456,1427,465,825,1120,6396
3360,2017-2-11,Cleveland Cavaliers,52,12580,2058,4449,0.463,676,1742,0.388,1382,2707,0.511,978,1301,0.752,521,1771,2292,1151,381,706,936,5770
3361,2017-2-11,Denver Nuggets,53,12795,2148,4648,0.462,530,1449,0.366,1618,3199,0.506,1030,1354,0.761,671,1800,2471,1299,358,790,1047,5856
3362,2017-2-11,Toronto Raptors,54,13035,2146,4616,0.465,501,1352,0.371,1645,3264,0.504,1105,1371,0.806,587,1726,2313,1011,466,611,1136,5898
3363,2017-2-11,Los Angeles Clippers,53,12770,2088,4455,0.469,548,1446,0.379,1540,3009,0.512,1026,1371,0.748,500,1804,2304,1191,400,664,1081,5750
3364,2017-2-11,Boston Celtics,53,12795,2066,4558,0.453,641,1758,0.365,1425,2800,0.509,963,1175,0.82,496,1702,2198,1337,400,636,1077,5736
3365,2017-2-11,Washington Wizards,53,12845,2186,4602,0.475,467,1267,0.369,1719,3335,0.515,874,1116,0.783,549,1746,2295,1250,455,715,1125,5713
3366,2017-2-11,Portland Trail Blazers,54,13110,2134,4678,0.456,549,1531,0.359,1585,3147,0.504,999,1268,0.788,537,1782,2319,1183,373,707,1171,5816
3367,2017-2-11,San Antonio Spurs,53,12770,2100,4396,0.478,484,1187,0.408,1616,3209,0.504,985,1221,0.807,495,1812,2307,1273,422,681,980,5669
3368,2017-2-11,Phoenix Suns,54,13085,2108,4729,0.446,430,1256,0.342,1678,3473,0.483,1103,1400,0.788,648,1750,2398,995,449,803,1343,5749
3369,2017-2-11,New York Knicks,55,13375,2213,4953,0.447,508,1425,0.356,1705,3528,0.483,913,1176,0.776,692,1846,2538,1207,401,737,1146,5847
3370,2017-2-11,Indiana Pacers,53,12845,2089,4497,0.465,439,1200,0.366,1650,3297,0.5,988,1215,0.813,446,1754,2200,1194,457,717,1031,5605
3371,2017-2-11,Oklahoma City Thunder,54,13060,2118,4702,0.45,452,1405,0.322,1666,3297,0.505,1022,1373,0.744,629,1864,2493,1139,417,790,1115,5710
3372,2017-2-11,Milwaukee Bucks,52,12555,2053,4316,0.476,439,1197,0.367,1614,3119,0.517,920,1216,0.757,489,1689,2178,1276,434,724,1064,5465
3373,2017-2-11,Brooklyn Nets,54,13035,2036,4622,0.441,590,1740,0.339,1446,2882,0.502,1016,1281,0.793,479,1899,2378,1137,376,895,1128,5678
3374,2017-2-11,Charlotte Hornets,53,12795,1999,4552,0.439,513,1459,0.352,1486,3093,0.48,1053,1306,0.806,483,1910,2393,1241,345,616,899,5564
3375,2017-2-11,Los Angeles Lakers,56,13440,2164,4860,0.445,521,1477,0.353,1643,3383,0.486,1013,1317,0.769,648,1818,2466,1157,432,817,1160,5862
3376,2017-2-11,Minnesota Timberwolves,54,13035,2097,4535,0.462,421,1198,0.351,1676,3337,0.502,1021,1297,0.787,617,1668,2285,1257,412,746,1115,5636
3377,2017-2-11,Atlanta Hawks,54,13110,2099,4592,0.457,484,1409,0.344,1615,3183,0.507,937,1285,0.729,548,1818,2366,1300,452,802,967,5619
3378,2017-2-11,New Orleans Pelicans,54,13135,2098,4710,0.445,509,1432,0.355,1589,3278,0.485,883,1187,0.744,470,1918,2388,1225,413,661,994,5588
3379,2017-2-11,Sacramento Kings,54,13110,2027,4434,0.457,501,1370,0.366,1526,3064,0.498,1027,1322,0.777,492,1709,2201,1221,442,751,1140,5582
3380,2017-2-11,Chicago Bulls,54,13010,2061,4679,0.44,344,1094,0.314,1717,3585,0.479,1058,1327,0.797,700,1829,2529,1141,419,695,942,5524
3381,2017-2-11,Detroit Pistons,54,13010,2156,4724,0.456,414,1226,0.338,1742,3498,0.498,756,1027,0.736,554,1843,2397,1155,387,635,976,5482
3382,2017-2-11,Miami Heat,54,13035,2083,4622,0.451,500,1396,0.358,1583,3226,0.491,785,1145,0.686,558,1804,2362,1150,382,680,1108,5451
3383,2017-2-11,Memphis Grizzlies,56,13640,2029,4701,0.432,516,1451,0.356,1513,3250,0.466,1071,1362,0.786,616,1814,2430,1161,468,700,1330,5645
3384,2017-2-11,Philadelphia 76ers,53,12820,1953,4471,0.437,546,1555,0.351,1407,2916,0.483,884,1162,0.761,501,1751,2252,1241,433,853,1143,5336
3385,2017-2-11,Utah Jazz,54,13010,1976,4233,0.467,520,1418,0.367,1456,2815,0.517,954,1265,0.754,483,1836,2319,1062,362,705,1036,5426
3386,2017-2-11,Orlando Magic,55,13275,2095,4744,0.442,478,1435,0.333,1617,3309,0.489,828,1144,0.724,532,1822,2354,1231,373,709,1040,5496
3387,2017-2-11,Dallas Mavericks,53,12820,1922,4356,0.441,566,1584,0.357,1356,2772,0.489,782,975,0.802,422,1594,2016,1062,410,579,1026,5192
3388,2017-2-12,Golden State Warriors,54,13060,2364,4717,0.501,666,1703,0.391,1698,3014,0.563,1008,1277,0.789,483,1938,2421,1680,512,789,1048,6402
3389,2017-2-12,Houston Rockets,57,13780,2304,4947,0.466,827,2268,0.365,1477,2679,0.551,1094,1435,0.762,603,1908,2511,1454,473,846,1143,6529
3390,2017-2-12,Cleveland Cavaliers,53,12820,2104,4533,0.464,691,1772,0.39,1413,2761,0.512,996,1323,0.753,529,1808,2337,1181,390,721,952,5895
3391,2017-2-12,Denver Nuggets,54,13035,2187,4745,0.461,542,1486,0.365,1645,3259,0.505,1049,1376,0.762,688,1828,2516,1322,366,802,1069,5965
3392,2017-2-12,Toronto Raptors,54,13035,2146,4616,0.465,501,1352,0.371,1645,3264,0.504,1105,1371,0.806,587,1726,2313,1011,466,611,1136,5898
3393,2017-2-12,Los Angeles Clippers,54,13010,2128,4540,0.469,562,1480,0.38,1566,3060,0.512,1039,1391,0.747,510,1844,2354,1217,403,677,1102,5857
3394,2017-2-12,Boston Celtics,54,13035,2108,4629,0.455,654,1788,0.366,1454,2841,0.512,978,1198,0.816,499,1736,2235,1357,406,652,1101,5848
3395,2017-2-12,Washington Wizards,53,12845,2186,4602,0.475,467,1267,0.369,1719,3335,0.515,874,1116,0.783,549,1746,2295,1250,455,715,1125,5713
3396,2017-2-12,Portland Trail Blazers,54,13110,2134,4678,0.456,549,1531,0.359,1585,3147,0.504,999,1268,0.788,537,1782,2319,1183,373,707,1171,5816
3397,2017-2-12,San Antonio Spurs,53,12770,2100,4396,0.478,484,1187,0.408,1616,3209,0.504,985,1221,0.807,495,1812,2307,1273,422,681,980,5669
3398,2017-2-12,Phoenix Suns,55,13325,2145,4823,0.445,438,1278,0.343,1707,3545,0.482,1123,1426,0.788,660,1780,2440,1015,457,822,1371,5851
3399,2017-2-12,New York Knicks,55,13375,2213,4953,0.447,508,1425,0.356,1705,3528,0.483,913,1176,0.776,692,1846,2538,1207,401,737,1146,5847
3400,2017-2-12,Oklahoma City Thunder,55,13300,2158,4785,0.451,458,1429,0.321,1700,3356,0.507,1050,1409,0.745,641,1895,2536,1159,424,809,1138,5824
3401,2017-2-12,Indiana Pacers,54,13085,2124,4570,0.465,449,1222,0.367,1675,3348,0.5,1008,1239,0.814,454,1782,2236,1213,459,731,1056,5705
3402,2017-2-12,Milwaukee Bucks,53,12795,2088,4389,0.476,456,1228,0.371,1632,3161,0.516,949,1253,0.757,497,1718,2215,1304,441,730,1082,5581
3403,2017-2-12,Brooklyn Nets,54,13035,2036,4622,0.441,590,1740,0.339,1446,2882,0.502,1016,1281,0.793,479,1899,2378,1137,376,895,1128,5678
3404,2017-2-12,Charlotte Hornets,54,13035,2036,4637,0.439,526,1496,0.352,1510,3141,0.481,1068,1326,0.805,491,1942,2433,1265,351,624,919,5666
3405,2017-2-12,Los Angeles Lakers,56,13440,2164,4860,0.445,521,1477,0.353,1643,3383,0.486,1013,1317,0.769,648,1818,2466,1157,432,817,1160,5862
3406,2017-2-12,Minnesota Timberwolves,54,13035,2097,4535,0.462,421,1198,0.351,1676,3337,0.502,1021,1297,0.787,617,1668,2285,1257,412,746,1115,5636
3407,2017-2-12,Atlanta Hawks,54,13110,2099,4592,0.457,484,1409,0.344,1615,3183,0.507,937,1285,0.729,548,1818,2366,1300,452,802,967,5619
3408,2017-2-12,New Orleans Pelicans,54,13135,2098,4710,0.445,509,1432,0.355,1589,3278,0.485,883,1187,0.744,470,1918,2388,1225,413,661,994,5588
3409,2017-2-12,Sacramento Kings,54,13110,2027,4434,0.457,501,1370,0.366,1526,3064,0.498,1027,1322,0.777,492,1709,2201,1221,442,751,1140,5582
3410,2017-2-12,Chicago Bulls,54,13010,2061,4679,0.44,344,1094,0.314,1717,3585,0.479,1058,1327,0.797,700,1829,2529,1141,419,695,942,5524
3411,2017-2-12,Detroit Pistons,54,13010,2156,4724,0.456,414,1226,0.338,1742,3498,0.498,756,1027,0.736,554,1843,2397,1155,387,635,976,5482
3412,2017-2-12,Miami Heat,55,13275,2122,4707,0.451,507,1420,0.357,1615,3287,0.491,809,1173,0.69,569,1842,2411,1165,386,699,1135,5560
3413,2017-2-12,Philadelphia 76ers,54,13060,1992,4557,0.437,555,1580,0.351,1437,2977,0.483,914,1200,0.762,512,1778,2290,1268,448,863,1164,5453
3414,2017-2-12,Memphis Grizzlies,56,13640,2029,4701,0.432,516,1451,0.356,1513,3250,0.466,1071,1362,0.786,616,1814,2430,1161,468,700,1330,5645
3415,2017-2-12,Utah Jazz,55,13250,2011,4319,0.466,528,1449,0.364,1483,2870,0.517,980,1295,0.757,496,1862,2358,1078,371,714,1055,5530
3416,2017-2-12,Orlando Magic,56,13515,2127,4826,0.441,481,1458,0.33,1646,3368,0.489,841,1162,0.724,543,1851,2394,1247,381,723,1056,5576
3417,2017-2-12,Dallas Mavericks,54,13060,1967,4447,0.442,583,1619,0.36,1384,2828,0.489,787,981,0.802,434,1633,2067,1094,420,593,1043,5304
3418,2017-2-13,Golden State Warriors,54,13060,2364,4717,0.501,666,1703,0.391,1698,3014,0.563,1008,1277,0.789,483,1938,2421,1680,512,789,1048,6402
3419,2017-2-13,Houston Rockets,57,13780,2304,4947,0.466,827,2268,0.365,1477,2679,0.551,1094,1435,0.762,603,1908,2511,1454,473,846,1143,6529
3420,2017-2-13,Cleveland Cavaliers,53,12820,2104,4533,0.464,691,1772,0.39,1413,2761,0.512,996,1323,0.753,529,1808,2337,1181,390,721,952,5895
3421,2017-2-13,Denver Nuggets,54,13035,2187,4745,0.461,542,1486,0.365,1645,3259,0.505,1049,1376,0.762,688,1828,2516,1322,366,802,1069,5965
3422,2017-2-13,Toronto Raptors,55,13275,2184,4691,0.466,509,1368,0.372,1675,3323,0.504,1122,1396,0.804,593,1758,2351,1029,470,620,1154,5999
3423,2017-2-13,Los Angeles Clippers,54,13010,2128,4540,0.469,562,1480,0.38,1566,3060,0.512,1039,1391,0.747,510,1844,2354,1217,403,677,1102,5857
3424,2017-2-13,Boston Celtics,54,13035,2108,4629,0.455,654,1788,0.366,1454,2841,0.512,978,1198,0.816,499,1736,2235,1357,406,652,1101,5848
3425,2017-2-13,Washington Wizards,53,12845,2186,4602,0.475,467,1267,0.369,1719,3335,0.515,874,1116,0.783,549,1746,2295,1250,455,715,1125,5713
3426,2017-2-13,Portland Trail Blazers,54,13110,2134,4678,0.456,549,1531,0.359,1585,3147,0.504,999,1268,0.788,537,1782,2319,1183,373,707,1171,5816
3427,2017-2-13,San Antonio Spurs,54,13010,2133,4487,0.475,490,1216,0.403,1643,3271,0.502,1003,1243,0.807,516,1837,2353,1290,433,692,996,5759
3428,2017-2-13,Phoenix Suns,55,13325,2145,4823,0.445,438,1278,0.343,1707,3545,0.482,1123,1426,0.788,660,1780,2440,1015,457,822,1371,5851
3429,2017-2-13,New York Knicks,56,13615,2247,5021,0.448,517,1439,0.359,1730,3582,0.483,930,1197,0.777,697,1885,2582,1225,406,756,1165,5941
3430,2017-2-13,Oklahoma City Thunder,55,13300,2158,4785,0.451,458,1429,0.321,1700,3356,0.507,1050,1409,0.745,641,1895,2536,1159,424,809,1138,5824
3431,2017-2-13,Indiana Pacers,54,13085,2124,4570,0.465,449,1222,0.367,1675,3348,0.5,1008,1239,0.814,454,1782,2236,1213,459,731,1056,5705
3432,2017-2-13,Milwaukee Bucks,53,12795,2088,4389,0.476,456,1228,0.371,1632,3161,0.516,949,1253,0.757,497,1718,2215,1304,441,730,1082,5581
3433,2017-2-13,Brooklyn Nets,54,13035,2036,4622,0.441,590,1740,0.339,1446,2882,0.502,1016,1281,0.793,479,1899,2378,1137,376,895,1128,5678
3434,2017-2-13,Charlotte Hornets,54,13035,2036,4637,0.439,526,1496,0.352,1510,3141,0.481,1068,1326,0.805,491,1942,2433,1265,351,624,919,5666
3435,2017-2-13,Los Angeles Lakers,56,13440,2164,4860,0.445,521,1477,0.353,1643,3383,0.486,1013,1317,0.769,648,1818,2466,1157,432,817,1160,5862
3436,2017-2-13,Minnesota Timberwolves,55,13275,2141,4616,0.464,427,1222,0.349,1714,3394,0.505,1044,1323,0.789,627,1704,2331,1284,423,760,1129,5753
3437,2017-2-13,Atlanta Hawks,54,13110,2099,4592,0.457,484,1409,0.344,1615,3183,0.507,937,1285,0.729,548,1818,2366,1300,452,802,967,5619
3438,2017-2-13,New Orleans Pelicans,55,13375,2132,4792,0.445,522,1463,0.357,1610,3329,0.484,901,1208,0.746,476,1948,2424,1248,423,678,1017,5687
3439,2017-2-13,Sacramento Kings,55,13350,2062,4512,0.457,512,1401,0.365,1550,3111,0.498,1051,1349,0.779,500,1747,2247,1244,453,770,1158,5687
3440,2017-2-13,Chicago Bulls,55,13250,2096,4763,0.44,354,1119,0.316,1742,3644,0.478,1067,1340,0.796,709,1855,2564,1163,426,713,966,5613
3441,2017-2-13,Detroit Pistons,55,13250,2192,4808,0.456,422,1257,0.336,1770,3551,0.498,778,1056,0.737,565,1873,2438,1167,395,642,994,5584
3442,2017-2-13,Miami Heat,55,13275,2122,4707,0.451,507,1420,0.357,1615,3287,0.491,809,1173,0.69,569,1842,2411,1165,386,699,1135,5560
3443,2017-2-13,Philadelphia 76ers,54,13060,1992,4557,0.437,555,1580,0.351,1437,2977,0.483,914,1200,0.762,512,1778,2290,1268,448,863,1164,5453
3444,2017-2-13,Memphis Grizzlies,56,13640,2029,4701,0.432,516,1451,0.356,1513,3250,0.466,1071,1362,0.786,616,1814,2430,1161,468,700,1330,5645
3445,2017-2-13,Utah Jazz,55,13250,2011,4319,0.466,528,1449,0.364,1483,2870,0.517,980,1295,0.757,496,1862,2358,1078,371,714,1055,5530
3446,2017-2-13,Orlando Magic,56,13515,2127,4826,0.441,481,1458,0.33,1646,3368,0.489,841,1162,0.724,543,1851,2394,1247,381,723,1056,5576
3447,2017-2-13,Dallas Mavericks,54,13060,1967,4447,0.442,583,1619,0.36,1384,2828,0.489,787,981,0.802,434,1633,2067,1094,420,593,1043,5304
3448,2017-2-14,Golden State Warriors,55,13300,2409,4809,0.501,674,1735,0.388,1735,3074,0.564,1020,1290,0.791,487,1961,2448,1705,524,798,1061,6512
3449,2017-2-14,Houston Rockets,57,13780,2304,4947,0.466,827,2268,0.365,1477,2679,0.551,1094,1435,0.762,603,1908,2511,1454,473,846,1143,6529
3450,2017-2-14,Cleveland Cavaliers,53,12820,2104,4533,0.464,691,1772,0.39,1413,2761,0.512,996,1323,0.753,529,1808,2337,1181,390,721,952,5895
3451,2017-2-14,Denver Nuggets,55,13275,2235,4833,0.462,566,1527,0.371,1669,3306,0.505,1061,1392,0.762,702,1866,2568,1356,372,824,1083,6097
3452,2017-2-14,Toronto Raptors,55,13275,2184,4691,0.466,509,1368,0.372,1675,3323,0.504,1122,1396,0.804,593,1758,2351,1029,470,620,1154,5999
3453,2017-2-14,Boston Celtics,55,13275,2148,4710,0.456,670,1822,0.368,1478,2888,0.512,993,1216,0.817,506,1770,2276,1385,411,664,1126,5959
3454,2017-2-14,Los Angeles Clippers,55,13250,2164,4621,0.468,571,1505,0.379,1593,3116,0.511,1046,1402,0.746,516,1887,2403,1233,410,690,1121,5945
3455,2017-2-14,Washington Wizards,54,13085,2228,4675,0.477,480,1287,0.373,1748,3388,0.516,897,1144,0.784,555,1780,2335,1277,459,737,1149,5833
3456,2017-2-14,Portland Trail Blazers,55,13375,2171,4781,0.454,565,1573,0.359,1606,3208,0.501,1013,1293,0.783,559,1826,2385,1205,377,721,1205,5920
3457,2017-2-14,San Antonio Spurs,55,13250,2173,4574,0.475,497,1231,0.404,1676,3343,0.501,1026,1270,0.808,528,1874,2402,1308,440,703,1018,5869
3458,2017-2-14,Phoenix Suns,56,13565,2185,4916,0.444,446,1301,0.343,1739,3615,0.481,1143,1450,0.788,673,1810,2483,1029,464,840,1396,5959
3459,2017-2-14,New York Knicks,56,13615,2247,5021,0.448,517,1439,0.359,1730,3582,0.483,930,1197,0.777,697,1885,2582,1225,406,756,1165,5941
3460,2017-2-14,Oklahoma City Thunder,56,13540,2192,4881,0.449,465,1463,0.318,1727,3418,0.505,1073,1439,0.746,661,1922,2583,1175,434,824,1160,5922
3461,2017-2-14,Indiana Pacers,55,13325,2162,4648,0.465,458,1242,0.369,1704,3406,0.5,1029,1269,0.811,460,1813,2273,1234,467,742,1079,5811
3462,2017-2-14,Milwaukee Bucks,54,13035,2128,4468,0.476,462,1249,0.37,1666,3219,0.518,965,1269,0.76,502,1746,2248,1330,450,741,1099,5683
3463,2017-2-14,Brooklyn Nets,55,13275,2074,4704,0.441,602,1777,0.339,1472,2927,0.503,1031,1299,0.794,485,1925,2410,1160,384,907,1152,5781
3464,2017-2-14,Charlotte Hornets,55,13275,2070,4715,0.439,537,1527,0.352,1533,3188,0.481,1088,1352,0.805,494,1972,2466,1284,362,639,936,5765
3465,2017-2-14,Los Angeles Lakers,56,13440,2164,4860,0.445,521,1477,0.353,1643,3383,0.486,1013,1317,0.769,648,1818,2466,1157,432,817,1160,5862
3466,2017-2-14,Minnesota Timberwolves,55,13275,2141,4616,0.464,427,1222,0.349,1714,3394,0.505,1044,1323,0.789,627,1704,2331,1284,423,760,1129,5753
3467,2017-2-14,Atlanta Hawks,55,13375,2131,4675,0.456,492,1437,0.342,1639,3238,0.506,974,1333,0.731,555,1863,2418,1320,461,811,990,5728
3468,2017-2-14,New Orleans Pelicans,56,13615,2169,4870,0.445,530,1491,0.355,1639,3379,0.485,929,1243,0.747,481,1980,2461,1267,431,694,1040,5797
3469,2017-2-14,Sacramento Kings,55,13350,2062,4512,0.457,512,1401,0.365,1550,3111,0.498,1051,1349,0.779,500,1747,2247,1244,453,770,1158,5687
3470,2017-2-14,Chicago Bulls,55,13250,2096,4763,0.44,354,1119,0.316,1742,3644,0.478,1067,1340,0.796,709,1855,2564,1163,426,713,966,5613
3471,2017-2-14,Detroit Pistons,56,13490,2226,4886,0.456,429,1278,0.336,1797,3608,0.498,792,1075,0.737,577,1905,2482,1184,399,659,1012,5673
3472,2017-2-14,Miami Heat,56,13515,2161,4790,0.451,513,1442,0.356,1648,3348,0.492,832,1200,0.693,575,1873,2448,1179,393,713,1160,5667
3473,2017-2-14,Philadelphia 76ers,55,13300,2033,4643,0.438,567,1613,0.352,1466,3030,0.484,925,1217,0.76,521,1820,2341,1292,457,881,1185,5558
3474,2017-2-14,Memphis Grizzlies,57,13880,2068,4778,0.433,525,1473,0.356,1543,3305,0.467,1096,1389,0.789,621,1850,2471,1186,475,712,1346,5757
3475,2017-2-14,Utah Jazz,56,13490,2039,4406,0.463,532,1472,0.361,1507,2934,0.514,992,1313,0.756,508,1899,2407,1092,376,724,1066,5602
3476,2017-2-14,Orlando Magic,57,13755,2171,4916,0.442,489,1472,0.332,1682,3444,0.488,861,1191,0.723,558,1888,2446,1265,390,737,1078,5692
3477,2017-2-14,Dallas Mavericks,55,13300,2002,4524,0.443,592,1646,0.36,1410,2878,0.49,806,1006,0.801,438,1666,2104,1115,427,605,1059,5402
3478,2017-2-15,Golden State Warriors,55,13300,2409,4809,0.501,674,1735,0.388,1735,3074,0.564,1020,1290,0.791,487,1961,2448,1705,524,798,1061,6512
3479,2017-2-15,Houston Rockets,57,13780,2304,4947,0.466,827,2268,0.365,1477,2679,0.551,1094,1435,0.762,603,1908,2511,1454,473,846,1143,6529
3480,2017-2-15,Cleveland Cavaliers,54,13060,2148,4619,0.465,704,1811,0.389,1444,2808,0.514,1011,1345,0.752,538,1842,2380,1208,393,731,970,6011
3481,2017-2-15,Denver Nuggets,55,13275,2235,4833,0.462,566,1527,0.371,1669,3306,0.505,1061,1392,0.762,702,1866,2568,1356,372,824,1083,6097
3482,2017-2-15,Toronto Raptors,56,13515,2219,4768,0.465,514,1388,0.37,1705,3380,0.504,1141,1420,0.804,601,1784,2385,1044,479,636,1180,6093
3483,2017-2-15,Boston Celtics,55,13275,2148,4710,0.456,670,1822,0.368,1478,2888,0.512,993,1216,0.817,506,1770,2276,1385,411,664,1126,5959
3484,2017-2-15,Los Angeles Clippers,55,13250,2164,4621,0.468,571,1505,0.379,1593,3116,0.511,1046,1402,0.746,516,1887,2403,1233,410,690,1121,5945
3485,2017-2-15,Washington Wizards,54,13085,2228,4675,0.477,480,1287,0.373,1748,3388,0.516,897,1144,0.784,555,1780,2335,1277,459,737,1149,5833
3486,2017-2-15,Portland Trail Blazers,55,13375,2171,4781,0.454,565,1573,0.359,1606,3208,0.501,1013,1293,0.783,559,1826,2385,1205,377,721,1205,5920
3487,2017-2-15,San Antonio Spurs,55,13250,2173,4574,0.475,497,1231,0.404,1676,3343,0.501,1026,1270,0.808,528,1874,2402,1308,440,703,1018,5869
3488,2017-2-15,Phoenix Suns,56,13565,2185,4916,0.444,446,1301,0.343,1739,3615,0.481,1143,1450,0.788,673,1810,2483,1029,464,840,1396,5959
3489,2017-2-15,New York Knicks,56,13615,2247,5021,0.448,517,1439,0.359,1730,3582,0.483,930,1197,0.777,697,1885,2582,1225,406,756,1165,5941
3490,2017-2-15,Oklahoma City Thunder,56,13540,2192,4881,0.449,465,1463,0.318,1727,3418,0.505,1073,1439,0.746,661,1922,2583,1175,434,824,1160,5922
3491,2017-2-15,Indiana Pacers,55,13325,2162,4648,0.465,458,1242,0.369,1704,3406,0.5,1029,1269,0.811,460,1813,2273,1234,467,742,1079,5811
3492,2017-2-15,Milwaukee Bucks,54,13035,2128,4468,0.476,462,1249,0.37,1666,3219,0.518,965,1269,0.76,502,1746,2248,1330,450,741,1099,5683
3493,2017-2-15,Brooklyn Nets,55,13275,2074,4704,0.441,602,1777,0.339,1472,2927,0.503,1031,1299,0.794,485,1925,2410,1160,384,907,1152,5781
3494,2017-2-15,Charlotte Hornets,55,13275,2070,4715,0.439,537,1527,0.352,1533,3188,0.481,1088,1352,0.805,494,1972,2466,1284,362,639,936,5765
3495,2017-2-15,Minnesota Timberwolves,56,13515,2183,4702,0.464,436,1245,0.35,1747,3457,0.505,1059,1342,0.789,635,1737,2372,1311,429,769,1147,5861
3496,2017-2-15,Los Angeles Lakers,57,13680,2202,4943,0.445,533,1506,0.354,1669,3437,0.486,1021,1332,0.767,661,1848,2509,1179,442,834,1181,5958
3497,2017-2-15,Atlanta Hawks,55,13375,2131,4675,0.456,492,1437,0.342,1639,3238,0.506,974,1333,0.731,555,1863,2418,1320,461,811,990,5728
3498,2017-2-15,New Orleans Pelicans,56,13615,2169,4870,0.445,530,1491,0.355,1639,3379,0.485,929,1243,0.747,481,1980,2461,1267,431,694,1040,5797
3499,2017-2-15,Sacramento Kings,56,13590,2098,4585,0.458,519,1425,0.364,1579,3160,0.5,1069,1374,0.778,507,1778,2285,1267,462,787,1170,5784
3500,2017-2-15,Chicago Bulls,56,13490,2131,4836,0.441,361,1136,0.318,1770,3700,0.478,1095,1375,0.796,716,1885,2601,1185,434,730,989,5718
3501,2017-2-15,Detroit Pistons,56,13490,2226,4886,0.456,429,1278,0.336,1797,3608,0.498,792,1075,0.737,577,1905,2482,1184,399,659,1012,5673
3502,2017-2-15,Miami Heat,56,13515,2161,4790,0.451,513,1442,0.356,1648,3348,0.492,832,1200,0.693,575,1873,2448,1179,393,713,1160,5667
3503,2017-2-15,Philadelphia 76ers,55,13300,2033,4643,0.438,567,1613,0.352,1466,3030,0.484,925,1217,0.76,521,1820,2341,1292,457,881,1185,5558
3504,2017-2-15,Memphis Grizzlies,57,13880,2068,4778,0.433,525,1473,0.356,1543,3305,0.467,1096,1389,0.789,621,1850,2471,1186,475,712,1346,5757
3505,2017-2-15,Utah Jazz,56,13490,2039,4406,0.463,532,1472,0.361,1507,2934,0.514,992,1313,0.756,508,1899,2407,1092,376,724,1066,5602
3506,2017-2-15,Orlando Magic,57,13755,2171,4916,0.442,489,1472,0.332,1682,3444,0.488,861,1191,0.723,558,1888,2446,1265,390,737,1078,5692
3507,2017-2-15,Dallas Mavericks,55,13300,2002,4524,0.443,592,1646,0.36,1410,2878,0.49,806,1006,0.801,438,1666,2104,1115,427,605,1059,5402
3508,2017-2-16,Golden State Warriors,56,13540,2450,4893,0.501,687,1771,0.388,1763,3122,0.565,1034,1311,0.789,493,2001,2494,1737,534,806,1077,6621
3509,2017-2-16,Houston Rockets,58,14020,2340,5034,0.465,840,2308,0.364,1500,2726,0.55,1118,1466,0.763,618,1934,2552,1476,479,854,1166,6638
3510,2017-2-16,Cleveland Cavaliers,55,13300,2187,4701,0.465,722,1850,0.39,1465,2851,0.514,1028,1364,0.754,547,1873,2420,1231,399,739,989,6124
3511,2017-2-16,Denver Nuggets,56,13515,2273,4927,0.461,577,1561,0.37,1696,3366,0.504,1073,1410,0.761,716,1901,2617,1381,376,838,1102,6196
3512,2017-2-16,Boston Celtics,56,13515,2186,4790,0.456,683,1850,0.369,1503,2940,0.511,1020,1252,0.815,512,1803,2315,1406,424,686,1144,6075
3513,2017-2-16,Toronto Raptors,57,13755,2251,4852,0.464,526,1420,0.37,1725,3432,0.503,1155,1439,0.803,609,1822,2431,1063,487,650,1193,6183
3514,2017-2-16,Washington Wizards,54,13085,2228,4675,0.477,480,1287,0.373,1748,3388,0.516,897,1144,0.784,555,1780,2335,1277,459,737,1149,5833
3515,2017-2-16,Los Angeles Clippers,56,13490,2201,4700,0.468,585,1542,0.379,1616,3158,0.512,1057,1414,0.748,521,1922,2443,1257,428,706,1138,6044
3516,2017-2-16,Portland Trail Blazers,56,13615,2203,4860,0.453,574,1595,0.36,1629,3265,0.499,1028,1313,0.783,568,1858,2426,1219,386,737,1226,6008
3517,2017-2-16,Phoenix Suns,57,13805,2234,5004,0.446,456,1325,0.344,1778,3679,0.483,1172,1484,0.79,685,1857,2542,1061,471,855,1416,6096
3518,2017-2-16,San Antonio Spurs,56,13490,2215,4663,0.475,505,1262,0.4,1710,3401,0.503,1041,1289,0.808,539,1913,2452,1333,452,715,1034,5976
3519,2017-2-16,New York Knicks,57,13855,2288,5107,0.448,528,1460,0.362,1760,3647,0.483,942,1211,0.778,703,1918,2621,1244,414,771,1186,6046
3520,2017-2-16,Oklahoma City Thunder,57,13780,2233,4969,0.449,477,1486,0.321,1756,3483,0.504,1095,1470,0.745,673,1958,2631,1196,444,836,1173,6038
3521,2017-2-16,Milwaukee Bucks,55,13275,2178,4556,0.478,469,1264,0.371,1709,3292,0.519,987,1301,0.759,509,1778,2287,1357,466,751,1118,5812
3522,2017-2-16,Indiana Pacers,56,13565,2202,4734,0.465,470,1266,0.371,1732,3468,0.499,1041,1283,0.811,473,1843,2316,1264,469,753,1096,5915
3523,2017-2-16,Brooklyn Nets,56,13515,2120,4792,0.442,616,1813,0.34,1504,2979,0.505,1050,1322,0.794,494,1958,2452,1190,391,924,1173,5906
3524,2017-2-16,Minnesota Timberwolves,57,13755,2224,4788,0.464,442,1263,0.35,1782,3525,0.506,1083,1370,0.791,644,1773,2417,1331,441,776,1162,5973
3525,2017-2-16,Los Angeles Lakers,58,13920,2237,5036,0.444,542,1532,0.354,1695,3504,0.484,1043,1360,0.767,668,1877,2545,1195,451,846,1208,6059
3526,2017-2-16,Charlotte Hornets,56,13515,2102,4791,0.439,550,1565,0.351,1552,3226,0.481,1096,1361,0.805,499,2011,2510,1305,371,656,954,5850
3527,2017-2-16,Atlanta Hawks,56,13615,2163,4754,0.455,499,1463,0.341,1664,3291,0.506,987,1352,0.73,565,1898,2463,1340,466,831,1003,5812
3528,2017-2-16,New Orleans Pelicans,57,13855,2206,4945,0.446,538,1509,0.357,1668,3436,0.485,942,1265,0.745,485,2014,2499,1285,441,706,1063,5892
3529,2017-2-16,Sacramento Kings,57,13830,2131,4674,0.456,526,1449,0.363,1605,3225,0.498,1082,1391,0.778,519,1816,2335,1290,466,805,1187,5870
3530,2017-2-16,Chicago Bulls,56,13490,2131,4836,0.441,361,1136,0.318,1770,3700,0.478,1095,1375,0.796,716,1885,2601,1185,434,730,989,5718
3531,2017-2-16,Miami Heat,57,13755,2205,4874,0.452,526,1477,0.356,1679,3397,0.494,848,1224,0.693,587,1907,2494,1206,396,724,1180,5784
3532,2017-2-16,Detroit Pistons,57,13730,2262,4968,0.455,435,1297,0.335,1827,3671,0.498,812,1097,0.74,586,1951,2537,1199,401,674,1028,5771
3533,2017-2-16,Philadelphia 76ers,56,13540,2077,4736,0.439,575,1644,0.35,1502,3092,0.486,937,1235,0.759,533,1855,2388,1315,473,903,1208,5666
3534,2017-2-16,Memphis Grizzlies,58,14120,2101,4867,0.432,531,1506,0.353,1570,3361,0.467,1115,1414,0.789,634,1885,2519,1208,483,727,1365,5848
3535,2017-2-16,Utah Jazz,57,13730,2081,4487,0.464,543,1494,0.363,1538,2993,0.514,1008,1336,0.754,517,1936,2453,1111,385,738,1083,5713
3536,2017-2-16,Orlando Magic,58,13995,2201,4992,0.441,493,1490,0.331,1708,3502,0.488,876,1210,0.724,563,1916,2479,1280,395,754,1097,5771
3537,2017-2-16,Dallas Mavericks,56,13540,2037,4616,0.441,602,1683,0.358,1435,2933,0.489,817,1017,0.803,443,1700,2143,1137,437,611,1080,5493
3538,2017-2-17,Golden State Warriors,56,13540,2450,4893,0.501,687,1771,0.388,1763,3122,0.565,1034,1311,0.789,493,2001,2494,1737,534,806,1077,6621
3539,2017-2-17,Houston Rockets,58,14020,2340,5034,0.465,840,2308,0.364,1500,2726,0.55,1118,1466,0.763,618,1934,2552,1476,479,854,1166,6638
3540,2017-2-17,Cleveland Cavaliers,55,13300,2187,4701,0.465,722,1850,0.39,1465,2851,0.514,1028,1364,0.754,547,1873,2420,1231,399,739,989,6124
3541,2017-2-17,Denver Nuggets,56,13515,2273,4927,0.461,577,1561,0.37,1696,3366,0.504,1073,1410,0.761,716,1901,2617,1381,376,838,1102,6196
3542,2017-2-17,Toronto Raptors,57,13755,2251,4852,0.464,526,1420,0.37,1725,3432,0.503,1155,1439,0.803,609,1822,2431,1063,487,650,1193,6183
3543,2017-2-17,Boston Celtics,57,13755,2222,4867,0.457,697,1887,0.369,1525,2980,0.512,1037,1272,0.815,516,1830,2346,1430,426,693,1162,6178
3544,2017-2-17,Washington Wizards,55,13325,2271,4758,0.477,495,1316,0.376,1776,3442,0.516,907,1159,0.783,563,1811,2374,1300,464,747,1168,5944
3545,2017-2-17,Los Angeles Clippers,56,13490,2201,4700,0.468,585,1542,0.379,1616,3158,0.512,1057,1414,0.748,521,1922,2443,1257,428,706,1138,6044
3546,2017-2-17,Portland Trail Blazers,56,13615,2203,4860,0.453,574,1595,0.36,1629,3265,0.499,1028,1313,0.783,568,1858,2426,1219,386,737,1226,6008
3547,2017-2-17,Phoenix Suns,57,13805,2234,5004,0.446,456,1325,0.344,1778,3679,0.483,1172,1484,0.79,685,1857,2542,1061,471,855,1416,6096
3548,2017-2-17,San Antonio Spurs,56,13490,2215,4663,0.475,505,1262,0.4,1710,3401,0.503,1041,1289,0.808,539,1913,2452,1333,452,715,1034,5976
3549,2017-2-17,New York Knicks,57,13855,2288,5107,0.448,528,1460,0.362,1760,3647,0.483,942,1211,0.778,703,1918,2621,1244,414,771,1186,6046
3550,2017-2-17,Oklahoma City Thunder,57,13780,2233,4969,0.449,477,1486,0.321,1756,3483,0.504,1095,1470,0.745,673,1958,2631,1196,444,836,1173,6038
3551,2017-2-17,Milwaukee Bucks,55,13275,2178,4556,0.478,469,1264,0.371,1709,3292,0.519,987,1301,0.759,509,1778,2287,1357,466,751,1118,5812
3552,2017-2-17,Brooklyn Nets,56,13515,2120,4792,0.442,616,1813,0.34,1504,2979,0.505,1050,1322,0.794,494,1958,2452,1190,391,924,1173,5906
3553,2017-2-17,Indiana Pacers,57,13805,2242,4814,0.466,474,1284,0.369,1768,3530,0.501,1055,1301,0.811,478,1873,2351,1285,476,764,1108,6013
3554,2017-2-17,Minnesota Timberwolves,57,13755,2224,4788,0.464,442,1263,0.35,1782,3525,0.506,1083,1370,0.791,644,1773,2417,1331,441,776,1162,5973
3555,2017-2-17,Los Angeles Lakers,58,13920,2237,5036,0.444,542,1532,0.354,1695,3504,0.484,1043,1360,0.767,668,1877,2545,1195,451,846,1208,6059
3556,2017-2-17,Charlotte Hornets,56,13515,2102,4791,0.439,550,1565,0.351,1552,3226,0.481,1096,1361,0.805,499,2011,2510,1305,371,656,954,5850
3557,2017-2-17,Atlanta Hawks,56,13615,2163,4754,0.455,499,1463,0.341,1664,3291,0.506,987,1352,0.73,565,1898,2463,1340,466,831,1003,5812
3558,2017-2-17,New Orleans Pelicans,57,13855,2206,4945,0.446,538,1509,0.357,1668,3436,0.485,942,1265,0.745,485,2014,2499,1285,441,706,1063,5892
3559,2017-2-17,Sacramento Kings,57,13830,2131,4674,0.456,526,1449,0.363,1605,3225,0.498,1082,1391,0.778,519,1816,2335,1290,466,805,1187,5870
3560,2017-2-17,Chicago Bulls,57,13730,2169,4926,0.44,367,1161,0.316,1802,3765,0.479,1117,1397,0.8,731,1921,2652,1208,436,737,1002,5822
3561,2017-2-17,Miami Heat,57,13755,2205,4874,0.452,526,1477,0.356,1679,3397,0.494,848,1224,0.693,587,1907,2494,1206,396,724,1180,5784
3562,2017-2-17,Detroit Pistons,57,13730,2262,4968,0.455,435,1297,0.335,1827,3671,0.498,812,1097,0.74,586,1951,2537,1199,401,674,1028,5771
3563,2017-2-17,Philadelphia 76ers,56,13540,2077,4736,0.439,575,1644,0.35,1502,3092,0.486,937,1235,0.759,533,1855,2388,1315,473,903,1208,5666
3564,2017-2-17,Memphis Grizzlies,58,14120,2101,4867,0.432,531,1506,0.353,1570,3361,0.467,1115,1414,0.789,634,1885,2519,1208,483,727,1365,5848
3565,2017-2-17,Utah Jazz,57,13730,2081,4487,0.464,543,1494,0.363,1538,2993,0.514,1008,1336,0.754,517,1936,2453,1111,385,738,1083,5713
3566,2017-2-17,Orlando Magic,58,13995,2201,4992,0.441,493,1490,0.331,1708,3502,0.488,876,1210,0.724,563,1916,2479,1280,395,754,1097,5771
3567,2017-2-17,Dallas Mavericks,56,13540,2037,4616,0.441,602,1683,0.358,1435,2933,0.489,817,1017,0.803,443,1700,2143,1137,437,611,1080,5493
3568,2017-2-18,Golden State Warriors,56,13540,2450,4893,0.501,687,1771,0.388,1763,3122,0.565,1034,1311,0.789,493,2001,2494,1737,534,806,1077,6621
3569,2017-2-18,Houston Rockets,58,14020,2340,5034,0.465,840,2308,0.364,1500,2726,0.55,1118,1466,0.763,618,1934,2552,1476,479,854,1166,6638
3570,2017-2-18,Cleveland Cavaliers,55,13300,2187,4701,0.465,722,1850,0.39,1465,2851,0.514,1028,1364,0.754,547,1873,2420,1231,399,739,989,6124
3571,2017-2-18,Denver Nuggets,56,13515,2273,4927,0.461,577,1561,0.37,1696,3366,0.504,1073,1410,0.761,716,1901,2617,1381,376,838,1102,6196
3572,2017-2-18,Toronto Raptors,57,13755,2251,4852,0.464,526,1420,0.37,1725,3432,0.503,1155,1439,0.803,609,1822,2431,1063,487,650,1193,6183
3573,2017-2-18,Boston Celtics,57,13755,2222,4867,0.457,697,1887,0.369,1525,2980,0.512,1037,1272,0.815,516,1830,2346,1430,426,693,1162,6178
3574,2017-2-18,Washington Wizards,55,13325,2271,4758,0.477,495,1316,0.376,1776,3442,0.516,907,1159,0.783,563,1811,2374,1300,464,747,1168,5944
3575,2017-2-18,Los Angeles Clippers,56,13490,2201,4700,0.468,585,1542,0.379,1616,3158,0.512,1057,1414,0.748,521,1922,2443,1257,428,706,1138,6044
3576,2017-2-18,Portland Trail Blazers,56,13615,2203,4860,0.453,574,1595,0.36,1629,3265,0.499,1028,1313,0.783,568,1858,2426,1219,386,737,1226,6008
3577,2017-2-18,Phoenix Suns,57,13805,2234,5004,0.446,456,1325,0.344,1778,3679,0.483,1172,1484,0.79,685,1857,2542,1061,471,855,1416,6096
3578,2017-2-18,San Antonio Spurs,56,13490,2215,4663,0.475,505,1262,0.4,1710,3401,0.503,1041,1289,0.808,539,1913,2452,1333,452,715,1034,5976
3579,2017-2-18,New York Knicks,57,13855,2288,5107,0.448,528,1460,0.362,1760,3647,0.483,942,1211,0.778,703,1918,2621,1244,414,771,1186,6046
3580,2017-2-18,Oklahoma City Thunder,57,13780,2233,4969,0.449,477,1486,0.321,1756,3483,0.504,1095,1470,0.745,673,1958,2631,1196,444,836,1173,6038
3581,2017-2-18,Milwaukee Bucks,55,13275,2178,4556,0.478,469,1264,0.371,1709,3292,0.519,987,1301,0.759,509,1778,2287,1357,466,751,1118,5812
3582,2017-2-18,Brooklyn Nets,56,13515,2120,4792,0.442,616,1813,0.34,1504,2979,0.505,1050,1322,0.794,494,1958,2452,1190,391,924,1173,5906
3583,2017-2-18,Indiana Pacers,57,13805,2242,4814,0.466,474,1284,0.369,1768,3530,0.501,1055,1301,0.811,478,1873,2351,1285,476,764,1108,6013
3584,2017-2-18,Minnesota Timberwolves,57,13755,2224,4788,0.464,442,1263,0.35,1782,3525,0.506,1083,1370,0.791,644,1773,2417,1331,441,776,1162,5973
3585,2017-2-18,Los Angeles Lakers,58,13920,2237,5036,0.444,542,1532,0.354,1695,3504,0.484,1043,1360,0.767,668,1877,2545,1195,451,846,1208,6059
3586,2017-2-18,Charlotte Hornets,56,13515,2102,4791,0.439,550,1565,0.351,1552,3226,0.481,1096,1361,0.805,499,2011,2510,1305,371,656,954,5850
3587,2017-2-18,Atlanta Hawks,56,13615,2163,4754,0.455,499,1463,0.341,1664,3291,0.506,987,1352,0.73,565,1898,2463,1340,466,831,1003,5812
3588,2017-2-18,New Orleans Pelicans,57,13855,2206,4945,0.446,538,1509,0.357,1668,3436,0.485,942,1265,0.745,485,2014,2499,1285,441,706,1063,5892
3589,2017-2-18,Sacramento Kings,57,13830,2131,4674,0.456,526,1449,0.363,1605,3225,0.498,1082,1391,0.778,519,1816,2335,1290,466,805,1187,5870
3590,2017-2-18,Chicago Bulls,57,13730,2169,4926,0.44,367,1161,0.316,1802,3765,0.479,1117,1397,0.8,731,1921,2652,1208,436,737,1002,5822
3591,2017-2-18,Miami Heat,57,13755,2205,4874,0.452,526,1477,0.356,1679,3397,0.494,848,1224,0.693,587,1907,2494,1206,396,724,1180,5784
3592,2017-2-18,Detroit Pistons,57,13730,2262,4968,0.455,435,1297,0.335,1827,3671,0.498,812,1097,0.74,586,1951,2537,1199,401,674,1028,5771
3593,2017-2-18,Philadelphia 76ers,56,13540,2077,4736,0.439,575,1644,0.35,1502,3092,0.486,937,1235,0.759,533,1855,2388,1315,473,903,1208,5666
3594,2017-2-18,Memphis Grizzlies,58,14120,2101,4867,0.432,531,1506,0.353,1570,3361,0.467,1115,1414,0.789,634,1885,2519,1208,483,727,1365,5848
3595,2017-2-18,Utah Jazz,57,13730,2081,4487,0.464,543,1494,0.363,1538,2993,0.514,1008,1336,0.754,517,1936,2453,1111,385,738,1083,5713
3596,2017-2-18,Orlando Magic,58,13995,2201,4992,0.441,493,1490,0.331,1708,3502,0.488,876,1210,0.724,563,1916,2479,1280,395,754,1097,5771
3597,2017-2-18,Dallas Mavericks,56,13540,2037,4616,0.441,602,1683,0.358,1435,2933,0.489,817,1017,0.803,443,1700,2143,1137,437,611,1080,5493
3598,2017-2-19,Golden State Warriors,56,13540,2450,4893,0.501,687,1771,0.388,1763,3122,0.565,1034,1311,0.789,493,2001,2494,1737,534,806,1077,6621
3599,2017-2-19,Houston Rockets,58,14020,2340,5034,0.465,840,2308,0.364,1500,2726,0.55,1118,1466,0.763,618,1934,2552,1476,479,854,1166,6638
3600,2017-2-19,Cleveland Cavaliers,55,13300,2187,4701,0.465,722,1850,0.39,1465,2851,0.514,1028,1364,0.754,547,1873,2420,1231,399,739,989,6124
3601,2017-2-19,Denver Nuggets,56,13515,2273,4927,0.461,577,1561,0.37,1696,3366,0.504,1073,1410,0.761,716,1901,2617,1381,376,838,1102,6196
3602,2017-2-19,Toronto Raptors,57,13755,2251,4852,0.464,526,1420,0.37,1725,3432,0.503,1155,1439,0.803,609,1822,2431,1063,487,650,1193,6183
3603,2017-2-19,Boston Celtics,57,13755,2222,4867,0.457,697,1887,0.369,1525,2980,0.512,1037,1272,0.815,516,1830,2346,1430,426,693,1162,6178
3604,2017-2-19,Washington Wizards,55,13325,2271,4758,0.477,495,1316,0.376,1776,3442,0.516,907,1159,0.783,563,1811,2374,1300,464,747,1168,5944
3605,2017-2-19,Los Angeles Clippers,56,13490,2201,4700,0.468,585,1542,0.379,1616,3158,0.512,1057,1414,0.748,521,1922,2443,1257,428,706,1138,6044
3606,2017-2-19,Portland Trail Blazers,56,13615,2203,4860,0.453,574,1595,0.36,1629,3265,0.499,1028,1313,0.783,568,1858,2426,1219,386,737,1226,6008
3607,2017-2-19,Phoenix Suns,57,13805,2234,5004,0.446,456,1325,0.344,1778,3679,0.483,1172,1484,0.79,685,1857,2542,1061,471,855,1416,6096
3608,2017-2-19,San Antonio Spurs,56,13490,2215,4663,0.475,505,1262,0.4,1710,3401,0.503,1041,1289,0.808,539,1913,2452,1333,452,715,1034,5976
3609,2017-2-19,New York Knicks,57,13855,2288,5107,0.448,528,1460,0.362,1760,3647,0.483,942,1211,0.778,703,1918,2621,1244,414,771,1186,6046
3610,2017-2-19,Oklahoma City Thunder,57,13780,2233,4969,0.449,477,1486,0.321,1756,3483,0.504,1095,1470,0.745,673,1958,2631,1196,444,836,1173,6038
3611,2017-2-19,Milwaukee Bucks,55,13275,2178,4556,0.478,469,1264,0.371,1709,3292,0.519,987,1301,0.759,509,1778,2287,1357,466,751,1118,5812
3612,2017-2-19,Brooklyn Nets,56,13515,2120,4792,0.442,616,1813,0.34,1504,2979,0.505,1050,1322,0.794,494,1958,2452,1190,391,924,1173,5906
3613,2017-2-19,Indiana Pacers,57,13805,2242,4814,0.466,474,1284,0.369,1768,3530,0.501,1055,1301,0.811,478,1873,2351,1285,476,764,1108,6013
3614,2017-2-19,Minnesota Timberwolves,57,13755,2224,4788,0.464,442,1263,0.35,1782,3525,0.506,1083,1370,0.791,644,1773,2417,1331,441,776,1162,5973
3615,2017-2-19,Los Angeles Lakers,58,13920,2237,5036,0.444,542,1532,0.354,1695,3504,0.484,1043,1360,0.767,668,1877,2545,1195,451,846,1208,6059
3616,2017-2-19,Charlotte Hornets,56,13515,2102,4791,0.439,550,1565,0.351,1552,3226,0.481,1096,1361,0.805,499,2011,2510,1305,371,656,954,5850
3617,2017-2-19,Atlanta Hawks,56,13615,2163,4754,0.455,499,1463,0.341,1664,3291,0.506,987,1352,0.73,565,1898,2463,1340,466,831,1003,5812
3618,2017-2-19,New Orleans Pelicans,57,13855,2206,4945,0.446,538,1509,0.357,1668,3436,0.485,942,1265,0.745,485,2014,2499,1285,441,706,1063,5892
3619,2017-2-19,Sacramento Kings,57,13830,2131,4674,0.456,526,1449,0.363,1605,3225,0.498,1082,1391,0.778,519,1816,2335,1290,466,805,1187,5870
3620,2017-2-19,Chicago Bulls,57,13730,2169,4926,0.44,367,1161,0.316,1802,3765,0.479,1117,1397,0.8,731,1921,2652,1208,436,737,1002,5822
3621,2017-2-19,Miami Heat,57,13755,2205,4874,0.452,526,1477,0.356,1679,3397,0.494,848,1224,0.693,587,1907,2494,1206,396,724,1180,5784
3622,2017-2-19,Detroit Pistons,57,13730,2262,4968,0.455,435,1297,0.335,1827,3671,0.498,812,1097,0.74,586,1951,2537,1199,401,674,1028,5771
3623,2017-2-19,Philadelphia 76ers,56,13540,2077,4736,0.439,575,1644,0.35,1502,3092,0.486,937,1235,0.759,533,1855,2388,1315,473,903,1208,5666
3624,2017-2-19,Memphis Grizzlies,58,14120,2101,4867,0.432,531,1506,0.353,1570,3361,0.467,1115,1414,0.789,634,1885,2519,1208,483,727,1365,5848
3625,2017-2-19,Utah Jazz,57,13730,2081,4487,0.464,543,1494,0.363,1538,2993,0.514,1008,1336,0.754,517,1936,2453,1111,385,738,1083,5713
3626,2017-2-19,Orlando Magic,58,13995,2201,4992,0.441,493,1490,0.331,1708,3502,0.488,876,1210,0.724,563,1916,2479,1280,395,754,1097,5771
3627,2017-2-19,Dallas Mavericks,56,13540,2037,4616,0.441,602,1683,0.358,1435,2933,0.489,817,1017,0.803,443,1700,2143,1137,437,611,1080,5493
3628,2017-2-20,Golden State Warriors,56,13540,2450,4893,0.501,687,1771,0.388,1763,3122,0.565,1034,1311,0.789,493,2001,2494,1737,534,806,1077,6621
3629,2017-2-20,Houston Rockets,58,14020,2340,5034,0.465,840,2308,0.364,1500,2726,0.55,1118,1466,0.763,618,1934,2552,1476,479,854,1166,6638
3630,2017-2-20,Cleveland Cavaliers,55,13300,2187,4701,0.465,722,1850,0.39,1465,2851,0.514,1028,1364,0.754,547,1873,2420,1231,399,739,989,6124
3631,2017-2-20,Denver Nuggets,56,13515,2273,4927,0.461,577,1561,0.37,1696,3366,0.504,1073,1410,0.761,716,1901,2617,1381,376,838,1102,6196
3632,2017-2-20,Toronto Raptors,57,13755,2251,4852,0.464,526,1420,0.37,1725,3432,0.503,1155,1439,0.803,609,1822,2431,1063,487,650,1193,6183
3633,2017-2-20,Boston Celtics,57,13755,2222,4867,0.457,697,1887,0.369,1525,2980,0.512,1037,1272,0.815,516,1830,2346,1430,426,693,1162,6178
3634,2017-2-20,Washington Wizards,55,13325,2271,4758,0.477,495,1316,0.376,1776,3442,0.516,907,1159,0.783,563,1811,2374,1300,464,747,1168,5944
3635,2017-2-20,Los Angeles Clippers,56,13490,2201,4700,0.468,585,1542,0.379,1616,3158,0.512,1057,1414,0.748,521,1922,2443,1257,428,706,1138,6044
3636,2017-2-20,Portland Trail Blazers,56,13615,2203,4860,0.453,574,1595,0.36,1629,3265,0.499,1028,1313,0.783,568,1858,2426,1219,386,737,1226,6008
3637,2017-2-20,Phoenix Suns,57,13805,2234,5004,0.446,456,1325,0.344,1778,3679,0.483,1172,1484,0.79,685,1857,2542,1061,471,855,1416,6096
3638,2017-2-20,San Antonio Spurs,56,13490,2215,4663,0.475,505,1262,0.4,1710,3401,0.503,1041,1289,0.808,539,1913,2452,1333,452,715,1034,5976
3639,2017-2-20,New York Knicks,57,13855,2288,5107,0.448,528,1460,0.362,1760,3647,0.483,942,1211,0.778,703,1918,2621,1244,414,771,1186,6046
3640,2017-2-20,Oklahoma City Thunder,57,13780,2233,4969,0.449,477,1486,0.321,1756,3483,0.504,1095,1470,0.745,673,1958,2631,1196,444,836,1173,6038
3641,2017-2-20,Milwaukee Bucks,55,13275,2178,4556,0.478,469,1264,0.371,1709,3292,0.519,987,1301,0.759,509,1778,2287,1357,466,751,1118,5812
3642,2017-2-20,Brooklyn Nets,56,13515,2120,4792,0.442,616,1813,0.34,1504,2979,0.505,1050,1322,0.794,494,1958,2452,1190,391,924,1173,5906
3643,2017-2-20,Indiana Pacers,57,13805,2242,4814,0.466,474,1284,0.369,1768,3530,0.501,1055,1301,0.811,478,1873,2351,1285,476,764,1108,6013
3644,2017-2-20,Minnesota Timberwolves,57,13755,2224,4788,0.464,442,1263,0.35,1782,3525,0.506,1083,1370,0.791,644,1773,2417,1331,441,776,1162,5973
3645,2017-2-20,Los Angeles Lakers,58,13920,2237,5036,0.444,542,1532,0.354,1695,3504,0.484,1043,1360,0.767,668,1877,2545,1195,451,846,1208,6059
3646,2017-2-20,Charlotte Hornets,56,13515,2102,4791,0.439,550,1565,0.351,1552,3226,0.481,1096,1361,0.805,499,2011,2510,1305,371,656,954,5850
3647,2017-2-20,Atlanta Hawks,56,13615,2163,4754,0.455,499,1463,0.341,1664,3291,0.506,987,1352,0.73,565,1898,2463,1340,466,831,1003,5812
3648,2017-2-20,New Orleans Pelicans,57,13855,2206,4945,0.446,538,1509,0.357,1668,3436,0.485,942,1265,0.745,485,2014,2499,1285,441,706,1063,5892
3649,2017-2-20,Sacramento Kings,57,13830,2131,4674,0.456,526,1449,0.363,1605,3225,0.498,1082,1391,0.778,519,1816,2335,1290,466,805,1187,5870
3650,2017-2-20,Chicago Bulls,57,13730,2169,4926,0.44,367,1161,0.316,1802,3765,0.479,1117,1397,0.8,731,1921,2652,1208,436,737,1002,5822
3651,2017-2-20,Miami Heat,57,13755,2205,4874,0.452,526,1477,0.356,1679,3397,0.494,848,1224,0.693,587,1907,2494,1206,396,724,1180,5784
3652,2017-2-20,Detroit Pistons,57,13730,2262,4968,0.455,435,1297,0.335,1827,3671,0.498,812,1097,0.74,586,1951,2537,1199,401,674,1028,5771
3653,2017-2-20,Philadelphia 76ers,56,13540,2077,4736,0.439,575,1644,0.35,1502,3092,0.486,937,1235,0.759,533,1855,2388,1315,473,903,1208,5666
3654,2017-2-20,Memphis Grizzlies,58,14120,2101,4867,0.432,531,1506,0.353,1570,3361,0.467,1115,1414,0.789,634,1885,2519,1208,483,727,1365,5848
3655,2017-2-20,Utah Jazz,57,13730,2081,4487,0.464,543,1494,0.363,1538,2993,0.514,1008,1336,0.754,517,1936,2453,1111,385,738,1083,5713
3656,2017-2-20,Orlando Magic,58,13995,2201,4992,0.441,493,1490,0.331,1708,3502,0.488,876,1210,0.724,563,1916,2479,1280,395,754,1097,5771
3657,2017-2-20,Dallas Mavericks,56,13540,2037,4616,0.441,602,1683,0.358,1435,2933,0.489,817,1017,0.803,443,1700,2143,1137,437,611,1080,5493
3658,2017-2-21,Golden State Warriors,56,13540,2450,4893,0.501,687,1771,0.388,1763,3122,0.565,1034,1311,0.789,493,2001,2494,1737,534,806,1077,6621
3659,2017-2-21,Houston Rockets,58,14020,2340,5034,0.465,840,2308,0.364,1500,2726,0.55,1118,1466,0.763,618,1934,2552,1476,479,854,1166,6638
3660,2017-2-21,Cleveland Cavaliers,55,13300,2187,4701,0.465,722,1850,0.39,1465,2851,0.514,1028,1364,0.754,547,1873,2420,1231,399,739,989,6124
3661,2017-2-21,Denver Nuggets,56,13515,2273,4927,0.461,577,1561,0.37,1696,3366,0.504,1073,1410,0.761,716,1901,2617,1381,376,838,1102,6196
3662,2017-2-21,Toronto Raptors,57,13755,2251,4852,0.464,526,1420,0.37,1725,3432,0.503,1155,1439,0.803,609,1822,2431,1063,487,650,1193,6183
3663,2017-2-21,Boston Celtics,57,13755,2222,4867,0.457,697,1887,0.369,1525,2980,0.512,1037,1272,0.815,516,1830,2346,1430,426,693,1162,6178
3664,2017-2-21,Washington Wizards,55,13325,2271,4758,0.477,495,1316,0.376,1776,3442,0.516,907,1159,0.783,563,1811,2374,1300,464,747,1168,5944
3665,2017-2-21,Los Angeles Clippers,56,13490,2201,4700,0.468,585,1542,0.379,1616,3158,0.512,1057,1414,0.748,521,1922,2443,1257,428,706,1138,6044
3666,2017-2-21,Portland Trail Blazers,56,13615,2203,4860,0.453,574,1595,0.36,1629,3265,0.499,1028,1313,0.783,568,1858,2426,1219,386,737,1226,6008
3667,2017-2-21,Phoenix Suns,57,13805,2234,5004,0.446,456,1325,0.344,1778,3679,0.483,1172,1484,0.79,685,1857,2542,1061,471,855,1416,6096
3668,2017-2-21,San Antonio Spurs,56,13490,2215,4663,0.475,505,1262,0.4,1710,3401,0.503,1041,1289,0.808,539,1913,2452,1333,452,715,1034,5976
3669,2017-2-21,New York Knicks,57,13855,2288,5107,0.448,528,1460,0.362,1760,3647,0.483,942,1211,0.778,703,1918,2621,1244,414,771,1186,6046
3670,2017-2-21,Oklahoma City Thunder,57,13780,2233,4969,0.449,477,1486,0.321,1756,3483,0.504,1095,1470,0.745,673,1958,2631,1196,444,836,1173,6038
3671,2017-2-21,Milwaukee Bucks,55,13275,2178,4556,0.478,469,1264,0.371,1709,3292,0.519,987,1301,0.759,509,1778,2287,1357,466,751,1118,5812
3672,2017-2-21,Brooklyn Nets,56,13515,2120,4792,0.442,616,1813,0.34,1504,2979,0.505,1050,1322,0.794,494,1958,2452,1190,391,924,1173,5906
3673,2017-2-21,Indiana Pacers,57,13805,2242,4814,0.466,474,1284,0.369,1768,3530,0.501,1055,1301,0.811,478,1873,2351,1285,476,764,1108,6013
3674,2017-2-21,Minnesota Timberwolves,57,13755,2224,4788,0.464,442,1263,0.35,1782,3525,0.506,1083,1370,0.791,644,1773,2417,1331,441,776,1162,5973
3675,2017-2-21,Los Angeles Lakers,58,13920,2237,5036,0.444,542,1532,0.354,1695,3504,0.484,1043,1360,0.767,668,1877,2545,1195,451,846,1208,6059
3676,2017-2-21,Charlotte Hornets,56,13515,2102,4791,0.439,550,1565,0.351,1552,3226,0.481,1096,1361,0.805,499,2011,2510,1305,371,656,954,5850
3677,2017-2-21,Atlanta Hawks,56,13615,2163,4754,0.455,499,1463,0.341,1664,3291,0.506,987,1352,0.73,565,1898,2463,1340,466,831,1003,5812
3678,2017-2-21,New Orleans Pelicans,57,13855,2206,4945,0.446,538,1509,0.357,1668,3436,0.485,942,1265,0.745,485,2014,2499,1285,441,706,1063,5892
3679,2017-2-21,Sacramento Kings,57,13830,2131,4674,0.456,526,1449,0.363,1605,3225,0.498,1082,1391,0.778,519,1816,2335,1290,466,805,1187,5870
3680,2017-2-21,Chicago Bulls,57,13730,2169,4926,0.44,367,1161,0.316,1802,3765,0.479,1117,1397,0.8,731,1921,2652,1208,436,737,1002,5822
3681,2017-2-21,Miami Heat,57,13755,2205,4874,0.452,526,1477,0.356,1679,3397,0.494,848,1224,0.693,587,1907,2494,1206,396,724,1180,5784
3682,2017-2-21,Detroit Pistons,57,13730,2262,4968,0.455,435,1297,0.335,1827,3671,0.498,812,1097,0.74,586,1951,2537,1199,401,674,1028,5771
3683,2017-2-21,Philadelphia 76ers,56,13540,2077,4736,0.439,575,1644,0.35,1502,3092,0.486,937,1235,0.759,533,1855,2388,1315,473,903,1208,5666
3684,2017-2-21,Memphis Grizzlies,58,14120,2101,4867,0.432,531,1506,0.353,1570,3361,0.467,1115,1414,0.789,634,1885,2519,1208,483,727,1365,5848
3685,2017-2-21,Utah Jazz,57,13730,2081,4487,0.464,543,1494,0.363,1538,2993,0.514,1008,1336,0.754,517,1936,2453,1111,385,738,1083,5713
3686,2017-2-21,Orlando Magic,58,13995,2201,4992,0.441,493,1490,0.331,1708,3502,0.488,876,1210,0.724,563,1916,2479,1280,395,754,1097,5771
3687,2017-2-21,Dallas Mavericks,56,13540,2037,4616,0.441,602,1683,0.358,1435,2933,0.489,817,1017,0.803,443,1700,2143,1137,437,611,1080,5493
3688,2017-2-22,Golden State Warriors,56,13540,2450,4893,0.501,687,1771,0.388,1763,3122,0.565,1034,1311,0.789,493,2001,2494,1737,534,806,1077,6621
3689,2017-2-22,Houston Rockets,58,14020,2340,5034,0.465,840,2308,0.364,1500,2726,0.55,1118,1466,0.763,618,1934,2552,1476,479,854,1166,6638
3690,2017-2-22,Cleveland Cavaliers,55,13300,2187,4701,0.465,722,1850,0.39,1465,2851,0.514,1028,1364,0.754,547,1873,2420,1231,399,739,989,6124
3691,2017-2-22,Denver Nuggets,56,13515,2273,4927,0.461,577,1561,0.37,1696,3366,0.504,1073,1410,0.761,716,1901,2617,1381,376,838,1102,6196
3692,2017-2-22,Toronto Raptors,57,13755,2251,4852,0.464,526,1420,0.37,1725,3432,0.503,1155,1439,0.803,609,1822,2431,1063,487,650,1193,6183
3693,2017-2-22,Boston Celtics,57,13755,2222,4867,0.457,697,1887,0.369,1525,2980,0.512,1037,1272,0.815,516,1830,2346,1430,426,693,1162,6178
3694,2017-2-22,Washington Wizards,55,13325,2271,4758,0.477,495,1316,0.376,1776,3442,0.516,907,1159,0.783,563,1811,2374,1300,464,747,1168,5944
3695,2017-2-22,Los Angeles Clippers,56,13490,2201,4700,0.468,585,1542,0.379,1616,3158,0.512,1057,1414,0.748,521,1922,2443,1257,428,706,1138,6044
3696,2017-2-22,Portland Trail Blazers,56,13615,2203,4860,0.453,574,1595,0.36,1629,3265,0.499,1028,1313,0.783,568,1858,2426,1219,386,737,1226,6008
3697,2017-2-22,Phoenix Suns,57,13805,2234,5004,0.446,456,1325,0.344,1778,3679,0.483,1172,1484,0.79,685,1857,2542,1061,471,855,1416,6096
3698,2017-2-22,San Antonio Spurs,56,13490,2215,4663,0.475,505,1262,0.4,1710,3401,0.503,1041,1289,0.808,539,1913,2452,1333,452,715,1034,5976
3699,2017-2-22,New York Knicks,57,13855,2288,5107,0.448,528,1460,0.362,1760,3647,0.483,942,1211,0.778,703,1918,2621,1244,414,771,1186,6046
3700,2017-2-22,Oklahoma City Thunder,57,13780,2233,4969,0.449,477,1486,0.321,1756,3483,0.504,1095,1470,0.745,673,1958,2631,1196,444,836,1173,6038
3701,2017-2-22,Milwaukee Bucks,55,13275,2178,4556,0.478,469,1264,0.371,1709,3292,0.519,987,1301,0.759,509,1778,2287,1357,466,751,1118,5812
3702,2017-2-22,Brooklyn Nets,56,13515,2120,4792,0.442,616,1813,0.34,1504,2979,0.505,1050,1322,0.794,494,1958,2452,1190,391,924,1173,5906
3703,2017-2-22,Indiana Pacers,57,13805,2242,4814,0.466,474,1284,0.369,1768,3530,0.501,1055,1301,0.811,478,1873,2351,1285,476,764,1108,6013
3704,2017-2-22,Minnesota Timberwolves,57,13755,2224,4788,0.464,442,1263,0.35,1782,3525,0.506,1083,1370,0.791,644,1773,2417,1331,441,776,1162,5973
3705,2017-2-22,Los Angeles Lakers,58,13920,2237,5036,0.444,542,1532,0.354,1695,3504,0.484,1043,1360,0.767,668,1877,2545,1195,451,846,1208,6059
3706,2017-2-22,Charlotte Hornets,56,13515,2102,4791,0.439,550,1565,0.351,1552,3226,0.481,1096,1361,0.805,499,2011,2510,1305,371,656,954,5850
3707,2017-2-22,Atlanta Hawks,56,13615,2163,4754,0.455,499,1463,0.341,1664,3291,0.506,987,1352,0.73,565,1898,2463,1340,466,831,1003,5812
3708,2017-2-22,New Orleans Pelicans,57,13855,2206,4945,0.446,538,1509,0.357,1668,3436,0.485,942,1265,0.745,485,2014,2499,1285,441,706,1063,5892
3709,2017-2-22,Sacramento Kings,57,13830,2131,4674,0.456,526,1449,0.363,1605,3225,0.498,1082,1391,0.778,519,1816,2335,1290,466,805,1187,5870
3710,2017-2-22,Chicago Bulls,57,13730,2169,4926,0.44,367,1161,0.316,1802,3765,0.479,1117,1397,0.8,731,1921,2652,1208,436,737,1002,5822
3711,2017-2-22,Miami Heat,57,13755,2205,4874,0.452,526,1477,0.356,1679,3397,0.494,848,1224,0.693,587,1907,2494,1206,396,724,1180,5784
3712,2017-2-22,Detroit Pistons,57,13730,2262,4968,0.455,435,1297,0.335,1827,3671,0.498,812,1097,0.74,586,1951,2537,1199,401,674,1028,5771
3713,2017-2-22,Philadelphia 76ers,56,13540,2077,4736,0.439,575,1644,0.35,1502,3092,0.486,937,1235,0.759,533,1855,2388,1315,473,903,1208,5666
3714,2017-2-22,Memphis Grizzlies,58,14120,2101,4867,0.432,531,1506,0.353,1570,3361,0.467,1115,1414,0.789,634,1885,2519,1208,483,727,1365,5848
3715,2017-2-22,Utah Jazz,57,13730,2081,4487,0.464,543,1494,0.363,1538,2993,0.514,1008,1336,0.754,517,1936,2453,1111,385,738,1083,5713
3716,2017-2-22,Orlando Magic,58,13995,2201,4992,0.441,493,1490,0.331,1708,3502,0.488,876,1210,0.724,563,1916,2479,1280,395,754,1097,5771
3717,2017-2-22,Dallas Mavericks,56,13540,2037,4616,0.441,602,1683,0.358,1435,2933,0.489,817,1017,0.803,443,1700,2143,1137,437,611,1080,5493
3718,2017-2-23,Golden State Warriors,56,13540,2450,4893,0.501,687,1771,0.388,1763,3122,0.565,1034,1311,0.789,493,2001,2494,1737,534,806,1077,6621
3719,2017-2-23,Houston Rockets,58,14020,2340,5034,0.465,840,2308,0.364,1500,2726,0.55,1118,1466,0.763,618,1934,2552,1476,479,854,1166,6638
3720,2017-2-23,Cleveland Cavaliers,55,13300,2187,4701,0.465,722,1850,0.39,1465,2851,0.514,1028,1364,0.754,547,1873,2420,1231,399,739,989,6124
3721,2017-2-23,Denver Nuggets,56,13515,2273,4927,0.461,577,1561,0.37,1696,3366,0.504,1073,1410,0.761,716,1901,2617,1381,376,838,1102,6196
3722,2017-2-23,Toronto Raptors,57,13755,2251,4852,0.464,526,1420,0.37,1725,3432,0.503,1155,1439,0.803,609,1822,2431,1063,487,650,1193,6183
3723,2017-2-23,Boston Celtics,57,13755,2222,4867,0.457,697,1887,0.369,1525,2980,0.512,1037,1272,0.815,516,1830,2346,1430,426,693,1162,6178
3724,2017-2-23,Washington Wizards,55,13325,2271,4758,0.477,495,1316,0.376,1776,3442,0.516,907,1159,0.783,563,1811,2374,1300,464,747,1168,5944
3725,2017-2-23,Los Angeles Clippers,56,13490,2201,4700,0.468,585,1542,0.379,1616,3158,0.512,1057,1414,0.748,521,1922,2443,1257,428,706,1138,6044
3726,2017-2-23,Portland Trail Blazers,56,13615,2203,4860,0.453,574,1595,0.36,1629,3265,0.499,1028,1313,0.783,568,1858,2426,1219,386,737,1226,6008
3727,2017-2-23,Phoenix Suns,57,13805,2234,5004,0.446,456,1325,0.344,1778,3679,0.483,1172,1484,0.79,685,1857,2542,1061,471,855,1416,6096
3728,2017-2-23,San Antonio Spurs,56,13490,2215,4663,0.475,505,1262,0.4,1710,3401,0.503,1041,1289,0.808,539,1913,2452,1333,452,715,1034,5976
3729,2017-2-23,New York Knicks,57,13855,2288,5107,0.448,528,1460,0.362,1760,3647,0.483,942,1211,0.778,703,1918,2621,1244,414,771,1186,6046
3730,2017-2-23,Oklahoma City Thunder,57,13780,2233,4969,0.449,477,1486,0.321,1756,3483,0.504,1095,1470,0.745,673,1958,2631,1196,444,836,1173,6038
3731,2017-2-23,Milwaukee Bucks,55,13275,2178,4556,0.478,469,1264,0.371,1709,3292,0.519,987,1301,0.759,509,1778,2287,1357,466,751,1118,5812
3732,2017-2-23,Brooklyn Nets,56,13515,2120,4792,0.442,616,1813,0.34,1504,2979,0.505,1050,1322,0.794,494,1958,2452,1190,391,924,1173,5906
3733,2017-2-23,Indiana Pacers,57,13805,2242,4814,0.466,474,1284,0.369,1768,3530,0.501,1055,1301,0.811,478,1873,2351,1285,476,764,1108,6013
3734,2017-2-23,Minnesota Timberwolves,57,13755,2224,4788,0.464,442,1263,0.35,1782,3525,0.506,1083,1370,0.791,644,1773,2417,1331,441,776,1162,5973
3735,2017-2-23,Los Angeles Lakers,58,13920,2237,5036,0.444,542,1532,0.354,1695,3504,0.484,1043,1360,0.767,668,1877,2545,1195,451,846,1208,6059
3736,2017-2-23,Charlotte Hornets,56,13515,2102,4791,0.439,550,1565,0.351,1552,3226,0.481,1096,1361,0.805,499,2011,2510,1305,371,656,954,5850
3737,2017-2-23,Atlanta Hawks,56,13615,2163,4754,0.455,499,1463,0.341,1664,3291,0.506,987,1352,0.73,565,1898,2463,1340,466,831,1003,5812
3738,2017-2-23,New Orleans Pelicans,57,13855,2206,4945,0.446,538,1509,0.357,1668,3436,0.485,942,1265,0.745,485,2014,2499,1285,441,706,1063,5892
3739,2017-2-23,Sacramento Kings,57,13830,2131,4674,0.456,526,1449,0.363,1605,3225,0.498,1082,1391,0.778,519,1816,2335,1290,466,805,1187,5870
3740,2017-2-23,Chicago Bulls,57,13730,2169,4926,0.44,367,1161,0.316,1802,3765,0.479,1117,1397,0.8,731,1921,2652,1208,436,737,1002,5822
3741,2017-2-23,Miami Heat,57,13755,2205,4874,0.452,526,1477,0.356,1679,3397,0.494,848,1224,0.693,587,1907,2494,1206,396,724,1180,5784
3742,2017-2-23,Detroit Pistons,57,13730,2262,4968,0.455,435,1297,0.335,1827,3671,0.498,812,1097,0.74,586,1951,2537,1199,401,674,1028,5771
3743,2017-2-23,Philadelphia 76ers,56,13540,2077,4736,0.439,575,1644,0.35,1502,3092,0.486,937,1235,0.759,533,1855,2388,1315,473,903,1208,5666
3744,2017-2-23,Memphis Grizzlies,58,14120,2101,4867,0.432,531,1506,0.353,1570,3361,0.467,1115,1414,0.789,634,1885,2519,1208,483,727,1365,5848
3745,2017-2-23,Utah Jazz,57,13730,2081,4487,0.464,543,1494,0.363,1538,2993,0.514,1008,1336,0.754,517,1936,2453,1111,385,738,1083,5713
3746,2017-2-23,Orlando Magic,58,13995,2201,4992,0.441,493,1490,0.331,1708,3502,0.488,876,1210,0.724,563,1916,2479,1280,395,754,1097,5771
3747,2017-2-23,Dallas Mavericks,56,13540,2037,4616,0.441,602,1683,0.358,1435,2933,0.489,817,1017,0.803,443,1700,2143,1137,437,611,1080,5493
3748,2017-2-24,Golden State Warriors,57,13780,2493,4974,0.501,700,1796,0.39,1793,3178,0.564,1058,1337,0.791,503,2044,2547,1768,545,827,1104,6744
3749,2017-2-24,Houston Rockets,59,14260,2385,5125,0.465,860,2359,0.365,1525,2766,0.551,1137,1490,0.763,630,1970,2600,1504,491,870,1191,6767
3750,2017-2-24,Cleveland Cavaliers,56,13540,2233,4788,0.466,737,1888,0.39,1496,2900,0.516,1040,1379,0.754,555,1909,2464,1260,404,751,1005,6243
3751,2017-2-24,Denver Nuggets,57,13755,2312,5015,0.461,589,1596,0.369,1723,3419,0.504,1083,1424,0.761,726,1934,2660,1404,386,854,1120,6296
3752,2017-2-24,Toronto Raptors,57,13755,2251,4852,0.464,526,1420,0.37,1725,3432,0.503,1155,1439,0.803,609,1822,2431,1063,487,650,1193,6183
3753,2017-2-24,Boston Celtics,57,13755,2222,4867,0.457,697,1887,0.369,1525,2980,0.512,1037,1272,0.815,516,1830,2346,1430,426,693,1162,6178
3754,2017-2-24,Washington Wizards,55,13325,2271,4758,0.477,495,1316,0.376,1776,3442,0.516,907,1159,0.783,563,1811,2374,1300,464,747,1168,5944
3755,2017-2-24,Los Angeles Clippers,57,13730,2239,4793,0.467,596,1570,0.38,1643,3223,0.51,1083,1451,0.746,531,1950,2481,1280,439,720,1154,6157
3756,2017-2-24,Portland Trail Blazers,57,13855,2244,4941,0.454,583,1613,0.361,1661,3328,0.499,1049,1340,0.783,577,1894,2471,1239,394,756,1251,6120
3757,2017-2-24,Phoenix Suns,57,13805,2234,5004,0.446,456,1325,0.344,1778,3679,0.483,1172,1484,0.79,685,1857,2542,1061,471,855,1416,6096
3758,2017-2-24,San Antonio Spurs,56,13490,2215,4663,0.475,505,1262,0.4,1710,3401,0.503,1041,1289,0.808,539,1913,2452,1333,452,715,1034,5976
3759,2017-2-24,New York Knicks,58,14095,2330,5208,0.447,536,1486,0.361,1794,3722,0.482,954,1228,0.777,719,1952,2671,1268,418,783,1205,6150
3760,2017-2-24,Oklahoma City Thunder,57,13780,2233,4969,0.449,477,1486,0.321,1756,3483,0.504,1095,1470,0.745,673,1958,2631,1196,444,836,1173,6038
3761,2017-2-24,Milwaukee Bucks,55,13275,2178,4556,0.478,469,1264,0.371,1709,3292,0.519,987,1301,0.759,509,1778,2287,1357,466,751,1118,5812
3762,2017-2-24,Brooklyn Nets,56,13515,2120,4792,0.442,616,1813,0.34,1504,2979,0.505,1050,1322,0.794,494,1958,2452,1190,391,924,1173,5906
3763,2017-2-24,Indiana Pacers,57,13805,2242,4814,0.466,474,1284,0.369,1768,3530,0.501,1055,1301,0.811,478,1873,2351,1285,476,764,1108,6013
3764,2017-2-24,Minnesota Timberwolves,57,13755,2224,4788,0.464,442,1263,0.35,1782,3525,0.506,1083,1370,0.791,644,1773,2417,1331,441,776,1162,5973
3765,2017-2-24,Los Angeles Lakers,58,13920,2237,5036,0.444,542,1532,0.354,1695,3504,0.484,1043,1360,0.767,668,1877,2545,1195,451,846,1208,6059
3766,2017-2-24,Charlotte Hornets,57,13780,2140,4883,0.438,557,1595,0.349,1583,3288,0.481,1121,1387,0.808,504,2056,2560,1324,376,663,969,5958
3767,2017-2-24,Atlanta Hawks,56,13615,2163,4754,0.455,499,1463,0.341,1664,3291,0.506,987,1352,0.73,565,1898,2463,1340,466,831,1003,5812
3768,2017-2-24,New Orleans Pelicans,58,14095,2242,5031,0.446,544,1540,0.353,1698,3491,0.486,963,1291,0.746,496,2047,2543,1309,451,726,1084,5991
3769,2017-2-24,Sacramento Kings,58,14070,2177,4762,0.457,533,1463,0.364,1644,3299,0.498,1099,1410,0.779,528,1853,2381,1316,474,819,1203,5986
3770,2017-2-24,Chicago Bulls,57,13730,2169,4926,0.44,367,1161,0.316,1802,3765,0.479,1117,1397,0.8,731,1921,2652,1208,436,737,1002,5822
3771,2017-2-24,Detroit Pistons,58,13995,2306,5075,0.454,450,1334,0.337,1856,3741,0.496,823,1109,0.742,596,1998,2594,1228,406,682,1045,5885
3772,2017-2-24,Miami Heat,57,13755,2205,4874,0.452,526,1477,0.356,1679,3397,0.494,848,1224,0.693,587,1907,2494,1206,396,724,1180,5784
3773,2017-2-24,Philadelphia 76ers,56,13540,2077,4736,0.439,575,1644,0.35,1502,3092,0.486,937,1235,0.759,533,1855,2388,1315,473,903,1208,5666
3774,2017-2-24,Memphis Grizzlies,58,14120,2101,4867,0.432,531,1506,0.353,1570,3361,0.467,1115,1414,0.789,634,1885,2519,1208,483,727,1365,5848
3775,2017-2-24,Utah Jazz,57,13730,2081,4487,0.464,543,1494,0.363,1538,2993,0.514,1008,1336,0.754,517,1936,2453,1111,385,738,1083,5713
3776,2017-2-24,Orlando Magic,59,14235,2235,5078,0.44,500,1512,0.331,1735,3566,0.487,904,1249,0.724,576,1943,2519,1298,403,768,1118,5874
3777,2017-2-24,Dallas Mavericks,56,13540,2037,4616,0.441,602,1683,0.358,1435,2933,0.489,817,1017,0.803,443,1700,2143,1137,437,611,1080,5493
3778,2017-2-25,Golden State Warriors,57,13780,2493,4974,0.501,700,1796,0.39,1793,3178,0.564,1058,1337,0.791,503,2044,2547,1768,545,827,1104,6744
3779,2017-2-25,Houston Rockets,59,14260,2385,5125,0.465,860,2359,0.365,1525,2766,0.551,1137,1490,0.763,630,1970,2600,1504,491,870,1191,6767
3780,2017-2-25,Cleveland Cavaliers,56,13540,2233,4788,0.466,737,1888,0.39,1496,2900,0.516,1040,1379,0.754,555,1909,2464,1260,404,751,1005,6243
3781,2017-2-25,Denver Nuggets,58,13995,2361,5112,0.462,603,1627,0.371,1758,3485,0.504,1100,1448,0.76,737,1974,2711,1436,397,867,1144,6425
3782,2017-2-25,Toronto Raptors,58,13995,2291,4933,0.464,531,1435,0.37,1760,3498,0.503,1177,1468,0.802,619,1853,2472,1078,494,659,1214,6290
3783,2017-2-25,Boston Celtics,58,13995,2255,4945,0.456,709,1925,0.368,1546,3020,0.512,1056,1294,0.816,523,1859,2382,1449,430,704,1183,6275
3784,2017-2-25,Washington Wizards,56,13565,2309,4848,0.476,500,1340,0.373,1809,3508,0.516,938,1199,0.782,575,1842,2417,1319,472,763,1193,6056
3785,2017-2-25,Los Angeles Clippers,58,13970,2274,4872,0.467,603,1593,0.379,1671,3279,0.51,1103,1475,0.748,539,1978,2517,1298,448,732,1180,6254
3786,2017-2-25,Portland Trail Blazers,57,13855,2244,4941,0.454,583,1613,0.361,1661,3328,0.499,1049,1340,0.783,577,1894,2471,1239,394,756,1251,6120
3787,2017-2-25,Phoenix Suns,58,14070,2283,5097,0.448,464,1349,0.344,1819,3748,0.485,1187,1509,0.787,693,1892,2585,1088,479,873,1439,6217
3788,2017-2-25,San Antonio Spurs,57,13730,2250,4745,0.474,514,1288,0.399,1736,3457,0.502,1067,1319,0.809,554,1949,2503,1356,461,728,1055,6081
3789,2017-2-25,Oklahoma City Thunder,58,14020,2277,5066,0.449,487,1510,0.323,1790,3556,0.503,1107,1487,0.744,687,2003,2690,1224,453,853,1187,6148
3790,2017-2-25,New York Knicks,58,14095,2330,5208,0.447,536,1486,0.361,1794,3722,0.482,954,1228,0.777,719,1952,2671,1268,418,783,1205,6150
3791,2017-2-25,Milwaukee Bucks,56,13515,2210,4630,0.477,476,1282,0.371,1734,3348,0.518,1011,1330,0.76,519,1803,2322,1372,471,766,1145,5907
3792,2017-2-25,Brooklyn Nets,57,13755,2161,4875,0.443,626,1843,0.34,1535,3032,0.506,1067,1353,0.789,501,1993,2494,1217,398,943,1196,6015
3793,2017-2-25,Indiana Pacers,58,14045,2282,4892,0.466,485,1310,0.37,1797,3582,0.502,1066,1312,0.813,486,1915,2401,1308,484,780,1127,6115
3794,2017-2-25,Minnesota Timberwolves,58,13995,2265,4866,0.465,447,1276,0.35,1818,3590,0.506,1093,1384,0.79,653,1808,2461,1355,450,792,1174,6070
3795,2017-2-25,Charlotte Hornets,57,13780,2140,4883,0.438,557,1595,0.349,1583,3288,0.481,1121,1387,0.808,504,2056,2560,1324,376,663,969,5958
3796,2017-2-25,Los Angeles Lakers,59,14160,2277,5137,0.443,549,1567,0.35,1728,3570,0.484,1049,1374,0.763,683,1913,2596,1218,466,859,1227,6152
3797,2017-2-25,Atlanta Hawks,57,13855,2193,4833,0.454,505,1483,0.341,1688,3350,0.504,1011,1388,0.728,573,1935,2508,1354,473,841,1015,5902
3798,2017-2-25,New Orleans Pelicans,58,14095,2242,5031,0.446,544,1540,0.353,1698,3491,0.486,963,1291,0.746,496,2047,2543,1309,451,726,1084,5991
3799,2017-2-25,Sacramento Kings,58,14070,2177,4762,0.457,533,1463,0.364,1644,3299,0.498,1099,1410,0.779,528,1853,2381,1316,474,819,1203,5986
3800,2017-2-25,Chicago Bulls,58,13995,2215,5024,0.441,379,1187,0.319,1836,3837,0.478,1141,1428,0.799,742,1956,2698,1239,450,749,1023,5950
3801,2017-2-25,Miami Heat,58,13995,2245,4973,0.451,543,1514,0.359,1702,3459,0.492,859,1237,0.694,602,1946,2548,1236,403,736,1207,5892
3802,2017-2-25,Detroit Pistons,58,13995,2306,5075,0.454,450,1334,0.337,1856,3741,0.496,823,1109,0.742,596,1998,2594,1228,406,682,1045,5885
3803,2017-2-25,Philadelphia 76ers,57,13780,2120,4823,0.44,585,1673,0.35,1535,3150,0.487,961,1265,0.76,541,1895,2436,1343,482,918,1234,5786
3804,2017-2-25,Memphis Grizzlies,59,14360,2136,4951,0.431,540,1533,0.352,1596,3418,0.467,1128,1437,0.785,646,1912,2558,1228,494,738,1380,5940
3805,2017-2-25,Utah Jazz,58,13970,2118,4561,0.464,551,1517,0.363,1567,3044,0.515,1035,1366,0.758,526,1968,2494,1134,393,752,1109,5822
3806,2017-2-25,Orlando Magic,59,14235,2235,5078,0.44,500,1512,0.331,1735,3566,0.487,904,1249,0.724,576,1943,2519,1298,403,768,1118,5874
3807,2017-2-25,Dallas Mavericks,57,13780,2072,4699,0.441,610,1716,0.355,1462,2983,0.49,823,1026,0.802,451,1727,2178,1153,446,626,1099,5577
3808,2017-2-26,Golden State Warriors,58,14020,2535,5074,0.5,711,1827,0.389,1824,3247,0.562,1075,1359,0.791,516,2083,2599,1798,555,838,1121,6856
3809,2017-2-26,Houston Rockets,60,14500,2429,5219,0.465,882,2417,0.365,1547,2802,0.552,1169,1532,0.763,643,1989,2632,1536,506,883,1212,6909
3810,2017-2-26,Cleveland Cavaliers,57,13780,2270,4868,0.466,751,1925,0.39,1519,2943,0.516,1051,1394,0.754,559,1945,2504,1284,409,763,1022,6342
3811,2017-2-26,Denver Nuggets,58,13995,2361,5112,0.462,603,1627,0.371,1758,3485,0.504,1100,1448,0.76,737,1974,2711,1436,397,867,1144,6425
3812,2017-2-26,Toronto Raptors,58,13995,2291,4933,0.464,531,1435,0.37,1760,3498,0.503,1177,1468,0.802,619,1853,2472,1078,494,659,1214,6290
3813,2017-2-26,Boston Celtics,58,13995,2255,4945,0.456,709,1925,0.368,1546,3020,0.512,1056,1294,0.816,523,1859,2382,1449,430,704,1183,6275
3814,2017-2-26,Washington Wizards,56,13565,2309,4848,0.476,500,1340,0.373,1809,3508,0.516,938,1199,0.782,575,1842,2417,1319,472,763,1193,6056
3815,2017-2-26,Los Angeles Clippers,58,13970,2274,4872,0.467,603,1593,0.379,1671,3279,0.51,1103,1475,0.748,539,1978,2517,1298,448,732,1180,6254
3816,2017-2-26,Portland Trail Blazers,57,13855,2244,4941,0.454,583,1613,0.361,1661,3328,0.499,1049,1340,0.783,577,1894,2471,1239,394,756,1251,6120
3817,2017-2-26,Phoenix Suns,58,14070,2283,5097,0.448,464,1349,0.344,1819,3748,0.485,1187,1509,0.787,693,1892,2585,1088,479,873,1439,6217
3818,2017-2-26,San Antonio Spurs,57,13730,2250,4745,0.474,514,1288,0.399,1736,3457,0.502,1067,1319,0.809,554,1949,2503,1356,461,728,1055,6081
3819,2017-2-26,New York Knicks,59,14335,2373,5299,0.448,542,1507,0.36,1831,3792,0.483,972,1251,0.777,729,1986,2715,1289,424,794,1227,6260
3820,2017-2-26,Oklahoma City Thunder,58,14020,2277,5066,0.449,487,1510,0.323,1790,3556,0.503,1107,1487,0.744,687,2003,2690,1224,453,853,1187,6148
3821,2017-2-26,Milwaukee Bucks,56,13515,2210,4630,0.477,476,1282,0.371,1734,3348,0.518,1011,1330,0.76,519,1803,2322,1372,471,766,1145,5907
3822,2017-2-26,Brooklyn Nets,58,13995,2199,4969,0.443,634,1871,0.339,1565,3098,0.505,1078,1370,0.787,512,2034,2546,1242,406,959,1216,6110
3823,2017-2-26,Indiana Pacers,59,14285,2316,4977,0.465,489,1322,0.37,1827,3655,0.5,1089,1338,0.814,499,1945,2444,1329,492,795,1151,6210
3824,2017-2-26,Minnesota Timberwolves,59,14235,2314,4960,0.467,456,1302,0.35,1858,3658,0.508,1116,1412,0.79,674,1845,2519,1383,460,815,1200,6200
3825,2017-2-26,Charlotte Hornets,58,14020,2174,4968,0.438,571,1633,0.35,1603,3335,0.481,1138,1405,0.81,517,2093,2610,1350,386,673,982,6057
3826,2017-2-26,Los Angeles Lakers,59,14160,2277,5137,0.443,549,1567,0.35,1728,3570,0.484,1049,1374,0.763,683,1913,2596,1218,466,859,1227,6152
3827,2017-2-26,Atlanta Hawks,58,14095,2225,4918,0.452,513,1508,0.34,1712,3410,0.502,1025,1414,0.725,585,1971,2556,1375,477,858,1034,5988
3828,2017-2-26,New Orleans Pelicans,59,14335,2273,5109,0.445,549,1564,0.351,1724,3545,0.486,979,1316,0.744,505,2083,2588,1330,458,745,1103,6074
3829,2017-2-26,Sacramento Kings,59,14310,2208,4841,0.456,544,1491,0.365,1664,3350,0.497,1111,1425,0.78,537,1885,2422,1334,477,833,1222,6071
3830,2017-2-26,Chicago Bulls,59,14235,2261,5117,0.442,394,1217,0.324,1867,3900,0.479,1151,1444,0.797,752,1993,2745,1273,456,756,1036,6067
3831,2017-2-26,Miami Heat,59,14235,2283,5051,0.452,556,1545,0.36,1727,3506,0.493,883,1268,0.696,613,1978,2591,1259,412,752,1226,6005
3832,2017-2-26,Philadelphia 76ers,58,14020,2160,4918,0.439,592,1704,0.347,1568,3214,0.488,983,1292,0.761,557,1929,2486,1362,488,929,1255,5895
3833,2017-2-26,Detroit Pistons,58,13995,2306,5075,0.454,450,1334,0.337,1856,3741,0.496,823,1109,0.742,596,1998,2594,1228,406,682,1045,5885
3834,2017-2-26,Memphis Grizzlies,59,14360,2136,4951,0.431,540,1533,0.352,1596,3418,0.467,1128,1437,0.785,646,1912,2558,1228,494,738,1380,5940
3835,2017-2-26,Utah Jazz,58,13970,2118,4561,0.464,551,1517,0.363,1567,3044,0.515,1035,1366,0.758,526,1968,2494,1134,393,752,1109,5822
3836,2017-2-26,Orlando Magic,60,14475,2272,5159,0.44,508,1539,0.33,1764,3620,0.487,927,1273,0.728,583,1983,2566,1319,414,781,1141,5979
3837,2017-2-26,Dallas Mavericks,58,14020,2108,4777,0.441,622,1742,0.357,1486,3035,0.49,835,1042,0.801,458,1763,2221,1177,458,643,1124,5673
3838,2017-2-27,Golden State Warriors,58,14020,2535,5074,0.5,711,1827,0.389,1824,3247,0.562,1075,1359,0.791,516,2083,2599,1798,555,838,1121,6856
3839,2017-2-27,Houston Rockets,60,14500,2429,5219,0.465,882,2417,0.365,1547,2802,0.552,1169,1532,0.763,643,1989,2632,1536,506,883,1212,6909
3840,2017-2-27,Cleveland Cavaliers,57,13780,2270,4868,0.466,751,1925,0.39,1519,2943,0.516,1051,1394,0.754,559,1945,2504,1284,409,763,1022,6342
3841,2017-2-27,Denver Nuggets,59,14235,2398,5196,0.462,614,1661,0.37,1784,3535,0.505,1113,1465,0.76,747,2003,2750,1462,406,879,1167,6523
3842,2017-2-27,Toronto Raptors,59,14235,2333,5011,0.466,538,1455,0.37,1795,3556,0.505,1198,1495,0.801,624,1887,2511,1094,501,669,1238,6402
3843,2017-2-27,Los Angeles Clippers,59,14235,2319,4969,0.467,613,1625,0.377,1706,3344,0.51,1127,1509,0.747,554,2010,2564,1325,462,741,1205,6378
3844,2017-2-27,Boston Celtics,59,14235,2289,5030,0.455,721,1960,0.368,1568,3070,0.511,1080,1324,0.816,532,1902,2434,1471,439,718,1209,6379
3845,2017-2-27,Washington Wizards,57,13805,2346,4935,0.475,508,1362,0.373,1838,3573,0.514,948,1212,0.782,581,1864,2445,1340,488,779,1220,6148
3846,2017-2-27,Portland Trail Blazers,58,14095,2279,5020,0.454,592,1634,0.362,1687,3386,0.498,1076,1375,0.783,585,1925,2510,1255,400,765,1277,6226
3847,2017-2-27,Phoenix Suns,59,14310,2323,5180,0.448,469,1363,0.344,1854,3817,0.486,1198,1525,0.786,705,1922,2627,1114,491,893,1461,6313
3848,2017-2-27,San Antonio Spurs,58,13970,2299,4839,0.475,524,1309,0.4,1775,3530,0.503,1078,1332,0.809,567,1982,2549,1393,473,740,1070,6200
3849,2017-2-27,Oklahoma City Thunder,59,14260,2319,5154,0.45,493,1531,0.322,1826,3623,0.504,1135,1524,0.745,703,2040,2743,1241,457,866,1216,6266
3850,2017-2-27,New York Knicks,59,14335,2373,5299,0.448,542,1507,0.36,1831,3792,0.483,972,1251,0.777,729,1986,2715,1289,424,794,1227,6260
3851,2017-2-27,Milwaukee Bucks,57,13755,2249,4706,0.478,482,1302,0.37,1767,3404,0.519,1027,1348,0.762,525,1830,2355,1398,481,785,1166,6007
3852,2017-2-27,Brooklyn Nets,58,13995,2199,4969,0.443,634,1871,0.339,1565,3098,0.505,1078,1370,0.787,512,2034,2546,1242,406,959,1216,6110
3853,2017-2-27,Indiana Pacers,59,14285,2316,4977,0.465,489,1322,0.37,1827,3655,0.5,1089,1338,0.814,499,1945,2444,1329,492,795,1151,6210
3854,2017-2-27,Minnesota Timberwolves,59,14235,2314,4960,0.467,456,1302,0.35,1858,3658,0.508,1116,1412,0.79,674,1845,2519,1383,460,815,1200,6200
3855,2017-2-27,Charlotte Hornets,59,14285,2212,5048,0.438,589,1673,0.352,1623,3375,0.481,1165,1435,0.812,522,2131,2653,1366,387,689,1014,6178
3856,2017-2-27,Los Angeles Lakers,60,14400,2317,5224,0.444,556,1589,0.35,1761,3635,0.484,1060,1392,0.761,696,1944,2640,1234,474,877,1245,6250
3857,2017-2-27,Atlanta Hawks,58,14095,2225,4918,0.452,513,1508,0.34,1712,3410,0.502,1025,1414,0.725,585,1971,2556,1375,477,858,1034,5988
3858,2017-2-27,New Orleans Pelicans,60,14575,2309,5189,0.445,557,1585,0.351,1752,3604,0.486,1009,1353,0.746,512,2111,2623,1347,468,755,1129,6184
3859,2017-2-27,Sacramento Kings,59,14310,2208,4841,0.456,544,1491,0.365,1664,3350,0.497,1111,1425,0.78,537,1885,2422,1334,477,833,1222,6071
3860,2017-2-27,Chicago Bulls,59,14235,2261,5117,0.442,394,1217,0.324,1867,3900,0.479,1151,1444,0.797,752,1993,2745,1273,456,756,1036,6067
3861,2017-2-27,Miami Heat,59,14235,2283,5051,0.452,556,1545,0.36,1727,3506,0.493,883,1268,0.696,613,1978,2591,1259,412,752,1226,6005
3862,2017-2-27,Philadelphia 76ers,58,14020,2160,4918,0.439,592,1704,0.347,1568,3214,0.488,983,1292,0.761,557,1929,2486,1362,488,929,1255,5895
3863,2017-2-27,Detroit Pistons,59,14235,2341,5156,0.454,462,1367,0.338,1879,3789,0.496,839,1144,0.733,607,2032,2639,1250,414,699,1069,5983
3864,2017-2-27,Memphis Grizzlies,60,14600,2172,5031,0.432,551,1566,0.352,1621,3465,0.468,1150,1462,0.787,659,1948,2607,1249,503,753,1400,6045
3865,2017-2-27,Utah Jazz,59,14210,2152,4633,0.464,562,1541,0.365,1590,3092,0.514,1058,1398,0.757,535,2009,2544,1152,403,776,1128,5924
3866,2017-2-27,Orlando Magic,60,14475,2272,5159,0.44,508,1539,0.33,1764,3620,0.487,927,1273,0.728,583,1983,2566,1319,414,781,1141,5979
3867,2017-2-27,Dallas Mavericks,58,14020,2108,4777,0.441,622,1742,0.357,1486,3035,0.49,835,1042,0.801,458,1763,2221,1177,458,643,1124,5673
3868,2017-2-28,Golden State Warriors,59,14260,2575,5163,0.499,717,1856,0.386,1858,3307,0.562,1108,1398,0.793,532,2112,2644,1829,569,851,1139,6975
3869,2017-2-28,Houston Rockets,61,14740,2461,5307,0.464,892,2462,0.362,1569,2845,0.551,1203,1574,0.764,655,2016,2671,1558,514,893,1234,7017
3870,2017-2-28,Cleveland Cavaliers,58,14020,2305,4938,0.467,761,1953,0.39,1544,2985,0.517,1073,1420,0.756,563,1986,2549,1304,413,779,1033,6444
3871,2017-2-28,Denver Nuggets,59,14235,2398,5196,0.462,614,1661,0.37,1784,3535,0.505,1113,1465,0.76,747,2003,2750,1462,406,879,1167,6523
3872,2017-2-28,Toronto Raptors,60,14475,2366,5089,0.465,545,1481,0.368,1821,3608,0.505,1217,1518,0.802,635,1917,2552,1106,510,681,1256,6494
3873,2017-2-28,Los Angeles Clippers,59,14235,2319,4969,0.467,613,1625,0.377,1706,3344,0.51,1127,1509,0.747,554,2010,2564,1325,462,741,1205,6378
3874,2017-2-28,Boston Celtics,60,14475,2323,5117,0.454,731,1994,0.367,1592,3123,0.51,1100,1349,0.815,541,1933,2474,1492,448,736,1229,6477
3875,2017-2-28,Washington Wizards,57,13805,2346,4935,0.475,508,1362,0.373,1838,3573,0.514,948,1212,0.782,581,1864,2445,1340,488,779,1220,6148
3876,2017-2-28,Portland Trail Blazers,58,14095,2279,5020,0.454,592,1634,0.362,1687,3386,0.498,1076,1375,0.783,585,1925,2510,1255,400,765,1277,6226
3877,2017-2-28,Phoenix Suns,59,14310,2323,5180,0.448,469,1363,0.344,1854,3817,0.486,1198,1525,0.786,705,1922,2627,1114,491,893,1461,6313
3878,2017-2-28,San Antonio Spurs,58,13970,2299,4839,0.475,524,1309,0.4,1775,3530,0.503,1078,1332,0.809,567,1982,2549,1393,473,740,1070,6200
3879,2017-2-28,Oklahoma City Thunder,59,14260,2319,5154,0.45,493,1531,0.322,1826,3623,0.504,1135,1524,0.745,703,2040,2743,1241,457,866,1216,6266
3880,2017-2-28,New York Knicks,60,14575,2406,5372,0.448,551,1531,0.36,1855,3841,0.483,988,1270,0.778,737,2018,2755,1306,434,811,1246,6351
3881,2017-2-28,Indiana Pacers,60,14525,2357,5068,0.465,502,1352,0.371,1855,3716,0.499,1111,1363,0.815,512,1987,2499,1358,499,810,1177,6327
3882,2017-2-28,Brooklyn Nets,58,13995,2199,4969,0.443,634,1871,0.339,1565,3098,0.505,1078,1370,0.787,512,2034,2546,1242,406,959,1216,6110
3883,2017-2-28,Milwaukee Bucks,58,13995,2286,4789,0.477,493,1332,0.37,1793,3457,0.519,1037,1364,0.76,530,1858,2388,1425,484,793,1189,6102
3884,2017-2-28,Minnesota Timberwolves,60,14475,2354,5055,0.466,464,1325,0.35,1890,3730,0.507,1130,1432,0.789,690,1881,2571,1408,471,825,1215,6302
3885,2017-2-28,Charlotte Hornets,59,14285,2212,5048,0.438,589,1673,0.352,1623,3375,0.481,1165,1435,0.812,522,2131,2653,1366,387,689,1014,6178
3886,2017-2-28,Los Angeles Lakers,60,14400,2317,5224,0.444,556,1589,0.35,1761,3635,0.484,1060,1392,0.761,696,1944,2640,1234,474,877,1245,6250
3887,2017-2-28,Atlanta Hawks,59,14335,2271,5013,0.453,519,1533,0.339,1752,3480,0.503,1041,1434,0.726,598,2013,2611,1397,487,872,1053,6102
3888,2017-2-28,New Orleans Pelicans,60,14575,2309,5189,0.445,557,1585,0.351,1752,3604,0.486,1009,1353,0.746,512,2111,2623,1347,468,755,1129,6184
3889,2017-2-28,Chicago Bulls,59,14235,2261,5117,0.442,394,1217,0.324,1867,3900,0.479,1151,1444,0.797,752,1993,2745,1273,456,756,1036,6067
3890,2017-2-28,Sacramento Kings,60,14550,2244,4923,0.456,550,1508,0.365,1694,3415,0.496,1121,1440,0.778,544,1920,2464,1357,483,851,1240,6159
3891,2017-2-28,Philadelphia 76ers,59,14260,2197,5000,0.439,602,1738,0.346,1595,3262,0.489,1007,1319,0.763,569,1959,2528,1386,499,951,1280,6003
3892,2017-2-28,Miami Heat,60,14475,2320,5134,0.452,565,1571,0.36,1755,3563,0.493,889,1281,0.694,626,2010,2636,1280,423,765,1244,6094
3893,2017-2-28,Detroit Pistons,59,14235,2341,5156,0.454,462,1367,0.338,1879,3789,0.496,839,1144,0.733,607,2032,2639,1250,414,699,1069,5983
3894,2017-2-28,Memphis Grizzlies,60,14600,2172,5031,0.432,551,1566,0.352,1621,3465,0.468,1150,1462,0.787,659,1948,2607,1249,503,753,1400,6045
3895,2017-2-28,Utah Jazz,59,14210,2152,4633,0.464,562,1541,0.365,1590,3092,0.514,1058,1398,0.757,535,2009,2544,1152,403,776,1128,5924
3896,2017-2-28,Orlando Magic,60,14475,2272,5159,0.44,508,1539,0.33,1764,3620,0.487,927,1273,0.728,583,1983,2566,1319,414,781,1141,5979
3897,2017-2-28,Dallas Mavericks,59,14260,2141,4853,0.441,631,1760,0.359,1510,3093,0.488,856,1065,0.804,469,1794,2263,1195,463,656,1137,5769
3898,2017-2-29,Golden State Warriors,60,14500,2614,5247,0.498,725,1885,0.385,1889,3362,0.562,1130,1425,0.793,545,2140,2685,1857,579,870,1162,7083
3899,2017-2-29,Houston Rockets,61,14740,2461,5307,0.464,892,2462,0.362,1569,2845,0.551,1203,1574,0.764,655,2016,2671,1558,514,893,1234,7017
3900,2017-2-29,Cleveland Cavaliers,58,14020,2305,4938,0.467,761,1953,0.39,1544,2985,0.517,1073,1420,0.756,563,1986,2549,1304,413,779,1033,6444
3901,2017-2-29,Denver Nuggets,60,14475,2443,5276,0.463,627,1691,0.371,1816,3585,0.507,1135,1489,0.762,753,2042,2795,1488,412,895,1183,6648
3902,2017-2-29,Toronto Raptors,60,14475,2366,5089,0.465,545,1481,0.368,1821,3608,0.505,1217,1518,0.802,635,1917,2552,1106,510,681,1256,6494
3903,2017-2-29,Los Angeles Clippers,59,14235,2319,4969,0.467,613,1625,0.377,1706,3344,0.51,1127,1509,0.747,554,2010,2564,1325,462,741,1205,6378
3904,2017-2-29,Boston Celtics,60,14475,2323,5117,0.454,731,1994,0.367,1592,3123,0.51,1100,1349,0.815,541,1933,2474,1492,448,736,1229,6477
3905,2017-2-29,Washington Wizards,58,14045,2387,5026,0.475,520,1390,0.374,1867,3636,0.513,966,1232,0.784,598,1893,2491,1369,499,798,1242,6260
3906,2017-2-29,Portland Trail Blazers,59,14360,2323,5104,0.455,602,1659,0.363,1721,3445,0.5,1091,1397,0.781,593,1967,2560,1280,405,789,1302,6339
3907,2017-2-29,Phoenix Suns,60,14550,2366,5263,0.45,476,1384,0.344,1890,3879,0.487,1217,1549,0.786,713,1946,2659,1136,497,905,1486,6425
3908,2017-2-29,San Antonio Spurs,58,13970,2299,4839,0.475,524,1309,0.4,1775,3530,0.503,1078,1332,0.809,567,1982,2549,1393,473,740,1070,6200
3909,2017-2-29,Oklahoma City Thunder,60,14500,2358,5230,0.451,508,1553,0.327,1850,3677,0.503,1151,1547,0.744,709,2076,2785,1261,462,880,1233,6375
3910,2017-2-29,New York Knicks,60,14575,2406,5372,0.448,551,1531,0.36,1855,3841,0.483,988,1270,0.778,737,2018,2755,1306,434,811,1246,6351
3911,2017-2-29,Indiana Pacers,60,14525,2357,5068,0.465,502,1352,0.371,1855,3716,0.499,1111,1363,0.815,512,1987,2499,1358,499,810,1177,6327
3912,2017-2-29,Brooklyn Nets,58,13995,2199,4969,0.443,634,1871,0.339,1565,3098,0.505,1078,1370,0.787,512,2034,2546,1242,406,959,1216,6110
3913,2017-2-29,Milwaukee Bucks,58,13995,2286,4789,0.477,493,1332,0.37,1793,3457,0.519,1037,1364,0.76,530,1858,2388,1425,484,793,1189,6102
3914,2017-2-29,Minnesota Timberwolves,60,14475,2354,5055,0.466,464,1325,0.35,1890,3730,0.507,1130,1432,0.789,690,1881,2571,1408,471,825,1215,6302
3915,2017-2-29,Charlotte Hornets,60,14525,2250,5133,0.438,605,1712,0.353,1645,3421,0.481,1182,1459,0.81,533,2165,2698,1391,390,701,1025,6287
3916,2017-2-29,Los Angeles Lakers,61,14640,2358,5308,0.444,568,1621,0.35,1790,3687,0.485,1070,1405,0.762,702,1977,2679,1256,483,891,1268,6354
3917,2017-2-29,Atlanta Hawks,59,14335,2271,5013,0.453,519,1533,0.339,1752,3480,0.503,1041,1434,0.726,598,2013,2611,1397,487,872,1053,6102
3918,2017-2-29,New Orleans Pelicans,60,14575,2309,5189,0.445,557,1585,0.351,1752,3604,0.486,1009,1353,0.746,512,2111,2623,1347,468,755,1129,6184
3919,2017-2-29,Chicago Bulls,60,14475,2305,5213,0.442,404,1243,0.325,1901,3970,0.479,1160,1454,0.798,763,2017,2780,1299,466,768,1055,6174
3920,2017-2-29,Sacramento Kings,60,14550,2244,4923,0.456,550,1508,0.365,1694,3415,0.496,1121,1440,0.778,544,1920,2464,1357,483,851,1240,6159
3921,2017-2-29,Detroit Pistons,60,14500,2386,5260,0.454,469,1392,0.337,1917,3868,0.496,862,1175,0.734,623,2064,2687,1273,427,706,1088,6103
3922,2017-2-29,Philadelphia 76ers,59,14260,2197,5000,0.439,602,1738,0.346,1595,3262,0.489,1007,1319,0.763,569,1959,2528,1386,499,951,1280,6003
3923,2017-2-29,Miami Heat,60,14475,2320,5134,0.452,565,1571,0.36,1755,3563,0.493,889,1281,0.694,626,2010,2636,1280,423,765,1244,6094
3924,2017-2-29,Memphis Grizzlies,61,14840,2220,5117,0.434,563,1591,0.354,1657,3526,0.47,1172,1491,0.786,671,1975,2646,1273,509,763,1419,6175
3925,2017-2-29,Utah Jazz,60,14450,2195,4726,0.464,571,1563,0.365,1624,3163,0.513,1069,1411,0.758,543,2034,2577,1174,411,783,1146,6030
3926,2017-2-29,Orlando Magic,60,14475,2272,5159,0.44,508,1539,0.33,1764,3620,0.487,927,1273,0.728,583,1983,2566,1319,414,781,1141,5979
3927,2017-2-29,Dallas Mavericks,59,14260,2141,4853,0.441,631,1760,0.359,1510,3093,0.488,856,1065,0.804,469,1794,2263,1195,463,656,1137,5769
3928,2017-2-30,Golden State Warriors,60,14500,2614,5247,0.498,725,1885,0.385,1889,3362,0.562,1130,1425,0.793,545,2140,2685,1857,579,870,1162,7083
3929,2017-2-30,Houston Rockets,61,14740,2461,5307,0.464,892,2462,0.362,1569,2845,0.551,1203,1574,0.764,655,2016,2671,1558,514,893,1234,7017
3930,2017-2-30,Cleveland Cavaliers,58,14020,2305,4938,0.467,761,1953,0.39,1544,2985,0.517,1073,1420,0.756,563,1986,2549,1304,413,779,1033,6444
3931,2017-2-30,Denver Nuggets,60,14475,2443,5276,0.463,627,1691,0.371,1816,3585,0.507,1135,1489,0.762,753,2042,2795,1488,412,895,1183,6648
3932,2017-2-30,Toronto Raptors,60,14475,2366,5089,0.465,545,1481,0.368,1821,3608,0.505,1217,1518,0.802,635,1917,2552,1106,510,681,1256,6494
3933,2017-2-30,Los Angeles Clippers,59,14235,2319,4969,0.467,613,1625,0.377,1706,3344,0.51,1127,1509,0.747,554,2010,2564,1325,462,741,1205,6378
3934,2017-2-30,Boston Celtics,60,14475,2323,5117,0.454,731,1994,0.367,1592,3123,0.51,1100,1349,0.815,541,1933,2474,1492,448,736,1229,6477
3935,2017-2-30,Washington Wizards,58,14045,2387,5026,0.475,520,1390,0.374,1867,3636,0.513,966,1232,0.784,598,1893,2491,1369,499,798,1242,6260
3936,2017-2-30,Portland Trail Blazers,59,14360,2323,5104,0.455,602,1659,0.363,1721,3445,0.5,1091,1397,0.781,593,1967,2560,1280,405,789,1302,6339
3937,2017-2-30,Phoenix Suns,60,14550,2366,5263,0.45,476,1384,0.344,1890,3879,0.487,1217,1549,0.786,713,1946,2659,1136,497,905,1486,6425
3938,2017-2-30,San Antonio Spurs,58,13970,2299,4839,0.475,524,1309,0.4,1775,3530,0.503,1078,1332,0.809,567,1982,2549,1393,473,740,1070,6200
3939,2017-2-30,Oklahoma City Thunder,60,14500,2358,5230,0.451,508,1553,0.327,1850,3677,0.503,1151,1547,0.744,709,2076,2785,1261,462,880,1233,6375
3940,2017-2-30,New York Knicks,60,14575,2406,5372,0.448,551,1531,0.36,1855,3841,0.483,988,1270,0.778,737,2018,2755,1306,434,811,1246,6351
3941,2017-2-30,Indiana Pacers,60,14525,2357,5068,0.465,502,1352,0.371,1855,3716,0.499,1111,1363,0.815,512,1987,2499,1358,499,810,1177,6327
3942,2017-2-30,Brooklyn Nets,58,13995,2199,4969,0.443,634,1871,0.339,1565,3098,0.505,1078,1370,0.787,512,2034,2546,1242,406,959,1216,6110
3943,2017-2-30,Milwaukee Bucks,58,13995,2286,4789,0.477,493,1332,0.37,1793,3457,0.519,1037,1364,0.76,530,1858,2388,1425,484,793,1189,6102
3944,2017-2-30,Minnesota Timberwolves,60,14475,2354,5055,0.466,464,1325,0.35,1890,3730,0.507,1130,1432,0.789,690,1881,2571,1408,471,825,1215,6302
3945,2017-2-30,Charlotte Hornets,60,14525,2250,5133,0.438,605,1712,0.353,1645,3421,0.481,1182,1459,0.81,533,2165,2698,1391,390,701,1025,6287
3946,2017-2-30,Los Angeles Lakers,61,14640,2358,5308,0.444,568,1621,0.35,1790,3687,0.485,1070,1405,0.762,702,1977,2679,1256,483,891,1268,6354
3947,2017-2-30,Atlanta Hawks,59,14335,2271,5013,0.453,519,1533,0.339,1752,3480,0.503,1041,1434,0.726,598,2013,2611,1397,487,872,1053,6102
3948,2017-2-30,New Orleans Pelicans,60,14575,2309,5189,0.445,557,1585,0.351,1752,3604,0.486,1009,1353,0.746,512,2111,2623,1347,468,755,1129,6184
3949,2017-2-30,Chicago Bulls,60,14475,2305,5213,0.442,404,1243,0.325,1901,3970,0.479,1160,1454,0.798,763,2017,2780,1299,466,768,1055,6174
3950,2017-2-30,Sacramento Kings,60,14550,2244,4923,0.456,550,1508,0.365,1694,3415,0.496,1121,1440,0.778,544,1920,2464,1357,483,851,1240,6159
3951,2017-2-30,Detroit Pistons,60,14500,2386,5260,0.454,469,1392,0.337,1917,3868,0.496,862,1175,0.734,623,2064,2687,1273,427,706,1088,6103
3952,2017-2-30,Philadelphia 76ers,59,14260,2197,5000,0.439,602,1738,0.346,1595,3262,0.489,1007,1319,0.763,569,1959,2528,1386,499,951,1280,6003
3953,2017-2-30,Miami Heat,60,14475,2320,5134,0.452,565,1571,0.36,1755,3563,0.493,889,1281,0.694,626,2010,2636,1280,423,765,1244,6094
3954,2017-2-30,Memphis Grizzlies,61,14840,2220,5117,0.434,563,1591,0.354,1657,3526,0.47,1172,1491,0.786,671,1975,2646,1273,509,763,1419,6175
3955,2017-2-30,Utah Jazz,60,14450,2195,4726,0.464,571,1563,0.365,1624,3163,0.513,1069,1411,0.758,543,2034,2577,1174,411,783,1146,6030
3956,2017-2-30,Orlando Magic,60,14475,2272,5159,0.44,508,1539,0.33,1764,3620,0.487,927,1273,0.728,583,1983,2566,1319,414,781,1141,5979
3957,2017-2-30,Dallas Mavericks,59,14260,2141,4853,0.441,631,1760,0.359,1510,3093,0.488,856,1065,0.804,469,1794,2263,1195,463,656,1137,5769
3958,2017-3-1,Golden State Warriors,60,14500,2614,5247,0.498,725,1885,0.385,1889,3362,0.562,1130,1425,0.793,545,2140,2685,1857,579,870,1162,7083
3959,2017-3-1,Houston Rockets,61,14740,2461,5307,0.464,892,2462,0.362,1569,2845,0.551,1203,1574,0.764,655,2016,2671,1558,514,893,1234,7017
3960,2017-3-1,Cleveland Cavaliers,58,14020,2305,4938,0.467,761,1953,0.39,1544,2985,0.517,1073,1420,0.756,563,1986,2549,1304,413,779,1033,6444
3961,2017-3-1,Denver Nuggets,60,14475,2443,5276,0.463,627,1691,0.371,1816,3585,0.507,1135,1489,0.762,753,2042,2795,1488,412,895,1183,6648
3962,2017-3-1,Toronto Raptors,60,14475,2366,5089,0.465,545,1481,0.368,1821,3608,0.505,1217,1518,0.802,635,1917,2552,1106,510,681,1256,6494
3963,2017-3-1,Los Angeles Clippers,59,14235,2319,4969,0.467,613,1625,0.377,1706,3344,0.51,1127,1509,0.747,554,2010,2564,1325,462,741,1205,6378
3964,2017-3-1,Boston Celtics,60,14475,2323,5117,0.454,731,1994,0.367,1592,3123,0.51,1100,1349,0.815,541,1933,2474,1492,448,736,1229,6477
3965,2017-3-1,Washington Wizards,58,14045,2387,5026,0.475,520,1390,0.374,1867,3636,0.513,966,1232,0.784,598,1893,2491,1369,499,798,1242,6260
3966,2017-3-1,Portland Trail Blazers,59,14360,2323,5104,0.455,602,1659,0.363,1721,3445,0.5,1091,1397,0.781,593,1967,2560,1280,405,789,1302,6339
3967,2017-3-1,Phoenix Suns,60,14550,2366,5263,0.45,476,1384,0.344,1890,3879,0.487,1217,1549,0.786,713,1946,2659,1136,497,905,1486,6425
3968,2017-3-1,San Antonio Spurs,58,13970,2299,4839,0.475,524,1309,0.4,1775,3530,0.503,1078,1332,0.809,567,1982,2549,1393,473,740,1070,6200
3969,2017-3-1,Oklahoma City Thunder,60,14500,2358,5230,0.451,508,1553,0.327,1850,3677,0.503,1151,1547,0.744,709,2076,2785,1261,462,880,1233,6375
3970,2017-3-1,New York Knicks,60,14575,2406,5372,0.448,551,1531,0.36,1855,3841,0.483,988,1270,0.778,737,2018,2755,1306,434,811,1246,6351
3971,2017-3-1,Indiana Pacers,60,14525,2357,5068,0.465,502,1352,0.371,1855,3716,0.499,1111,1363,0.815,512,1987,2499,1358,499,810,1177,6327
3972,2017-3-1,Brooklyn Nets,58,13995,2199,4969,0.443,634,1871,0.339,1565,3098,0.505,1078,1370,0.787,512,2034,2546,1242,406,959,1216,6110
3973,2017-3-1,Milwaukee Bucks,58,13995,2286,4789,0.477,493,1332,0.37,1793,3457,0.519,1037,1364,0.76,530,1858,2388,1425,484,793,1189,6102
3974,2017-3-1,Minnesota Timberwolves,60,14475,2354,5055,0.466,464,1325,0.35,1890,3730,0.507,1130,1432,0.789,690,1881,2571,1408,471,825,1215,6302
3975,2017-3-1,Charlotte Hornets,60,14525,2250,5133,0.438,605,1712,0.353,1645,3421,0.481,1182,1459,0.81,533,2165,2698,1391,390,701,1025,6287
3976,2017-3-1,Los Angeles Lakers,61,14640,2358,5308,0.444,568,1621,0.35,1790,3687,0.485,1070,1405,0.762,702,1977,2679,1256,483,891,1268,6354
3977,2017-3-1,Atlanta Hawks,59,14335,2271,5013,0.453,519,1533,0.339,1752,3480,0.503,1041,1434,0.726,598,2013,2611,1397,487,872,1053,6102
3978,2017-3-1,New Orleans Pelicans,60,14575,2309,5189,0.445,557,1585,0.351,1752,3604,0.486,1009,1353,0.746,512,2111,2623,1347,468,755,1129,6184
3979,2017-3-1,Chicago Bulls,60,14475,2305,5213,0.442,404,1243,0.325,1901,3970,0.479,1160,1454,0.798,763,2017,2780,1299,466,768,1055,6174
3980,2017-3-1,Sacramento Kings,60,14550,2244,4923,0.456,550,1508,0.365,1694,3415,0.496,1121,1440,0.778,544,1920,2464,1357,483,851,1240,6159
3981,2017-3-1,Detroit Pistons,60,14500,2386,5260,0.454,469,1392,0.337,1917,3868,0.496,862,1175,0.734,623,2064,2687,1273,427,706,1088,6103
3982,2017-3-1,Philadelphia 76ers,59,14260,2197,5000,0.439,602,1738,0.346,1595,3262,0.489,1007,1319,0.763,569,1959,2528,1386,499,951,1280,6003
3983,2017-3-1,Miami Heat,60,14475,2320,5134,0.452,565,1571,0.36,1755,3563,0.493,889,1281,0.694,626,2010,2636,1280,423,765,1244,6094
3984,2017-3-1,Memphis Grizzlies,61,14840,2220,5117,0.434,563,1591,0.354,1657,3526,0.47,1172,1491,0.786,671,1975,2646,1273,509,763,1419,6175
3985,2017-3-1,Utah Jazz,60,14450,2195,4726,0.464,571,1563,0.365,1624,3163,0.513,1069,1411,0.758,543,2034,2577,1174,411,783,1146,6030
3986,2017-3-1,Orlando Magic,60,14475,2272,5159,0.44,508,1539,0.33,1764,3620,0.487,927,1273,0.728,583,1983,2566,1319,414,781,1141,5979
3987,2017-3-1,Dallas Mavericks,59,14260,2141,4853,0.441,631,1760,0.359,1510,3093,0.488,856,1065,0.804,469,1794,2263,1195,463,656,1137,5769
3988,2017-3-2,Golden State Warriors,60,14500,2614,5247,0.498,725,1885,0.385,1889,3362,0.562,1130,1425,0.793,545,2140,2685,1857,579,870,1162,7083
3989,2017-3-2,Houston Rockets,62,14980,2498,5394,0.463,912,2514,0.363,1586,2880,0.551,1231,1607,0.766,674,2059,2733,1579,517,909,1251,7139
3990,2017-3-2,Cleveland Cavaliers,59,14260,2342,5029,0.466,771,1986,0.388,1571,3043,0.516,1088,1442,0.755,575,2015,2590,1324,416,789,1054,6543
3991,2017-3-2,Denver Nuggets,61,14715,2484,5360,0.463,637,1724,0.369,1847,3636,0.508,1153,1509,0.764,767,2073,2840,1509,420,909,1198,6758
3992,2017-3-2,Los Angeles Clippers,60,14475,2361,5063,0.466,625,1659,0.377,1736,3404,0.51,1134,1522,0.745,564,2036,2600,1351,470,748,1228,6481
3993,2017-3-2,Toronto Raptors,61,14715,2399,5179,0.463,552,1501,0.368,1847,3678,0.502,1240,1544,0.803,651,1951,2602,1117,518,692,1274,6590
3994,2017-3-2,Washington Wizards,59,14285,2427,5110,0.475,529,1415,0.374,1898,3695,0.514,982,1251,0.785,605,1930,2535,1401,505,810,1263,6365
3995,2017-3-2,Boston Celtics,61,14715,2359,5195,0.454,744,2025,0.367,1615,3170,0.509,1118,1372,0.815,549,1972,2521,1520,452,748,1250,6580
3996,2017-3-2,Portland Trail Blazers,59,14360,2323,5104,0.455,602,1659,0.363,1721,3445,0.5,1091,1397,0.781,593,1967,2560,1280,405,789,1302,6339
3997,2017-3-2,Phoenix Suns,60,14550,2366,5263,0.45,476,1384,0.344,1890,3879,0.487,1217,1549,0.786,713,1946,2659,1136,497,905,1486,6425
3998,2017-3-2,San Antonio Spurs,59,14210,2334,4913,0.475,533,1338,0.398,1801,3575,0.504,1099,1356,0.81,573,2012,2585,1413,481,758,1091,6300
3999,2017-3-2,Oklahoma City Thunder,60,14500,2358,5230,0.451,508,1553,0.327,1850,3677,0.503,1151,1547,0.744,709,2076,2785,1261,462,880,1233,6375
4000,2017-3-2,New York Knicks,61,14815,2440,5453,0.447,559,1560,0.358,1881,3893,0.483,1013,1301,0.779,750,2055,2805,1327,443,822,1262,6452
4001,2017-3-2,Brooklyn Nets,59,14235,2233,5043,0.443,645,1899,0.34,1588,3144,0.505,1108,1406,0.788,522,2067,2589,1258,414,977,1241,6219
4002,2017-3-2,Indiana Pacers,61,14765,2394,5149,0.465,509,1375,0.37,1885,3774,0.499,1129,1388,0.813,525,2015,2540,1380,512,827,1203,6426
4003,2017-3-2,Milwaukee Bucks,59,14235,2324,4872,0.477,502,1350,0.372,1822,3522,0.517,1050,1379,0.761,540,1882,2422,1451,492,806,1208,6200
4004,2017-3-2,Minnesota Timberwolves,61,14715,2393,5133,0.466,472,1341,0.352,1921,3792,0.507,1151,1458,0.789,700,1919,2619,1431,482,835,1230,6409
4005,2017-3-2,Charlotte Hornets,60,14525,2250,5133,0.438,605,1712,0.353,1645,3421,0.481,1182,1459,0.81,533,2165,2698,1391,390,701,1025,6287
4006,2017-3-2,Los Angeles Lakers,61,14640,2358,5308,0.444,568,1621,0.35,1790,3687,0.485,1070,1405,0.762,702,1977,2679,1256,483,891,1268,6354
4007,2017-3-2,Atlanta Hawks,60,14575,2307,5077,0.454,529,1554,0.34,1778,3523,0.505,1059,1458,0.726,602,2043,2645,1421,499,894,1072,6202
4008,2017-3-2,New Orleans Pelicans,61,14815,2348,5267,0.446,566,1610,0.352,1782,3657,0.487,1031,1376,0.749,520,2156,2676,1365,474,769,1144,6293
4009,2017-3-2,Chicago Bulls,60,14475,2305,5213,0.442,404,1243,0.325,1901,3970,0.479,1160,1454,0.798,763,2017,2780,1299,466,768,1055,6174
4010,2017-3-2,Sacramento Kings,61,14790,2279,5004,0.455,561,1530,0.367,1718,3474,0.495,1140,1462,0.78,554,1948,2502,1369,491,866,1268,6259
4011,2017-3-2,Miami Heat,61,14715,2369,5224,0.453,578,1601,0.361,1791,3623,0.494,903,1302,0.694,634,2044,2678,1304,432,778,1262,6219
4012,2017-3-2,Philadelphia 76ers,60,14500,2234,5085,0.439,608,1755,0.346,1626,3330,0.488,1025,1341,0.764,579,1989,2568,1402,506,970,1302,6101
4013,2017-3-2,Detroit Pistons,61,14740,2426,5363,0.452,472,1415,0.334,1954,3948,0.495,865,1192,0.726,646,2091,2737,1286,438,713,1105,6189
4014,2017-3-2,Memphis Grizzlies,61,14840,2220,5117,0.434,563,1591,0.354,1657,3526,0.47,1172,1491,0.786,671,1975,2646,1273,509,763,1419,6175
4015,2017-3-2,Utah Jazz,61,14690,2230,4816,0.463,575,1582,0.363,1655,3234,0.512,1075,1422,0.756,559,2064,2623,1192,417,797,1169,6110
4016,2017-3-2,Orlando Magic,61,14715,2306,5242,0.44,513,1564,0.328,1793,3678,0.487,944,1295,0.729,592,2017,2609,1330,417,793,1166,6069
4017,2017-3-2,Dallas Mavericks,60,14500,2176,4930,0.441,645,1793,0.36,1531,3137,0.488,867,1078,0.804,479,1817,2296,1217,473,676,1157,5864
4018,2017-3-3,Golden State Warriors,61,14740,2648,5335,0.496,731,1915,0.382,1917,3420,0.561,1143,1439,0.794,551,2175,2726,1880,589,885,1180,7170
4019,2017-3-3,Houston Rockets,62,14980,2498,5394,0.463,912,2514,0.363,1586,2880,0.551,1231,1607,0.766,674,2059,2733,1579,517,909,1251,7139
4020,2017-3-3,Cleveland Cavaliers,59,14260,2342,5029,0.466,771,1986,0.388,1571,3043,0.516,1088,1442,0.755,575,2015,2590,1324,416,789,1054,6543
4021,2017-3-3,Denver Nuggets,61,14715,2484,5360,0.463,637,1724,0.369,1847,3636,0.508,1153,1509,0.764,767,2073,2840,1509,420,909,1198,6758
4022,2017-3-3,Los Angeles Clippers,60,14475,2361,5063,0.466,625,1659,0.377,1736,3404,0.51,1134,1522,0.745,564,2036,2600,1351,470,748,1228,6481
4023,2017-3-3,Toronto Raptors,61,14715,2399,5179,0.463,552,1501,0.368,1847,3678,0.502,1240,1544,0.803,651,1951,2602,1117,518,692,1274,6590
4024,2017-3-3,Washington Wizards,59,14285,2427,5110,0.475,529,1415,0.374,1898,3695,0.514,982,1251,0.785,605,1930,2535,1401,505,810,1263,6365
4025,2017-3-3,Boston Celtics,61,14715,2359,5195,0.454,744,2025,0.367,1615,3170,0.509,1118,1372,0.815,549,1972,2521,1520,452,748,1250,6580
4026,2017-3-3,Portland Trail Blazers,60,14600,2362,5183,0.456,612,1684,0.363,1750,3499,0.5,1117,1432,0.78,602,2003,2605,1299,414,803,1321,6453
4027,2017-3-3,Phoenix Suns,61,14790,2412,5340,0.452,483,1403,0.344,1929,3937,0.49,1238,1574,0.787,717,1984,2701,1166,505,923,1509,6545
4028,2017-3-3,San Antonio Spurs,59,14210,2334,4913,0.475,533,1338,0.398,1801,3575,0.504,1099,1356,0.81,573,2012,2585,1413,481,758,1091,6300
4029,2017-3-3,Oklahoma City Thunder,61,14740,2392,5316,0.45,519,1582,0.328,1873,3734,0.502,1181,1579,0.748,721,2104,2825,1272,471,892,1258,6484
4030,2017-3-3,New York Knicks,61,14815,2440,5453,0.447,559,1560,0.358,1881,3893,0.483,1013,1301,0.779,750,2055,2805,1327,443,822,1262,6452
4031,2017-3-3,Brooklyn Nets,59,14235,2233,5043,0.443,645,1899,0.34,1588,3144,0.505,1108,1406,0.788,522,2067,2589,1258,414,977,1241,6219
4032,2017-3-3,Indiana Pacers,61,14765,2394,5149,0.465,509,1375,0.37,1885,3774,0.499,1129,1388,0.813,525,2015,2540,1380,512,827,1203,6426
4033,2017-3-3,Milwaukee Bucks,59,14235,2324,4872,0.477,502,1350,0.372,1822,3522,0.517,1050,1379,0.761,540,1882,2422,1451,492,806,1208,6200
4034,2017-3-3,Minnesota Timberwolves,61,14715,2393,5133,0.466,472,1341,0.352,1921,3792,0.507,1151,1458,0.789,700,1919,2619,1431,482,835,1230,6409
4035,2017-3-3,Charlotte Hornets,61,14765,2285,5222,0.438,615,1746,0.352,1670,3476,0.48,1205,1487,0.81,542,2190,2732,1410,404,717,1045,6390
4036,2017-3-3,Los Angeles Lakers,61,14640,2358,5308,0.444,568,1621,0.35,1790,3687,0.485,1070,1405,0.762,702,1977,2679,1256,483,891,1268,6354
4037,2017-3-3,Atlanta Hawks,60,14575,2307,5077,0.454,529,1554,0.34,1778,3523,0.505,1059,1458,0.726,602,2043,2645,1421,499,894,1072,6202
4038,2017-3-3,New Orleans Pelicans,61,14815,2348,5267,0.446,566,1610,0.352,1782,3657,0.487,1031,1376,0.749,520,2156,2676,1365,474,769,1144,6293
4039,2017-3-3,Chicago Bulls,61,14715,2341,5295,0.442,409,1262,0.324,1932,4033,0.479,1177,1475,0.798,770,2059,2829,1318,475,783,1070,6268
4040,2017-3-3,Sacramento Kings,61,14790,2279,5004,0.455,561,1530,0.367,1718,3474,0.495,1140,1462,0.78,554,1948,2502,1369,491,866,1268,6259
4041,2017-3-3,Miami Heat,61,14715,2369,5224,0.453,578,1601,0.361,1791,3623,0.494,903,1302,0.694,634,2044,2678,1304,432,778,1262,6219
4042,2017-3-3,Philadelphia 76ers,60,14500,2234,5085,0.439,608,1755,0.346,1626,3330,0.488,1025,1341,0.764,579,1989,2568,1402,506,970,1302,6101
4043,2017-3-3,Detroit Pistons,61,14740,2426,5363,0.452,472,1415,0.334,1954,3948,0.495,865,1192,0.726,646,2091,2737,1286,438,713,1105,6189
4044,2017-3-3,Memphis Grizzlies,61,14840,2220,5117,0.434,563,1591,0.354,1657,3526,0.47,1172,1491,0.786,671,1975,2646,1273,509,763,1419,6175
4045,2017-3-3,Utah Jazz,61,14690,2230,4816,0.463,575,1582,0.363,1655,3234,0.512,1075,1422,0.756,559,2064,2623,1192,417,797,1169,6110
4046,2017-3-3,Orlando Magic,61,14715,2306,5242,0.44,513,1564,0.328,1793,3678,0.487,944,1295,0.729,592,2017,2609,1330,417,793,1166,6069
4047,2017-3-3,Dallas Mavericks,60,14500,2176,4930,0.441,645,1793,0.36,1531,3137,0.488,867,1078,0.804,479,1817,2296,1217,473,676,1157,5864
4048,2017-3-4,Golden State Warriors,61,14740,2648,5335,0.496,731,1915,0.382,1917,3420,0.561,1143,1439,0.794,551,2175,2726,1880,589,885,1180,7170
4049,2017-3-4,Houston Rockets,62,14980,2498,5394,0.463,912,2514,0.363,1586,2880,0.551,1231,1607,0.766,674,2059,2733,1579,517,909,1251,7139
4050,2017-3-4,Cleveland Cavaliers,60,14500,2389,5115,0.467,796,2032,0.392,1593,3083,0.517,1104,1462,0.755,580,2043,2623,1355,423,803,1078,6678
4051,2017-3-4,Denver Nuggets,61,14715,2484,5360,0.463,637,1724,0.369,1847,3636,0.508,1153,1509,0.764,767,2073,2840,1509,420,909,1198,6758
4052,2017-3-4,Toronto Raptors,62,14955,2440,5260,0.464,563,1526,0.369,1877,3734,0.503,1261,1571,0.803,662,1991,2653,1133,523,709,1297,6704
4053,2017-3-4,Boston Celtics,62,14955,2402,5279,0.455,754,2058,0.366,1648,3221,0.512,1137,1397,0.814,555,2012,2567,1550,459,766,1267,6695
4054,2017-3-4,Washington Wizards,60,14525,2461,5202,0.473,539,1445,0.373,1922,3757,0.512,1010,1283,0.787,620,1960,2580,1424,513,821,1284,6471
4055,2017-3-4,Los Angeles Clippers,61,14715,2397,5127,0.468,633,1678,0.377,1764,3449,0.511,1155,1558,0.741,571,2067,2638,1374,474,771,1246,6582
4056,2017-3-4,Portland Trail Blazers,60,14600,2362,5183,0.456,612,1684,0.363,1750,3499,0.5,1117,1432,0.78,602,2003,2605,1299,414,803,1321,6453
4057,2017-3-4,Phoenix Suns,62,15030,2456,5429,0.452,488,1424,0.343,1968,4005,0.491,1263,1605,0.787,726,2020,2746,1194,515,940,1535,6663
4058,2017-3-4,San Antonio Spurs,60,14475,2374,5008,0.474,539,1365,0.395,1835,3643,0.504,1114,1381,0.807,584,2054,2638,1433,487,769,1113,6401
4059,2017-3-4,Oklahoma City Thunder,62,14980,2429,5403,0.45,528,1617,0.327,1901,3786,0.502,1209,1614,0.749,732,2140,2872,1286,481,911,1288,6595
4060,2017-3-4,New York Knicks,62,15055,2473,5537,0.447,566,1581,0.358,1907,3956,0.482,1042,1334,0.781,759,2087,2846,1341,453,832,1282,6554
4061,2017-3-4,Brooklyn Nets,60,14475,2269,5132,0.442,652,1929,0.338,1617,3203,0.505,1126,1430,0.787,531,2100,2631,1270,420,989,1265,6316
4062,2017-3-4,Indiana Pacers,61,14765,2394,5149,0.465,509,1375,0.37,1885,3774,0.499,1129,1388,0.813,525,2015,2540,1380,512,827,1203,6426
4063,2017-3-4,Milwaukee Bucks,60,14475,2368,4952,0.478,512,1375,0.372,1856,3577,0.519,1064,1394,0.763,543,1904,2447,1486,503,816,1235,6312
4064,2017-3-4,Minnesota Timberwolves,61,14715,2393,5133,0.466,472,1341,0.352,1921,3792,0.507,1151,1458,0.789,700,1919,2619,1431,482,835,1230,6409
4065,2017-3-4,Charlotte Hornets,61,14765,2285,5222,0.438,615,1746,0.352,1670,3476,0.48,1205,1487,0.81,542,2190,2732,1410,404,717,1045,6390
4066,2017-3-4,Los Angeles Lakers,62,14880,2395,5395,0.444,574,1645,0.349,1821,3750,0.486,1085,1425,0.761,708,2005,2713,1279,494,905,1289,6449
4067,2017-3-4,Atlanta Hawks,61,14815,2356,5168,0.456,539,1580,0.341,1817,3588,0.506,1081,1488,0.726,613,2075,2688,1451,506,906,1087,6332
4068,2017-3-4,New Orleans Pelicans,62,15080,2383,5358,0.445,574,1635,0.351,1809,3723,0.486,1051,1400,0.751,528,2196,2724,1385,476,785,1166,6391
4069,2017-3-4,Chicago Bulls,61,14715,2341,5295,0.442,409,1262,0.324,1932,4033,0.479,1177,1475,0.798,770,2059,2829,1318,475,783,1070,6268
4070,2017-3-4,Sacramento Kings,61,14790,2279,5004,0.455,561,1530,0.367,1718,3474,0.495,1140,1462,0.78,554,1948,2502,1369,491,866,1268,6259
4071,2017-3-4,Miami Heat,62,14955,2404,5315,0.452,586,1629,0.36,1818,3686,0.493,924,1327,0.696,647,2077,2724,1324,439,787,1278,6318
4072,2017-3-4,Philadelphia 76ers,61,14740,2270,5168,0.439,617,1783,0.346,1653,3385,0.488,1049,1372,0.765,591,2027,2618,1422,511,985,1323,6206
4073,2017-3-4,Detroit Pistons,61,14740,2426,5363,0.452,472,1415,0.334,1954,3948,0.495,865,1192,0.726,646,2091,2737,1286,438,713,1105,6189
4074,2017-3-4,Memphis Grizzlies,62,15080,2258,5199,0.434,572,1619,0.353,1686,3580,0.471,1187,1513,0.785,678,2007,2685,1289,513,773,1442,6275
4075,2017-3-4,Utah Jazz,62,14930,2268,4890,0.464,587,1608,0.365,1681,3282,0.512,1099,1456,0.755,564,2104,2668,1217,424,810,1194,6222
4076,2017-3-4,Orlando Magic,62,14955,2351,5332,0.441,518,1581,0.328,1833,3751,0.489,959,1314,0.73,600,2056,2656,1357,424,802,1179,6179
4077,2017-3-4,Dallas Mavericks,61,14740,2215,5012,0.442,650,1820,0.357,1565,3192,0.49,888,1105,0.804,487,1854,2341,1240,478,684,1177,5968
4078,2017-3-5,Golden State Warriors,61,14740,2648,5335,0.496,731,1915,0.382,1917,3420,0.561,1143,1439,0.794,551,2175,2726,1880,589,885,1180,7170
4079,2017-3-5,Houston Rockets,63,15220,2537,5472,0.464,930,2556,0.364,1607,2916,0.551,1258,1643,0.766,684,2092,2776,1604,527,923,1271,7262
4080,2017-3-5,Cleveland Cavaliers,61,14740,2424,5188,0.467,807,2059,0.392,1617,3129,0.517,1115,1480,0.753,588,2068,2656,1375,427,818,1094,6770
4081,2017-3-5,Denver Nuggets,62,14955,2520,5440,0.463,646,1754,0.368,1874,3686,0.508,1174,1534,0.765,778,2107,2885,1530,425,922,1218,6860
4082,2017-3-5,Boston Celtics,62,14955,2402,5279,0.455,754,2058,0.366,1648,3221,0.512,1137,1397,0.814,555,2012,2567,1550,459,766,1267,6695
4083,2017-3-5,Portland Trail Blazers,61,14840,2411,5269,0.458,628,1709,0.367,1783,3560,0.501,1133,1454,0.779,608,2034,2642,1328,423,815,1334,6583
4084,2017-3-5,Washington Wizards,60,14525,2461,5202,0.473,539,1445,0.373,1922,3757,0.512,1010,1283,0.787,620,1960,2580,1424,513,821,1284,6471
4085,2017-3-5,Toronto Raptors,63,15195,2475,5335,0.464,570,1547,0.368,1905,3788,0.503,1278,1591,0.803,665,2024,2689,1153,525,720,1320,6798
4086,2017-3-5,Los Angeles Clippers,62,14955,2438,5212,0.468,639,1703,0.375,1799,3509,0.513,1168,1574,0.742,582,2093,2675,1394,481,785,1263,6683
4087,2017-3-5,Phoenix Suns,62,15030,2456,5429,0.452,488,1424,0.343,1968,4005,0.491,1263,1605,0.787,726,2020,2746,1194,515,940,1535,6663
4088,2017-3-5,San Antonio Spurs,61,14740,2412,5102,0.473,545,1389,0.392,1867,3713,0.503,1129,1405,0.804,601,2086,2687,1449,497,781,1130,6498
4089,2017-3-5,Oklahoma City Thunder,62,14980,2429,5403,0.45,528,1617,0.327,1901,3786,0.502,1209,1614,0.749,732,2140,2872,1286,481,911,1288,6595
4090,2017-3-5,New York Knicks,62,15055,2473,5537,0.447,566,1581,0.358,1907,3956,0.482,1042,1334,0.781,759,2087,2846,1341,453,832,1282,6554
4091,2017-3-5,Brooklyn Nets,61,14715,2314,5218,0.443,666,1959,0.34,1648,3259,0.506,1138,1447,0.786,539,2123,2662,1294,427,1002,1287,6432
4092,2017-3-5,Indiana Pacers,61,14765,2394,5149,0.465,509,1375,0.37,1885,3774,0.499,1129,1388,0.813,525,2015,2540,1380,512,827,1203,6426
4093,2017-3-5,Milwaukee Bucks,61,14715,2406,5039,0.477,518,1402,0.369,1888,3637,0.519,1083,1417,0.764,552,1937,2489,1502,506,822,1253,6413
4094,2017-3-5,Charlotte Hornets,62,15005,2326,5312,0.438,631,1773,0.356,1695,3539,0.479,1219,1504,0.811,555,2220,2775,1435,412,722,1063,6502
4095,2017-3-5,Minnesota Timberwolves,62,14980,2428,5222,0.465,476,1357,0.351,1952,3865,0.505,1167,1480,0.789,716,1958,2674,1455,488,849,1250,6499
4096,2017-3-5,Los Angeles Lakers,62,14880,2395,5395,0.444,574,1645,0.349,1821,3750,0.486,1085,1425,0.761,708,2005,2713,1279,494,905,1289,6449
4097,2017-3-5,Atlanta Hawks,61,14815,2356,5168,0.456,539,1580,0.341,1817,3588,0.506,1081,1488,0.726,613,2075,2688,1451,506,906,1087,6332
4098,2017-3-5,New Orleans Pelicans,62,15080,2383,5358,0.445,574,1635,0.351,1809,3723,0.486,1051,1400,0.751,528,2196,2724,1385,476,785,1166,6391
4099,2017-3-5,Sacramento Kings,61,14790,2279,5004,0.455,561,1530,0.367,1718,3474,0.495,1140,1462,0.78,554,1948,2502,1369,491,866,1268,6259
4100,2017-3-5,Chicago Bulls,62,14955,2376,5378,0.442,415,1279,0.324,1961,4099,0.478,1192,1495,0.797,784,2090,2874,1344,486,802,1094,6359
4101,2017-3-5,Miami Heat,63,15195,2450,5403,0.453,604,1663,0.363,1846,3740,0.494,934,1339,0.698,662,2110,2772,1344,445,797,1297,6438
4102,2017-3-5,Detroit Pistons,62,14980,2480,5458,0.454,482,1438,0.335,1998,4020,0.497,883,1213,0.728,656,2125,2781,1312,449,720,1114,6325
4103,2017-3-5,Philadelphia 76ers,62,14980,2313,5256,0.44,631,1817,0.347,1682,3439,0.489,1055,1379,0.765,597,2057,2654,1452,516,1004,1341,6312
4104,2017-3-5,Memphis Grizzlies,63,15320,2301,5296,0.434,580,1647,0.352,1721,3649,0.472,1201,1534,0.783,695,2036,2731,1315,521,786,1466,6383
4105,2017-3-5,Utah Jazz,62,14930,2268,4890,0.464,587,1608,0.365,1681,3282,0.512,1099,1456,0.755,564,2104,2668,1217,424,810,1194,6222
4106,2017-3-5,Orlando Magic,62,14955,2351,5332,0.441,518,1581,0.328,1833,3751,0.489,959,1314,0.73,600,2056,2656,1357,424,802,1179,6179
4107,2017-3-5,Dallas Mavericks,61,14740,2215,5012,0.442,650,1820,0.357,1565,3192,0.49,888,1105,0.804,487,1854,2341,1240,478,684,1177,5968
4108,2017-3-6,Golden State Warriors,62,14980,2688,5423,0.496,744,1950,0.382,1944,3473,0.56,1162,1462,0.795,562,2199,2761,1901,600,893,1198,7282
4109,2017-3-6,Houston Rockets,63,15220,2537,5472,0.464,930,2556,0.364,1607,2916,0.551,1258,1643,0.766,684,2092,2776,1604,527,923,1271,7262
4110,2017-3-6,Cleveland Cavaliers,61,14740,2424,5188,0.467,807,2059,0.392,1617,3129,0.517,1115,1480,0.753,588,2068,2656,1375,427,818,1094,6770
4111,2017-3-6,Denver Nuggets,62,14955,2520,5440,0.463,646,1754,0.368,1874,3686,0.508,1174,1534,0.765,778,2107,2885,1530,425,922,1218,6860
4112,2017-3-6,Washington Wizards,61,14765,2500,5283,0.473,553,1471,0.376,1947,3812,0.511,1033,1308,0.79,630,1988,2618,1450,522,833,1300,6586
4113,2017-3-6,Boston Celtics,63,15195,2434,5364,0.454,767,2095,0.366,1667,3269,0.51,1166,1437,0.811,569,2052,2621,1569,465,778,1295,6801
4114,2017-3-6,Portland Trail Blazers,61,14840,2411,5269,0.458,628,1709,0.367,1783,3560,0.501,1133,1454,0.779,608,2034,2642,1328,423,815,1334,6583
4115,2017-3-6,Toronto Raptors,63,15195,2475,5335,0.464,570,1547,0.368,1905,3788,0.503,1278,1591,0.803,665,2024,2689,1153,525,720,1320,6798
4116,2017-3-6,Los Angeles Clippers,62,14955,2438,5212,0.468,639,1703,0.375,1799,3509,0.513,1168,1574,0.742,582,2093,2675,1394,481,785,1263,6683
4117,2017-3-6,Phoenix Suns,63,15270,2498,5523,0.452,492,1444,0.341,2006,4079,0.492,1284,1631,0.787,736,2060,2796,1210,522,951,1564,6772
4118,2017-3-6,San Antonio Spurs,61,14740,2412,5102,0.473,545,1389,0.392,1867,3713,0.503,1129,1405,0.804,601,2086,2687,1449,497,781,1130,6498
4119,2017-3-6,Oklahoma City Thunder,63,15220,2462,5485,0.449,530,1639,0.323,1932,3846,0.502,1230,1644,0.748,745,2176,2921,1305,485,926,1309,6684
4120,2017-3-6,New York Knicks,63,15295,2512,5620,0.447,573,1603,0.357,1939,4017,0.483,1062,1359,0.781,771,2122,2893,1359,458,847,1302,6659
4121,2017-3-6,Brooklyn Nets,61,14715,2314,5218,0.443,666,1959,0.34,1648,3259,0.506,1138,1447,0.786,539,2123,2662,1294,427,1002,1287,6432
4122,2017-3-6,Indiana Pacers,62,15005,2429,5227,0.465,524,1408,0.372,1905,3819,0.499,1141,1409,0.81,534,2050,2584,1404,518,842,1225,6523
4123,2017-3-6,Milwaukee Bucks,61,14715,2406,5039,0.477,518,1402,0.369,1888,3637,0.519,1083,1417,0.764,552,1937,2489,1502,506,822,1253,6413
4124,2017-3-6,Charlotte Hornets,62,15005,2326,5312,0.438,631,1773,0.356,1695,3539,0.479,1219,1504,0.811,555,2220,2775,1435,412,722,1063,6502
4125,2017-3-6,Minnesota Timberwolves,62,14980,2428,5222,0.465,476,1357,0.351,1952,3865,0.505,1167,1480,0.789,716,1958,2674,1455,488,849,1250,6499
4126,2017-3-6,Los Angeles Lakers,63,15120,2433,5478,0.444,584,1673,0.349,1849,3805,0.486,1096,1440,0.761,719,2043,2762,1301,501,930,1313,6546
4127,2017-3-6,Atlanta Hawks,62,15055,2390,5245,0.456,548,1607,0.341,1842,3638,0.506,1100,1519,0.724,624,2108,2732,1472,518,920,1106,6428
4128,2017-3-6,New Orleans Pelicans,63,15320,2419,5447,0.444,583,1659,0.351,1836,3788,0.485,1075,1435,0.749,541,2227,2768,1408,488,798,1178,6496
4129,2017-3-6,Sacramento Kings,62,15055,2322,5087,0.456,569,1547,0.368,1753,3540,0.495,1155,1482,0.779,559,1980,2539,1393,499,878,1289,6368
4130,2017-3-6,Chicago Bulls,62,14955,2376,5378,0.442,415,1279,0.324,1961,4099,0.478,1192,1495,0.797,784,2090,2874,1344,486,802,1094,6359
4131,2017-3-6,Miami Heat,63,15195,2450,5403,0.453,604,1663,0.363,1846,3740,0.494,934,1339,0.698,662,2110,2772,1344,445,797,1297,6438
4132,2017-3-6,Detroit Pistons,62,14980,2480,5458,0.454,482,1438,0.335,1998,4020,0.497,883,1213,0.728,656,2125,2781,1312,449,720,1114,6325
4133,2017-3-6,Philadelphia 76ers,62,14980,2313,5256,0.44,631,1817,0.347,1682,3439,0.489,1055,1379,0.765,597,2057,2654,1452,516,1004,1341,6312
4134,2017-3-6,Memphis Grizzlies,63,15320,2301,5296,0.434,580,1647,0.352,1721,3649,0.472,1201,1534,0.783,695,2036,2731,1315,521,786,1466,6383
4135,2017-3-6,Utah Jazz,63,15195,2309,4980,0.464,597,1641,0.364,1712,3339,0.513,1117,1483,0.753,576,2139,2715,1241,432,823,1209,6332
4136,2017-3-6,Orlando Magic,63,15195,2395,5421,0.442,532,1616,0.329,1863,3805,0.49,971,1333,0.728,613,2086,2699,1373,433,816,1197,6293
4137,2017-3-6,Dallas Mavericks,62,14980,2257,5098,0.443,657,1845,0.356,1600,3253,0.492,901,1121,0.804,492,1886,2378,1264,484,692,1197,6072
4138,2017-3-7,Golden State Warriors,63,15220,2729,5510,0.495,764,1994,0.383,1965,3516,0.559,1179,1484,0.794,575,2229,2804,1934,610,907,1220,7401
4139,2017-3-7,Houston Rockets,64,15460,2578,5560,0.464,944,2595,0.364,1634,2965,0.551,1272,1660,0.766,691,2128,2819,1623,530,935,1291,7372
4140,2017-3-7,Cleveland Cavaliers,62,14980,2459,5266,0.467,816,2086,0.391,1643,3180,0.517,1134,1509,0.751,599,2109,2708,1390,430,835,1109,6868
4141,2017-3-7,Denver Nuggets,63,15195,2557,5514,0.464,659,1784,0.369,1898,3730,0.509,1195,1562,0.765,785,2140,2925,1558,436,939,1236,6968
4142,2017-3-7,Washington Wizards,61,14765,2500,5283,0.473,553,1471,0.376,1947,3812,0.511,1033,1308,0.79,630,1988,2618,1450,522,833,1300,6586
4143,2017-3-7,Portland Trail Blazers,61,14840,2411,5269,0.458,628,1709,0.367,1783,3560,0.501,1133,1454,0.779,608,2034,2642,1328,423,815,1334,6583
4144,2017-3-7,Los Angeles Clippers,63,15195,2477,5285,0.469,648,1723,0.376,1829,3562,0.513,1197,1621,0.738,590,2132,2722,1417,488,798,1287,6799
4145,2017-3-7,Boston Celtics,64,15435,2468,5447,0.453,777,2130,0.365,1691,3317,0.51,1190,1466,0.812,576,2082,2658,1591,474,789,1326,6903
4146,2017-3-7,Toronto Raptors,63,15195,2475,5335,0.464,570,1547,0.368,1905,3788,0.503,1278,1591,0.803,665,2024,2689,1153,525,720,1320,6798
4147,2017-3-7,Phoenix Suns,63,15270,2498,5523,0.452,492,1444,0.341,2006,4079,0.492,1284,1631,0.787,736,2060,2796,1210,522,951,1564,6772
4148,2017-3-7,San Antonio Spurs,62,14980,2452,5190,0.472,556,1417,0.392,1896,3773,0.503,1150,1428,0.805,610,2121,2731,1473,503,790,1143,6610
4149,2017-3-7,Oklahoma City Thunder,63,15220,2462,5485,0.449,530,1639,0.323,1932,3846,0.502,1230,1644,0.748,745,2176,2921,1305,485,926,1309,6684
4150,2017-3-7,New York Knicks,64,15535,2552,5706,0.447,579,1617,0.358,1973,4089,0.483,1089,1387,0.785,783,2155,2938,1385,464,856,1325,6772
4151,2017-3-7,Brooklyn Nets,62,14955,2353,5291,0.445,680,1989,0.342,1673,3302,0.507,1168,1485,0.787,546,2157,2703,1310,439,1018,1314,6554
4152,2017-3-7,Milwaukee Bucks,62,14955,2447,5122,0.478,532,1435,0.371,1915,3687,0.519,1099,1437,0.765,561,1969,2530,1530,513,834,1269,6525
4153,2017-3-7,Indiana Pacers,63,15245,2466,5308,0.465,536,1438,0.373,1930,3870,0.499,1143,1412,0.809,540,2085,2625,1433,521,857,1242,6611
4154,2017-3-7,Charlotte Hornets,63,15245,2361,5398,0.437,642,1804,0.356,1719,3594,0.478,1238,1525,0.812,568,2257,2825,1456,422,732,1071,6602
4155,2017-3-7,Minnesota Timberwolves,62,14980,2428,5222,0.465,476,1357,0.351,1952,3865,0.505,1167,1480,0.789,716,1958,2674,1455,488,849,1250,6499
4156,2017-3-7,Los Angeles Lakers,63,15120,2433,5478,0.444,584,1673,0.349,1849,3805,0.486,1096,1440,0.761,719,2043,2762,1301,501,930,1313,6546
4157,2017-3-7,Atlanta Hawks,63,15295,2428,5327,0.456,561,1635,0.343,1867,3692,0.506,1122,1550,0.724,638,2141,2779,1491,524,939,1129,6539
4158,2017-3-7,New Orleans Pelicans,64,15560,2449,5531,0.443,593,1692,0.35,1856,3839,0.483,1088,1453,0.749,554,2261,2815,1424,499,818,1193,6579
4159,2017-3-7,Sacramento Kings,63,15295,2358,5170,0.456,575,1563,0.368,1783,3607,0.494,1173,1503,0.78,570,2009,2579,1413,508,893,1307,6464
4160,2017-3-7,Chicago Bulls,63,15195,2410,5461,0.441,423,1307,0.324,1987,4154,0.478,1211,1516,0.799,791,2120,2911,1365,489,812,1114,6454
4161,2017-3-7,Miami Heat,64,15435,2489,5494,0.453,620,1698,0.365,1869,3796,0.492,946,1353,0.699,670,2140,2810,1367,452,804,1316,6544
4162,2017-3-7,Detroit Pistons,63,15220,2525,5550,0.455,488,1459,0.334,2037,4091,0.498,896,1233,0.727,666,2163,2829,1338,456,726,1133,6434
4163,2017-3-7,Philadelphia 76ers,63,15220,2352,5345,0.44,639,1847,0.346,1713,3498,0.49,1067,1398,0.763,611,2085,2696,1482,521,1016,1361,6410
4164,2017-3-7,Memphis Grizzlies,64,15560,2335,5373,0.435,590,1672,0.353,1745,3701,0.471,1232,1573,0.783,703,2065,2768,1338,528,801,1495,6492
4165,2017-3-7,Utah Jazz,64,15435,2342,5061,0.463,607,1668,0.364,1735,3393,0.511,1129,1498,0.754,588,2173,2761,1257,442,842,1226,6420
4166,2017-3-7,Orlando Magic,64,15435,2435,5506,0.442,541,1648,0.328,1894,3858,0.491,987,1357,0.727,624,2117,2741,1396,437,829,1220,6398
4167,2017-3-7,Dallas Mavericks,62,14980,2257,5098,0.443,657,1845,0.356,1600,3253,0.492,901,1121,0.804,492,1886,2378,1264,484,692,1197,6072
4168,2017-3-8,Golden State Warriors,63,15220,2729,5510,0.495,764,1994,0.383,1965,3516,0.559,1179,1484,0.794,575,2229,2804,1934,610,907,1220,7401
4169,2017-3-8,Houston Rockets,64,15460,2578,5560,0.464,944,2595,0.364,1634,2965,0.551,1272,1660,0.766,691,2128,2819,1623,530,935,1291,7372
4170,2017-3-8,Cleveland Cavaliers,62,14980,2459,5266,0.467,816,2086,0.391,1643,3180,0.517,1134,1509,0.751,599,2109,2708,1390,430,835,1109,6868
4171,2017-3-8,Denver Nuggets,63,15195,2557,5514,0.464,659,1784,0.369,1898,3730,0.509,1195,1562,0.765,785,2140,2925,1558,436,939,1236,6968
4172,2017-3-8,Washington Wizards,62,15005,2541,5373,0.473,560,1489,0.376,1981,3884,0.51,1075,1361,0.79,639,2023,2662,1469,537,844,1321,6717
4173,2017-3-8,Portland Trail Blazers,62,15080,2458,5354,0.459,639,1732,0.369,1819,3622,0.502,1154,1481,0.779,620,2058,2678,1352,430,826,1357,6709
4174,2017-3-8,Los Angeles Clippers,63,15195,2477,5285,0.469,648,1723,0.376,1829,3562,0.513,1197,1621,0.738,590,2132,2722,1417,488,798,1287,6799
4175,2017-3-8,Boston Celtics,64,15435,2468,5447,0.453,777,2130,0.365,1691,3317,0.51,1190,1466,0.812,576,2082,2658,1591,474,789,1326,6903
4176,2017-3-8,Toronto Raptors,63,15195,2475,5335,0.464,570,1547,0.368,1905,3788,0.503,1278,1591,0.803,665,2024,2689,1153,525,720,1320,6798
4177,2017-3-8,Phoenix Suns,64,15510,2542,5611,0.453,505,1471,0.343,2037,4140,0.492,1310,1664,0.787,745,2100,2845,1233,527,970,1596,6899
4178,2017-3-8,San Antonio Spurs,62,14980,2452,5190,0.472,556,1417,0.392,1896,3773,0.503,1150,1428,0.805,610,2121,2731,1473,503,790,1143,6610
4179,2017-3-8,Oklahoma City Thunder,64,15460,2506,5570,0.45,540,1664,0.325,1966,3906,0.503,1253,1674,0.749,757,2203,2960,1321,489,943,1334,6805
4180,2017-3-8,New York Knicks,64,15535,2552,5706,0.447,579,1617,0.358,1973,4089,0.483,1089,1387,0.785,783,2155,2938,1385,464,856,1325,6772
4181,2017-3-8,Brooklyn Nets,62,14955,2353,5291,0.445,680,1989,0.342,1673,3302,0.507,1168,1485,0.787,546,2157,2703,1310,439,1018,1314,6554
4182,2017-3-8,Milwaukee Bucks,62,14955,2447,5122,0.478,532,1435,0.371,1915,3687,0.519,1099,1437,0.765,561,1969,2530,1530,513,834,1269,6525
4183,2017-3-8,Indiana Pacers,63,15245,2466,5308,0.465,536,1438,0.373,1930,3870,0.499,1143,1412,0.809,540,2085,2625,1433,521,857,1242,6611
4184,2017-3-8,Charlotte Hornets,63,15245,2361,5398,0.437,642,1804,0.356,1719,3594,0.478,1238,1525,0.812,568,2257,2825,1456,422,732,1071,6602
4185,2017-3-8,Minnesota Timberwolves,62,14980,2428,5222,0.465,476,1357,0.351,1952,3865,0.505,1167,1480,0.789,716,1958,2674,1455,488,849,1250,6499
4186,2017-3-8,Los Angeles Lakers,64,15360,2475,5568,0.445,595,1703,0.349,1880,3865,0.486,1112,1462,0.761,730,2076,2806,1326,510,941,1333,6657
4187,2017-3-8,Atlanta Hawks,63,15295,2428,5327,0.456,561,1635,0.343,1867,3692,0.506,1122,1550,0.724,638,2141,2779,1491,524,939,1129,6539
4188,2017-3-8,New Orleans Pelicans,64,15560,2449,5531,0.443,593,1692,0.35,1856,3839,0.483,1088,1453,0.749,554,2261,2815,1424,499,818,1193,6579
4189,2017-3-8,Sacramento Kings,63,15295,2358,5170,0.456,575,1563,0.368,1783,3607,0.494,1173,1503,0.78,570,2009,2579,1413,508,893,1307,6464
4190,2017-3-8,Chicago Bulls,63,15195,2410,5461,0.441,423,1307,0.324,1987,4154,0.478,1211,1516,0.799,791,2120,2911,1365,489,812,1114,6454
4191,2017-3-8,Miami Heat,64,15435,2489,5494,0.453,620,1698,0.365,1869,3796,0.492,946,1353,0.699,670,2140,2810,1367,452,804,1316,6544
4192,2017-3-8,Detroit Pistons,63,15220,2525,5550,0.455,488,1459,0.334,2037,4091,0.498,896,1233,0.727,666,2163,2829,1338,456,726,1133,6434
4193,2017-3-8,Philadelphia 76ers,63,15220,2352,5345,0.44,639,1847,0.346,1713,3498,0.49,1067,1398,0.763,611,2085,2696,1482,521,1016,1361,6410
4194,2017-3-8,Memphis Grizzlies,64,15560,2335,5373,0.435,590,1672,0.353,1745,3701,0.471,1232,1573,0.783,703,2065,2768,1338,528,801,1495,6492
4195,2017-3-8,Utah Jazz,64,15435,2342,5061,0.463,607,1668,0.364,1735,3393,0.511,1129,1498,0.754,588,2173,2761,1257,442,842,1226,6420
4196,2017-3-8,Orlando Magic,64,15435,2435,5506,0.442,541,1648,0.328,1894,3858,0.491,987,1357,0.727,624,2117,2741,1396,437,829,1220,6398
4197,2017-3-8,Dallas Mavericks,63,15220,2302,5181,0.444,674,1876,0.359,1628,3305,0.493,916,1140,0.804,498,1921,2419,1289,489,706,1214,6194
4198,2017-3-9,Golden State Warriors,64,15460,2766,5594,0.494,770,2024,0.38,1996,3570,0.559,1185,1493,0.794,587,2263,2850,1957,618,924,1240,7487
4199,2017-3-9,Houston Rockets,65,15700,2613,5639,0.463,952,2627,0.362,1661,3012,0.551,1302,1700,0.766,701,2149,2850,1645,539,943,1311,7480
4200,2017-3-9,Cleveland Cavaliers,62,14980,2459,5266,0.467,816,2086,0.391,1643,3180,0.517,1134,1509,0.751,599,2109,2708,1390,430,835,1109,6868
4201,2017-3-9,Denver Nuggets,64,15435,2603,5601,0.465,672,1812,0.371,1931,3789,0.51,1203,1579,0.762,795,2169,2964,1589,442,955,1252,7081
4202,2017-3-9,Washington Wizards,63,15245,2591,5461,0.474,571,1515,0.377,2020,3946,0.512,1087,1380,0.788,647,2058,2705,1500,547,855,1337,6840
4203,2017-3-9,Portland Trail Blazers,62,15080,2458,5354,0.459,639,1732,0.369,1819,3622,0.502,1154,1481,0.779,620,2058,2678,1352,430,826,1357,6709
4204,2017-3-9,Phoenix Suns,64,15510,2542,5611,0.453,505,1471,0.343,2037,4140,0.492,1310,1664,0.787,745,2100,2845,1233,527,970,1596,6899
4205,2017-3-9,Los Angeles Clippers,64,15435,2512,5368,0.468,657,1747,0.376,1855,3621,0.512,1209,1639,0.738,600,2158,2758,1435,497,814,1305,6890
4206,2017-3-9,Boston Celtics,65,15675,2505,5531,0.453,787,2159,0.365,1718,3372,0.509,1205,1485,0.811,585,2118,2703,1619,486,801,1336,7002
4207,2017-3-9,Toronto Raptors,64,15435,2511,5411,0.464,578,1568,0.369,1933,3843,0.503,1292,1614,0.8,673,2058,2731,1174,531,731,1338,6892
4208,2017-3-9,San Antonio Spurs,63,15220,2494,5274,0.473,570,1446,0.394,1924,3828,0.503,1166,1449,0.805,616,2158,2774,1506,512,802,1158,6724
4209,2017-3-9,Oklahoma City Thunder,64,15460,2506,5570,0.45,540,1664,0.325,1966,3906,0.503,1253,1674,0.749,757,2203,2960,1321,489,943,1334,6805
4210,2017-3-9,Brooklyn Nets,63,15195,2390,5371,0.445,691,2022,0.342,1699,3349,0.507,1188,1510,0.787,551,2192,2743,1338,446,1040,1339,6659
4211,2017-3-9,New York Knicks,65,15775,2591,5790,0.447,586,1638,0.358,2005,4152,0.483,1097,1399,0.784,793,2188,2981,1407,468,871,1345,6865
4212,2017-3-9,Milwaukee Bucks,63,15195,2484,5208,0.477,540,1461,0.37,1944,3747,0.519,1121,1465,0.765,573,2003,2576,1556,522,842,1282,6629
4213,2017-3-9,Indiana Pacers,64,15485,2510,5396,0.465,547,1461,0.374,1963,3935,0.499,1159,1431,0.81,549,2122,2671,1460,524,862,1260,6726
4214,2017-3-9,Minnesota Timberwolves,63,15220,2470,5308,0.465,481,1377,0.349,1989,3931,0.506,1185,1500,0.79,730,1994,2724,1481,498,861,1273,6606
4215,2017-3-9,Charlotte Hornets,64,15485,2398,5478,0.438,649,1825,0.356,1749,3653,0.479,1258,1546,0.814,574,2290,2864,1470,429,744,1088,6703
4216,2017-3-9,Los Angeles Lakers,64,15360,2475,5568,0.445,595,1703,0.349,1880,3865,0.486,1112,1462,0.761,730,2076,2806,1326,510,941,1333,6657
4217,2017-3-9,Atlanta Hawks,64,15535,2469,5422,0.455,565,1655,0.341,1904,3767,0.505,1146,1582,0.724,649,2177,2826,1510,536,954,1151,6649
4218,2017-3-9,New Orleans Pelicans,65,15800,2483,5611,0.443,602,1721,0.35,1881,3890,0.484,1098,1466,0.749,562,2293,2855,1446,505,832,1213,6666
4219,2017-3-9,Sacramento Kings,64,15535,2400,5256,0.457,582,1582,0.368,1818,3674,0.495,1186,1519,0.781,575,2046,2621,1433,515,906,1329,6568
4220,2017-3-9,Miami Heat,65,15675,2526,5579,0.453,637,1739,0.366,1889,3840,0.492,963,1377,0.699,683,2173,2856,1389,460,816,1334,6652
4221,2017-3-9,Chicago Bulls,64,15435,2446,5542,0.441,435,1335,0.326,2011,4207,0.478,1218,1527,0.798,800,2155,2955,1389,492,828,1130,6545
4222,2017-3-9,Detroit Pistons,64,15460,2564,5639,0.455,495,1485,0.333,2069,4154,0.498,909,1255,0.724,677,2197,2874,1358,460,736,1151,6532
4223,2017-3-9,Philadelphia 76ers,63,15220,2352,5345,0.44,639,1847,0.346,1713,3498,0.49,1067,1398,0.763,611,2085,2696,1482,521,1016,1361,6410
4224,2017-3-9,Memphis Grizzlies,64,15560,2335,5373,0.435,590,1672,0.353,1745,3701,0.471,1232,1573,0.783,703,2065,2768,1338,528,801,1495,6492
4225,2017-3-9,Utah Jazz,65,15675,2383,5137,0.464,619,1699,0.364,1764,3438,0.513,1150,1522,0.756,598,2208,2806,1278,444,858,1249,6535
4226,2017-3-9,Orlando Magic,65,15675,2472,5595,0.442,548,1673,0.328,1924,3922,0.491,1004,1378,0.729,639,2150,2789,1417,447,838,1237,6496
4227,2017-3-9,Dallas Mavericks,63,15220,2302,5181,0.444,674,1876,0.359,1628,3305,0.493,916,1140,0.804,498,1921,2419,1289,489,706,1214,6194
4228,2017-3-10,Golden State Warriors,64,15460,2766,5594,0.494,770,2024,0.38,1996,3570,0.559,1185,1493,0.794,587,2263,2850,1957,618,924,1240,7487
4229,2017-3-10,Houston Rockets,65,15700,2613,5639,0.463,952,2627,0.362,1661,3012,0.551,1302,1700,0.766,701,2149,2850,1645,539,943,1311,7480
4230,2017-3-10,Cleveland Cavaliers,63,15220,2498,5350,0.467,827,2125,0.389,1671,3225,0.518,1146,1528,0.75,607,2143,2750,1414,434,844,1126,6969
4231,2017-3-10,Denver Nuggets,64,15435,2603,5601,0.465,672,1812,0.371,1931,3789,0.51,1203,1579,0.762,795,2169,2964,1589,442,955,1252,7081
4232,2017-3-10,Washington Wizards,63,15245,2591,5461,0.474,571,1515,0.377,2020,3946,0.512,1087,1380,0.788,647,2058,2705,1500,547,855,1337,6840
4233,2017-3-10,Portland Trail Blazers,63,15345,2498,5442,0.459,645,1753,0.368,1853,3689,0.502,1182,1514,0.781,636,2097,2733,1377,438,845,1379,6823
4234,2017-3-10,Phoenix Suns,65,15750,2584,5702,0.453,511,1490,0.343,2073,4212,0.492,1330,1689,0.787,763,2136,2899,1253,534,989,1620,7009
4235,2017-3-10,Los Angeles Clippers,65,15675,2552,5446,0.469,668,1777,0.376,1884,3669,0.513,1232,1667,0.739,607,2198,2805,1459,499,828,1323,7004
4236,2017-3-10,Boston Celtics,65,15675,2505,5531,0.453,787,2159,0.365,1718,3372,0.509,1205,1485,0.811,585,2118,2703,1619,486,801,1336,7002
4237,2017-3-10,Toronto Raptors,64,15435,2511,5411,0.464,578,1568,0.369,1933,3843,0.503,1292,1614,0.8,673,2058,2731,1174,531,731,1338,6892
4238,2017-3-10,San Antonio Spurs,64,15460,2529,5358,0.472,576,1465,0.393,1953,3893,0.502,1182,1469,0.805,629,2186,2815,1521,520,817,1174,6816
4239,2017-3-10,Oklahoma City Thunder,65,15700,2547,5659,0.45,546,1684,0.324,2001,3975,0.503,1267,1695,0.747,772,2236,3008,1344,499,954,1356,6907
4240,2017-3-10,Brooklyn Nets,63,15195,2390,5371,0.445,691,2022,0.342,1699,3349,0.507,1188,1510,0.787,551,2192,2743,1338,446,1040,1339,6659
4241,2017-3-10,New York Knicks,65,15775,2591,5790,0.447,586,1638,0.358,2005,4152,0.483,1097,1399,0.784,793,2188,2981,1407,468,871,1345,6865
4242,2017-3-10,Milwaukee Bucks,63,15195,2484,5208,0.477,540,1461,0.37,1944,3747,0.519,1121,1465,0.765,573,2003,2576,1556,522,842,1282,6629
4243,2017-3-10,Indiana Pacers,64,15485,2510,5396,0.465,547,1461,0.374,1963,3935,0.499,1159,1431,0.81,549,2122,2671,1460,524,862,1260,6726
4244,2017-3-10,Minnesota Timberwolves,63,15220,2470,5308,0.465,481,1377,0.349,1989,3931,0.506,1185,1500,0.79,730,1994,2724,1481,498,861,1273,6606
4245,2017-3-10,Charlotte Hornets,64,15485,2398,5478,0.438,649,1825,0.356,1749,3653,0.479,1258,1546,0.814,574,2290,2864,1470,429,744,1088,6703
4246,2017-3-10,Los Angeles Lakers,65,15600,2522,5666,0.445,607,1730,0.351,1915,3936,0.487,1128,1486,0.759,744,2104,2848,1347,521,950,1353,6779
4247,2017-3-10,Atlanta Hawks,64,15535,2469,5422,0.455,565,1655,0.341,1904,3767,0.505,1146,1582,0.724,649,2177,2826,1510,536,954,1151,6649
4248,2017-3-10,New Orleans Pelicans,65,15800,2483,5611,0.443,602,1721,0.35,1881,3890,0.484,1098,1466,0.749,562,2293,2855,1446,505,832,1213,6666
4249,2017-3-10,Sacramento Kings,64,15535,2400,5256,0.457,582,1582,0.368,1818,3674,0.495,1186,1519,0.781,575,2046,2621,1433,515,906,1329,6568
4250,2017-3-10,Miami Heat,65,15675,2526,5579,0.453,637,1739,0.366,1889,3840,0.492,963,1377,0.699,683,2173,2856,1389,460,816,1334,6652
4251,2017-3-10,Chicago Bulls,64,15435,2446,5542,0.441,435,1335,0.326,2011,4207,0.478,1218,1527,0.798,800,2155,2955,1389,492,828,1130,6545
4252,2017-3-10,Detroit Pistons,65,15700,2605,5727,0.455,504,1511,0.334,2101,4216,0.498,924,1274,0.725,688,2231,2919,1380,466,743,1166,6638
4253,2017-3-10,Philadelphia 76ers,64,15485,2393,5439,0.44,650,1876,0.346,1743,3563,0.489,1082,1418,0.763,623,2117,2740,1500,531,1032,1390,6518
4254,2017-3-10,Memphis Grizzlies,65,15800,2372,5456,0.435,597,1692,0.353,1775,3764,0.472,1249,1595,0.783,709,2093,2802,1364,534,810,1517,6590
4255,2017-3-10,Utah Jazz,65,15675,2383,5137,0.464,619,1699,0.364,1764,3438,0.513,1150,1522,0.756,598,2208,2806,1278,444,858,1249,6535
4256,2017-3-10,Orlando Magic,65,15675,2472,5595,0.442,548,1673,0.328,1924,3922,0.491,1004,1378,0.729,639,2150,2789,1417,447,838,1237,6496
4257,2017-3-10,Dallas Mavericks,63,15220,2302,5181,0.444,674,1876,0.359,1628,3305,0.493,916,1140,0.804,498,1921,2419,1289,489,706,1214,6194
4258,2017-3-11,Golden State Warriors,65,15700,2807,5682,0.494,777,2048,0.379,2030,3634,0.559,1198,1510,0.793,599,2294,2893,1982,627,936,1261,7589
4259,2017-3-11,Houston Rockets,66,15940,2650,5728,0.463,967,2674,0.362,1683,3054,0.551,1328,1732,0.767,712,2192,2904,1671,550,960,1326,7595
4260,2017-3-11,Denver Nuggets,65,15675,2648,5686,0.466,684,1843,0.371,1964,3843,0.511,1220,1601,0.762,806,2208,3014,1613,453,973,1270,7200
4261,2017-3-11,Cleveland Cavaliers,63,15220,2498,5350,0.467,827,2125,0.389,1671,3225,0.518,1146,1528,0.75,607,2143,2750,1414,434,844,1126,6969
4262,2017-3-11,Washington Wizards,64,15510,2643,5565,0.475,580,1541,0.376,2063,4024,0.513,1104,1399,0.789,659,2098,2757,1529,554,864,1359,6970
4263,2017-3-11,Portland Trail Blazers,63,15345,2498,5442,0.459,645,1753,0.368,1853,3689,0.502,1182,1514,0.781,636,2097,2733,1377,438,845,1379,6823
4264,2017-3-11,Phoenix Suns,65,15750,2584,5702,0.453,511,1490,0.343,2073,4212,0.492,1330,1689,0.787,763,2136,2899,1253,534,989,1620,7009
4265,2017-3-11,Los Angeles Clippers,65,15675,2552,5446,0.469,668,1777,0.376,1884,3669,0.513,1232,1667,0.739,607,2198,2805,1459,499,828,1323,7004
4266,2017-3-11,Boston Celtics,66,15915,2539,5612,0.452,799,2192,0.365,1740,3420,0.509,1224,1508,0.812,594,2143,2737,1638,497,819,1359,7101
4267,2017-3-11,Toronto Raptors,65,15675,2548,5503,0.463,582,1593,0.365,1966,3910,0.503,1313,1641,0.8,689,2088,2777,1193,548,742,1366,6991
4268,2017-3-11,San Antonio Spurs,64,15460,2529,5358,0.472,576,1465,0.393,1953,3893,0.502,1182,1469,0.805,629,2186,2815,1521,520,817,1174,6816
4269,2017-3-11,Oklahoma City Thunder,65,15700,2547,5659,0.45,546,1684,0.324,2001,3975,0.503,1267,1695,0.747,772,2236,3008,1344,499,954,1356,6907
4270,2017-3-11,New York Knicks,65,15775,2591,5790,0.447,586,1638,0.358,2005,4152,0.483,1097,1399,0.784,793,2188,2981,1407,468,871,1345,6865
4271,2017-3-11,Brooklyn Nets,64,15435,2424,5449,0.445,700,2053,0.341,1724,3396,0.508,1207,1533,0.787,555,2223,2778,1361,455,1052,1367,6755
4272,2017-3-11,Milwaukee Bucks,64,15435,2517,5272,0.477,547,1478,0.37,1970,3794,0.519,1147,1495,0.767,578,2032,2610,1573,535,862,1303,6728
4273,2017-3-11,Charlotte Hornets,65,15725,2445,5557,0.44,659,1846,0.357,1786,3711,0.481,1275,1566,0.814,580,2327,2907,1504,435,751,1105,6824
4274,2017-3-11,Minnesota Timberwolves,64,15460,2509,5396,0.465,485,1391,0.349,2024,4005,0.505,1206,1527,0.79,744,2026,2770,1502,504,872,1291,6709
4275,2017-3-11,Indiana Pacers,65,15725,2543,5471,0.465,549,1479,0.371,1994,3992,0.499,1176,1453,0.809,557,2150,2707,1475,538,880,1284,6811
4276,2017-3-11,Los Angeles Lakers,65,15600,2522,5666,0.445,607,1730,0.351,1915,3936,0.487,1128,1486,0.759,744,2104,2848,1347,521,950,1353,6779
4277,2017-3-11,Atlanta Hawks,65,15775,2508,5497,0.456,573,1677,0.342,1935,3820,0.507,1165,1611,0.723,657,2214,2871,1534,544,975,1171,6754
4278,2017-3-11,Sacramento Kings,65,15800,2444,5348,0.457,594,1605,0.37,1850,3743,0.494,1208,1547,0.781,583,2078,2661,1460,520,916,1350,6690
4279,2017-3-11,New Orleans Pelicans,65,15800,2483,5611,0.443,602,1721,0.35,1881,3890,0.484,1098,1466,0.749,562,2293,2855,1446,505,832,1213,6666
4280,2017-3-11,Miami Heat,65,15675,2526,5579,0.453,637,1739,0.366,1889,3840,0.492,963,1377,0.699,683,2173,2856,1389,460,816,1334,6652
4281,2017-3-11,Detroit Pistons,65,15700,2605,5727,0.455,504,1511,0.334,2101,4216,0.498,924,1274,0.725,688,2231,2919,1380,466,743,1166,6638
4282,2017-3-11,Chicago Bulls,65,15675,2484,5640,0.44,444,1374,0.323,2040,4266,0.478,1227,1539,0.797,811,2193,3004,1413,501,846,1151,6639
4283,2017-3-11,Philadelphia 76ers,64,15485,2393,5439,0.44,650,1876,0.346,1743,3563,0.489,1082,1418,0.763,623,2117,2740,1500,531,1032,1390,6518
4284,2017-3-11,Memphis Grizzlies,65,15800,2372,5456,0.435,597,1692,0.353,1775,3764,0.472,1249,1595,0.783,709,2093,2802,1364,534,810,1517,6590
4285,2017-3-11,Utah Jazz,65,15675,2383,5137,0.464,619,1699,0.364,1764,3438,0.513,1150,1522,0.756,598,2208,2806,1278,444,858,1249,6535
4286,2017-3-11,Orlando Magic,66,15915,2503,5671,0.441,553,1700,0.325,1950,3971,0.491,1018,1400,0.727,647,2173,2820,1436,451,848,1261,6577
4287,2017-3-11,Dallas Mavericks,64,15460,2335,5259,0.444,688,1909,0.36,1647,3350,0.492,941,1168,0.806,505,1961,2466,1305,494,721,1232,6299
4288,2017-3-12,Golden State Warriors,66,15940,2840,5774,0.492,782,2065,0.379,2058,3709,0.555,1212,1533,0.791,619,2323,2942,2001,637,951,1277,7674
4289,2017-3-12,Houston Rockets,66,15940,2650,5728,0.463,967,2674,0.362,1683,3054,0.551,1328,1732,0.767,712,2192,2904,1671,550,960,1326,7595
4290,2017-3-12,Cleveland Cavaliers,64,15460,2541,5436,0.467,842,2164,0.389,1699,3272,0.519,1161,1553,0.748,616,2186,2802,1444,435,853,1144,7085
4291,2017-3-12,Denver Nuggets,66,15915,2688,5771,0.466,693,1877,0.369,1995,3894,0.512,1236,1619,0.763,815,2243,3058,1634,461,982,1286,7305
4292,2017-3-12,Washington Wizards,65,15775,2690,5655,0.476,592,1566,0.378,2098,4089,0.513,1123,1427,0.787,668,2135,2803,1556,559,875,1379,7095
4293,2017-3-12,Portland Trail Blazers,64,15610,2546,5536,0.46,661,1785,0.37,1885,3751,0.503,1194,1530,0.78,643,2133,2776,1403,442,859,1398,6947
4294,2017-3-12,Los Angeles Clippers,66,15915,2592,5527,0.469,676,1802,0.375,1916,3725,0.514,1256,1696,0.741,615,2231,2846,1484,512,841,1336,7116
4295,2017-3-12,Phoenix Suns,66,15990,2622,5785,0.453,517,1511,0.342,2105,4274,0.493,1348,1709,0.789,768,2171,2939,1271,539,1000,1644,7109
4296,2017-3-12,Boston Celtics,66,15915,2539,5612,0.452,799,2192,0.365,1740,3420,0.509,1224,1508,0.812,594,2143,2737,1638,497,819,1359,7101
4297,2017-3-12,Toronto Raptors,66,15915,2581,5591,0.462,584,1608,0.363,1997,3983,0.501,1334,1666,0.801,705,2120,2825,1200,554,754,1386,7080
4298,2017-3-12,San Antonio Spurs,65,15700,2569,5435,0.473,588,1492,0.394,1981,3943,0.502,1197,1487,0.805,636,2225,2861,1548,526,835,1192,6923
4299,2017-3-12,Oklahoma City Thunder,66,15940,2590,5745,0.451,554,1707,0.325,2036,4038,0.504,1285,1719,0.748,784,2267,3051,1367,506,966,1376,7019
4300,2017-3-12,Brooklyn Nets,64,15435,2424,5449,0.445,700,2053,0.341,1724,3396,0.508,1207,1533,0.787,555,2223,2778,1361,455,1052,1367,6755
4301,2017-3-12,New York Knicks,66,16015,2627,5872,0.447,599,1668,0.359,2028,4204,0.482,1104,1410,0.783,801,2224,3025,1433,472,889,1363,6957
4302,2017-3-12,Charlotte Hornets,66,15990,2491,5659,0.44,672,1892,0.355,1819,3767,0.483,1292,1586,0.815,591,2366,2957,1536,440,760,1119,6946
4303,2017-3-12,Milwaukee Bucks,65,15675,2554,5352,0.477,555,1498,0.37,1999,3854,0.519,1167,1518,0.769,589,2061,2650,1592,540,871,1326,6830
4304,2017-3-12,Indiana Pacers,65,15725,2543,5471,0.465,549,1479,0.371,1994,3992,0.499,1176,1453,0.809,557,2150,2707,1475,538,880,1284,6811
4305,2017-3-12,Minnesota Timberwolves,65,15700,2546,5477,0.465,490,1404,0.349,2056,4073,0.505,1222,1548,0.789,755,2053,2808,1523,508,884,1313,6804
4306,2017-3-12,Los Angeles Lakers,65,15600,2522,5666,0.445,607,1730,0.351,1915,3936,0.487,1128,1486,0.759,744,2104,2848,1347,521,950,1353,6779
4307,2017-3-12,Atlanta Hawks,66,16015,2544,5569,0.457,588,1707,0.344,1956,3862,0.506,1185,1637,0.724,663,2254,2917,1556,553,993,1194,6861
4308,2017-3-12,New Orleans Pelicans,66,16065,2533,5710,0.444,616,1755,0.351,1917,3955,0.485,1109,1482,0.748,571,2331,2902,1479,509,842,1229,6791
4309,2017-3-12,Sacramento Kings,66,16040,2480,5430,0.457,602,1628,0.37,1878,3802,0.494,1220,1567,0.779,593,2109,2702,1484,524,928,1365,6782
4310,2017-3-12,Miami Heat,66,15915,2561,5651,0.453,648,1767,0.367,1913,3884,0.493,986,1410,0.699,686,2205,2891,1410,468,828,1353,6756
4311,2017-3-12,Detroit Pistons,66,15940,2651,5823,0.455,513,1538,0.334,2138,4285,0.499,935,1293,0.723,702,2268,2970,1407,480,750,1181,6750
4312,2017-3-12,Chicago Bulls,65,15675,2484,5640,0.44,444,1374,0.323,2040,4266,0.478,1227,1539,0.797,811,2193,3004,1413,501,846,1151,6639
4313,2017-3-12,Philadelphia 76ers,65,15725,2433,5523,0.441,660,1906,0.346,1773,3617,0.49,1092,1432,0.763,630,2151,2781,1528,542,1048,1413,6618
4314,2017-3-12,Memphis Grizzlies,66,16040,2406,5546,0.434,602,1721,0.35,1804,3825,0.472,1266,1618,0.782,722,2121,2843,1386,545,823,1538,6680
4315,2017-3-12,Utah Jazz,66,15915,2419,5212,0.464,628,1719,0.365,1791,3493,0.513,1173,1550,0.757,605,2237,2842,1293,453,870,1266,6639
4316,2017-3-12,Orlando Magic,67,16155,2541,5767,0.441,557,1721,0.324,1984,4046,0.49,1042,1428,0.73,661,2211,2872,1453,457,853,1282,6681
4317,2017-3-12,Dallas Mavericks,65,15700,2363,5333,0.443,697,1935,0.36,1666,3398,0.49,974,1204,0.809,515,1999,2514,1322,496,734,1249,6397
4318,2017-3-13,Golden State Warriors,66,15940,2840,5774,0.492,782,2065,0.379,2058,3709,0.555,1212,1533,0.791,619,2323,2942,2001,637,951,1277,7674
4319,2017-3-13,Houston Rockets,67,16180,2691,5824,0.462,983,2719,0.362,1708,3105,0.55,1347,1760,0.765,732,2224,2956,1696,560,966,1343,7712
4320,2017-3-13,Cleveland Cavaliers,65,15700,2583,5516,0.468,859,2207,0.389,1724,3309,0.521,1172,1566,0.748,620,2220,2840,1468,438,868,1167,7197
4321,2017-3-13,Denver Nuggets,66,15915,2688,5771,0.466,693,1877,0.369,1995,3894,0.512,1236,1619,0.763,815,2243,3058,1634,461,982,1286,7305
4322,2017-3-13,Washington Wizards,65,15775,2690,5655,0.476,592,1566,0.378,2098,4089,0.513,1123,1427,0.787,668,2135,2803,1556,559,875,1379,7095
4323,2017-3-13,Portland Trail Blazers,65,15850,2589,5622,0.461,668,1807,0.37,1921,3815,0.504,1211,1555,0.779,652,2173,2825,1417,449,873,1422,7057
4324,2017-3-13,Los Angeles Clippers,66,15915,2592,5527,0.469,676,1802,0.375,1916,3725,0.514,1256,1696,0.741,615,2231,2846,1484,512,841,1336,7116
4325,2017-3-13,Phoenix Suns,67,16230,2663,5878,0.453,522,1525,0.342,2141,4353,0.492,1362,1729,0.788,774,2206,2980,1291,544,1009,1665,7210
4326,2017-3-13,Boston Celtics,67,16155,2579,5698,0.453,815,2229,0.366,1764,3469,0.509,1228,1512,0.812,606,2182,2788,1660,511,840,1373,7201
4327,2017-3-13,Toronto Raptors,66,15915,2581,5591,0.462,584,1608,0.363,1997,3983,0.501,1334,1666,0.801,705,2120,2825,1200,554,754,1386,7080
4328,2017-3-13,San Antonio Spurs,65,15700,2569,5435,0.473,588,1492,0.394,1981,3943,0.502,1197,1487,0.805,636,2225,2861,1548,526,835,1192,6923
4329,2017-3-13,Oklahoma City Thunder,66,15940,2590,5745,0.451,554,1707,0.325,2036,4038,0.504,1285,1719,0.748,784,2267,3051,1367,506,966,1376,7019
4330,2017-3-13,Brooklyn Nets,65,15675,2464,5536,0.445,719,2091,0.344,1745,3445,0.507,1228,1562,0.786,568,2265,2833,1384,462,1064,1390,6875
4331,2017-3-13,New York Knicks,67,16255,2666,5966,0.447,607,1691,0.359,2059,4275,0.482,1130,1442,0.784,812,2256,3068,1455,477,898,1383,7069
4332,2017-3-13,Charlotte Hornets,66,15990,2491,5659,0.44,672,1892,0.355,1819,3767,0.483,1292,1586,0.815,591,2366,2957,1536,440,760,1119,6946
4333,2017-3-13,Milwaukee Bucks,65,15675,2554,5352,0.477,555,1498,0.37,1999,3854,0.519,1167,1518,0.769,589,2061,2650,1592,540,871,1326,6830
4334,2017-3-13,Minnesota Timberwolves,65,15700,2546,5477,0.465,490,1404,0.349,2056,4073,0.505,1222,1548,0.789,755,2053,2808,1523,508,884,1313,6804
4335,2017-3-13,Indiana Pacers,66,15965,2578,5553,0.464,554,1494,0.371,2024,4059,0.499,1203,1485,0.81,568,2185,2753,1487,540,889,1299,6913
4336,2017-3-13,Los Angeles Lakers,66,15840,2566,5754,0.446,611,1750,0.349,1955,4004,0.488,1152,1514,0.761,751,2137,2888,1371,531,965,1374,6895
4337,2017-3-13,Atlanta Hawks,66,16015,2544,5569,0.457,588,1707,0.344,1956,3862,0.506,1185,1637,0.724,663,2254,2917,1556,553,993,1194,6861
4338,2017-3-13,New Orleans Pelicans,66,16065,2533,5710,0.444,616,1755,0.351,1917,3955,0.485,1109,1482,0.748,571,2331,2902,1479,509,842,1229,6791
4339,2017-3-13,Sacramento Kings,66,16040,2480,5430,0.457,602,1628,0.37,1878,3802,0.494,1220,1567,0.779,593,2109,2702,1484,524,928,1365,6782
4340,2017-3-13,Detroit Pistons,66,15940,2651,5823,0.455,513,1538,0.334,2138,4285,0.499,935,1293,0.723,702,2268,2970,1407,480,750,1181,6750
4341,2017-3-13,Miami Heat,67,16155,2600,5745,0.453,657,1799,0.365,1943,3946,0.492,997,1426,0.699,705,2240,2945,1428,472,836,1375,6854
4342,2017-3-13,Philadelphia 76ers,66,15965,2474,5602,0.442,670,1930,0.347,1804,3672,0.491,1118,1464,0.764,634,2181,2815,1556,550,1064,1437,6736
4343,2017-3-13,Chicago Bulls,66,15915,2517,5727,0.439,451,1399,0.322,2066,4328,0.477,1234,1548,0.797,823,2221,3044,1431,514,863,1161,6719
4344,2017-3-13,Memphis Grizzlies,66,16040,2406,5546,0.434,602,1721,0.35,1804,3825,0.472,1266,1618,0.782,722,2121,2843,1386,545,823,1538,6680
4345,2017-3-13,Utah Jazz,66,15915,2419,5212,0.464,628,1719,0.365,1791,3493,0.513,1173,1550,0.757,605,2237,2842,1293,453,870,1266,6639
4346,2017-3-13,Orlando Magic,67,16155,2541,5767,0.441,557,1721,0.324,1984,4046,0.49,1042,1428,0.73,661,2211,2872,1453,457,853,1282,6681
4347,2017-3-13,Dallas Mavericks,65,15700,2363,5333,0.443,697,1935,0.36,1666,3398,0.49,974,1204,0.809,515,1999,2514,1322,496,734,1249,6397
4348,2017-3-14,Golden State Warriors,66,15940,2840,5774,0.492,782,2065,0.379,2058,3709,0.555,1212,1533,0.791,619,2323,2942,2001,637,951,1277,7674
4349,2017-3-14,Houston Rockets,67,16180,2691,5824,0.462,983,2719,0.362,1708,3105,0.55,1347,1760,0.765,732,2224,2956,1696,560,966,1343,7712
4350,2017-3-14,Denver Nuggets,67,16155,2733,5855,0.467,710,1915,0.371,2023,3940,0.513,1258,1644,0.765,821,2279,3100,1670,470,997,1304,7434
4351,2017-3-14,Cleveland Cavaliers,65,15700,2583,5516,0.468,859,2207,0.389,1724,3309,0.521,1172,1566,0.748,620,2220,2840,1468,438,868,1167,7197
4352,2017-3-14,Washington Wizards,66,16015,2726,5739,0.475,599,1592,0.376,2127,4147,0.513,1148,1458,0.787,676,2165,2841,1571,569,890,1404,7199
4353,2017-3-14,Portland Trail Blazers,65,15850,2589,5622,0.461,668,1807,0.37,1921,3815,0.504,1211,1555,0.779,652,2173,2825,1417,449,873,1422,7057
4354,2017-3-14,Los Angeles Clippers,67,16155,2631,5605,0.469,688,1832,0.376,1943,3773,0.515,1274,1719,0.741,618,2256,2874,1500,516,847,1358,7224
4355,2017-3-14,Phoenix Suns,67,16230,2663,5878,0.453,522,1525,0.342,2141,4353,0.492,1362,1729,0.788,774,2206,2980,1291,544,1009,1665,7210
4356,2017-3-14,Boston Celtics,67,16155,2579,5698,0.453,815,2229,0.366,1764,3469,0.509,1228,1512,0.812,606,2182,2788,1660,511,840,1373,7201
4357,2017-3-14,Toronto Raptors,67,16155,2618,5669,0.462,593,1633,0.363,2025,4036,0.502,1351,1684,0.802,714,2166,2880,1219,561,766,1402,7180
4358,2017-3-14,San Antonio Spurs,66,15940,2608,5516,0.473,604,1526,0.396,2004,3990,0.502,1210,1504,0.805,643,2262,2905,1579,532,856,1214,7030
4359,2017-3-14,Oklahoma City Thunder,66,15940,2590,5745,0.451,554,1707,0.325,2036,4038,0.504,1285,1719,0.748,784,2267,3051,1367,506,966,1376,7019
4360,2017-3-14,Brooklyn Nets,65,15675,2464,5536,0.445,719,2091,0.344,1745,3445,0.507,1228,1562,0.786,568,2265,2833,1384,462,1064,1390,6875
4361,2017-3-14,New York Knicks,67,16255,2666,5966,0.447,607,1691,0.359,2059,4275,0.482,1130,1442,0.784,812,2256,3068,1455,477,898,1383,7069
4362,2017-3-14,Charlotte Hornets,67,16230,2534,5752,0.441,679,1921,0.353,1855,3831,0.484,1308,1605,0.815,602,2399,3001,1561,444,766,1137,7055
4363,2017-3-14,Milwaukee Bucks,66,15915,2585,5419,0.477,569,1524,0.373,2016,3895,0.518,1184,1538,0.77,597,2085,2682,1613,546,887,1347,6923
4364,2017-3-14,Minnesota Timberwolves,66,15940,2591,5563,0.466,500,1425,0.351,2091,4138,0.505,1241,1570,0.79,763,2091,2854,1550,516,899,1337,6923
4365,2017-3-14,Indiana Pacers,66,15965,2578,5553,0.464,554,1494,0.371,2024,4059,0.499,1203,1485,0.81,568,2185,2753,1487,540,889,1299,6913
4366,2017-3-14,Los Angeles Lakers,67,16080,2608,5851,0.446,617,1770,0.349,1991,4081,0.488,1163,1533,0.759,767,2167,2934,1388,541,981,1395,6996
4367,2017-3-14,Atlanta Hawks,67,16255,2581,5650,0.457,594,1729,0.344,1987,3921,0.507,1204,1667,0.722,669,2284,2953,1583,566,1009,1214,6960
4368,2017-3-14,Sacramento Kings,67,16280,2524,5512,0.458,618,1658,0.373,1906,3854,0.495,1236,1588,0.778,595,2148,2743,1508,532,943,1379,6902
4369,2017-3-14,New Orleans Pelicans,66,16065,2533,5710,0.444,616,1755,0.351,1917,3955,0.485,1109,1482,0.748,571,2331,2902,1479,509,842,1229,6791
4370,2017-3-14,Detroit Pistons,66,15940,2651,5823,0.455,513,1538,0.334,2138,4285,0.499,935,1293,0.723,702,2268,2970,1407,480,750,1181,6750
4371,2017-3-14,Miami Heat,67,16155,2600,5745,0.453,657,1799,0.365,1943,3946,0.492,997,1426,0.699,705,2240,2945,1428,472,836,1375,6854
4372,2017-3-14,Philadelphia 76ers,66,15965,2474,5602,0.442,670,1930,0.347,1804,3672,0.491,1118,1464,0.764,634,2181,2815,1556,550,1064,1437,6736
4373,2017-3-14,Chicago Bulls,67,16155,2558,5819,0.44,465,1439,0.323,2093,4380,0.478,1253,1570,0.798,835,2259,3094,1460,520,873,1181,6834
4374,2017-3-14,Memphis Grizzlies,67,16280,2447,5625,0.435,616,1748,0.352,1831,3877,0.472,1283,1641,0.782,733,2147,2880,1416,556,835,1558,6793
4375,2017-3-14,Utah Jazz,67,16155,2460,5290,0.465,642,1740,0.369,1818,3550,0.512,1191,1572,0.758,613,2271,2884,1315,454,877,1288,6753
4376,2017-3-14,Orlando Magic,68,16395,2586,5865,0.441,570,1755,0.325,2016,4110,0.491,1054,1440,0.732,670,2246,2916,1485,467,865,1300,6796
4377,2017-3-14,Dallas Mavericks,66,15940,2394,5418,0.442,704,1960,0.359,1690,3458,0.489,983,1217,0.808,522,2026,2548,1343,500,741,1268,6475
4378,2017-3-15,Golden State Warriors,67,16180,2872,5862,0.49,796,2097,0.38,2076,3765,0.551,1240,1568,0.791,632,2353,2985,2025,649,969,1301,7780
4379,2017-3-15,Houston Rockets,67,16180,2691,5824,0.462,983,2719,0.362,1708,3105,0.55,1347,1760,0.765,732,2224,2956,1696,560,966,1343,7712
4380,2017-3-15,Cleveland Cavaliers,66,15940,2629,5593,0.47,878,2237,0.392,1751,3356,0.522,1189,1589,0.748,623,2258,2881,1497,442,877,1185,7325
4381,2017-3-15,Denver Nuggets,67,16155,2733,5855,0.467,710,1915,0.371,2023,3940,0.513,1258,1644,0.765,821,2279,3100,1670,470,997,1304,7434
4382,2017-3-15,Washington Wizards,66,16015,2726,5739,0.475,599,1592,0.376,2127,4147,0.513,1148,1458,0.787,676,2165,2841,1571,569,890,1404,7199
4383,2017-3-15,Portland Trail Blazers,66,16090,2612,5698,0.458,679,1839,0.369,1933,3859,0.501,1231,1581,0.779,660,2213,2873,1430,452,889,1442,7134
4384,2017-3-15,Los Angeles Clippers,67,16155,2631,5605,0.469,688,1832,0.376,1943,3773,0.515,1274,1719,0.741,618,2256,2874,1500,516,847,1358,7224
4385,2017-3-15,Phoenix Suns,67,16230,2663,5878,0.453,522,1525,0.342,2141,4353,0.492,1362,1729,0.788,774,2206,2980,1291,544,1009,1665,7210
4386,2017-3-15,Boston Celtics,67,16155,2579,5698,0.453,815,2229,0.366,1764,3469,0.509,1228,1512,0.812,606,2182,2788,1660,511,840,1373,7201
4387,2017-3-15,Toronto Raptors,67,16155,2618,5669,0.462,593,1633,0.363,2025,4036,0.502,1351,1684,0.802,714,2166,2880,1219,561,766,1402,7180
4388,2017-3-15,Oklahoma City Thunder,67,16180,2634,5834,0.451,564,1729,0.326,2070,4105,0.504,1309,1753,0.747,797,2298,3095,1397,519,979,1403,7141
4389,2017-3-15,San Antonio Spurs,66,15940,2608,5516,0.473,604,1526,0.396,2004,3990,0.502,1210,1504,0.805,643,2262,2905,1579,532,856,1214,7030
4390,2017-3-15,Brooklyn Nets,66,15915,2497,5607,0.445,731,2115,0.346,1766,3492,0.506,1254,1592,0.788,572,2293,2865,1404,468,1082,1413,6979
4391,2017-3-15,Charlotte Hornets,67,16230,2534,5752,0.441,679,1921,0.353,1855,3831,0.484,1308,1605,0.815,602,2399,3001,1561,444,766,1137,7055
4392,2017-3-15,New York Knicks,68,16495,2701,6049,0.447,616,1719,0.358,2085,4330,0.482,1138,1455,0.782,823,2297,3120,1476,485,912,1398,7156
4393,2017-3-15,Milwaukee Bucks,66,15915,2585,5419,0.477,569,1524,0.373,2016,3895,0.518,1184,1538,0.77,597,2085,2682,1613,546,887,1347,6923
4394,2017-3-15,Minnesota Timberwolves,66,15940,2591,5563,0.466,500,1425,0.351,2091,4138,0.505,1241,1570,0.79,763,2091,2854,1550,516,899,1337,6923
4395,2017-3-15,Los Angeles Lakers,67,16080,2608,5851,0.446,617,1770,0.349,1991,4081,0.488,1163,1533,0.759,767,2167,2934,1388,541,981,1395,6996
4396,2017-3-15,Indiana Pacers,67,16205,2610,5640,0.463,562,1523,0.369,2048,4117,0.497,1212,1500,0.808,582,2224,2806,1503,546,905,1313,6994
4397,2017-3-15,Atlanta Hawks,67,16255,2581,5650,0.457,594,1729,0.344,1987,3921,0.507,1204,1667,0.722,669,2284,2953,1583,566,1009,1214,6960
4398,2017-3-15,Sacramento Kings,67,16280,2524,5512,0.458,618,1658,0.373,1906,3854,0.495,1236,1588,0.778,595,2148,2743,1508,532,943,1379,6902
4399,2017-3-15,New Orleans Pelicans,67,16305,2571,5790,0.444,622,1776,0.35,1949,4014,0.486,1127,1512,0.745,575,2376,2951,1498,519,847,1247,6891
4400,2017-3-15,Miami Heat,67,16155,2600,5745,0.453,657,1799,0.365,1943,3946,0.492,997,1426,0.699,705,2240,2945,1428,472,836,1375,6854
4401,2017-3-15,Detroit Pistons,67,16180,2688,5922,0.454,517,1557,0.332,2171,4365,0.497,953,1312,0.726,718,2297,3015,1427,486,758,1200,6846
4402,2017-3-15,Philadelphia 76ers,67,16205,2513,5691,0.442,678,1957,0.346,1835,3734,0.491,1136,1491,0.762,647,2220,2867,1584,560,1085,1463,6840
4403,2017-3-15,Chicago Bulls,67,16155,2558,5819,0.44,465,1439,0.323,2093,4380,0.478,1253,1570,0.798,835,2259,3094,1460,520,873,1181,6834
4404,2017-3-15,Memphis Grizzlies,67,16280,2447,5625,0.435,616,1748,0.352,1831,3877,0.472,1283,1641,0.782,733,2147,2880,1416,556,835,1558,6793
4405,2017-3-15,Utah Jazz,67,16155,2460,5290,0.465,642,1740,0.369,1818,3550,0.512,1191,1572,0.758,613,2271,2884,1315,454,877,1288,6753
4406,2017-3-15,Orlando Magic,68,16395,2586,5865,0.441,570,1755,0.325,2016,4110,0.491,1054,1440,0.732,670,2246,2916,1485,467,865,1300,6796
4407,2017-3-15,Dallas Mavericks,66,15940,2394,5418,0.442,704,1960,0.359,1690,3458,0.489,983,1217,0.808,522,2026,2548,1343,500,741,1268,6475
4408,2017-3-16,Golden State Warriors,67,16180,2872,5862,0.49,796,2097,0.38,2076,3765,0.551,1240,1568,0.791,632,2353,2985,2025,649,969,1301,7780
4409,2017-3-16,Houston Rockets,68,16420,2741,5915,0.463,1001,2762,0.362,1740,3153,0.552,1368,1792,0.763,745,2261,3006,1733,573,985,1364,7851
4410,2017-3-16,Cleveland Cavaliers,66,15940,2629,5593,0.47,878,2237,0.392,1751,3356,0.522,1189,1589,0.748,623,2258,2881,1497,442,877,1185,7325
4411,2017-3-16,Denver Nuggets,67,16155,2733,5855,0.467,710,1915,0.371,2023,3940,0.513,1258,1644,0.765,821,2279,3100,1670,470,997,1304,7434
4412,2017-3-16,Washington Wizards,67,16255,2766,5821,0.475,611,1622,0.377,2155,4199,0.513,1163,1479,0.786,681,2202,2883,1601,573,902,1427,7306
4413,2017-3-16,Portland Trail Blazers,67,16330,2650,5778,0.459,688,1861,0.37,1962,3917,0.501,1256,1609,0.781,668,2244,2912,1451,462,900,1458,7244
4414,2017-3-16,Los Angeles Clippers,68,16395,2666,5680,0.469,693,1856,0.373,1973,3824,0.516,1295,1748,0.741,624,2292,2916,1523,519,862,1378,7320
4415,2017-3-16,Boston Celtics,68,16395,2622,5777,0.454,828,2262,0.366,1794,3515,0.51,1246,1533,0.813,611,2214,2825,1694,513,850,1389,7318
4416,2017-3-16,Phoenix Suns,68,16470,2706,5985,0.452,528,1550,0.341,2178,4435,0.491,1371,1743,0.787,790,2237,3027,1315,553,1022,1690,7311
4417,2017-3-16,Toronto Raptors,67,16155,2618,5669,0.462,593,1633,0.363,2025,4036,0.502,1351,1684,0.802,714,2166,2880,1219,561,766,1402,7180
4418,2017-3-16,Oklahoma City Thunder,67,16180,2634,5834,0.451,564,1729,0.326,2070,4105,0.504,1309,1753,0.747,797,2298,3095,1397,519,979,1403,7141
4419,2017-3-16,San Antonio Spurs,67,16180,2650,5604,0.473,615,1552,0.396,2035,4052,0.502,1221,1519,0.804,653,2293,2946,1607,539,870,1234,7136
4420,2017-3-16,Brooklyn Nets,66,15915,2497,5607,0.445,731,2115,0.346,1766,3492,0.506,1254,1592,0.788,572,2293,2865,1404,468,1082,1413,6979
4421,2017-3-16,New York Knicks,68,16495,2701,6049,0.447,616,1719,0.358,2085,4330,0.482,1138,1455,0.782,823,2297,3120,1476,485,912,1398,7156
4422,2017-3-16,Charlotte Hornets,68,16470,2566,5832,0.44,682,1944,0.351,1884,3888,0.485,1318,1618,0.815,605,2426,3031,1576,453,776,1150,7132
4423,2017-3-16,Minnesota Timberwolves,67,16180,2631,5654,0.465,508,1452,0.35,2123,4202,0.505,1257,1590,0.791,778,2118,2896,1576,520,907,1358,7027
4424,2017-3-16,Milwaukee Bucks,67,16155,2619,5495,0.477,579,1553,0.373,2040,3942,0.518,1203,1563,0.77,601,2117,2718,1635,554,898,1372,7020
4425,2017-3-16,Los Angeles Lakers,68,16320,2650,5942,0.446,620,1795,0.345,2030,4147,0.49,1176,1551,0.758,776,2196,2972,1404,551,1003,1420,7096
4426,2017-3-16,Indiana Pacers,68,16445,2649,5713,0.464,574,1551,0.37,2075,4162,0.499,1220,1509,0.808,585,2263,2848,1529,554,919,1328,7092
4427,2017-3-16,Atlanta Hawks,67,16255,2581,5650,0.457,594,1729,0.344,1987,3921,0.507,1204,1667,0.722,669,2284,2953,1583,566,1009,1214,6960
4428,2017-3-16,Sacramento Kings,68,16520,2562,5591,0.458,624,1672,0.373,1938,3919,0.495,1261,1622,0.777,603,2188,2791,1530,540,961,1397,7009
4429,2017-3-16,New Orleans Pelicans,68,16545,2613,5878,0.445,631,1798,0.351,1982,4080,0.486,1146,1540,0.744,583,2406,2989,1519,528,860,1260,7003
4430,2017-3-16,Miami Heat,68,16395,2644,5832,0.453,673,1834,0.367,1971,3998,0.493,1013,1445,0.701,717,2273,2990,1451,481,851,1397,6974
4431,2017-3-16,Philadelphia 76ers,67,16205,2513,5691,0.442,678,1957,0.346,1835,3734,0.491,1136,1491,0.762,647,2220,2867,1584,560,1085,1463,6840
4432,2017-3-16,Detroit Pistons,68,16420,2724,6008,0.453,520,1570,0.331,2204,4438,0.497,961,1324,0.726,726,2328,3054,1441,492,765,1218,6929
4433,2017-3-16,Chicago Bulls,68,16395,2592,5910,0.439,476,1467,0.324,2116,4443,0.476,1265,1585,0.798,849,2290,3139,1482,526,878,1200,6925
4434,2017-3-16,Memphis Grizzlies,68,16520,2483,5710,0.435,627,1779,0.352,1856,3931,0.472,1298,1659,0.782,747,2185,2932,1442,558,846,1577,6891
4435,2017-3-16,Utah Jazz,68,16395,2496,5367,0.465,655,1768,0.37,1841,3599,0.512,1203,1588,0.758,619,2308,2927,1343,460,892,1303,6850
4436,2017-3-16,Orlando Magic,68,16395,2586,5865,0.441,570,1755,0.325,2016,4110,0.491,1054,1440,0.732,670,2246,2916,1485,467,865,1300,6796
4437,2017-3-16,Dallas Mavericks,67,16180,2434,5497,0.443,718,1992,0.36,1716,3505,0.49,1001,1242,0.806,527,2061,2588,1367,505,751,1290,6587
4438,2017-3-17,Golden State Warriors,68,16420,2922,5949,0.491,806,2123,0.38,2116,3826,0.553,1252,1591,0.787,639,2393,3032,2061,663,981,1319,7902
4439,2017-3-17,Houston Rockets,68,16420,2741,5915,0.463,1001,2762,0.362,1740,3153,0.552,1368,1792,0.763,745,2261,3006,1733,573,985,1364,7851
4440,2017-3-17,Denver Nuggets,68,16395,2779,5941,0.468,725,1943,0.373,2054,3998,0.514,1280,1670,0.766,832,2316,3148,1701,477,1007,1318,7563
4441,2017-3-17,Cleveland Cavaliers,67,16180,2665,5679,0.469,887,2270,0.391,1778,3409,0.522,1199,1608,0.746,634,2299,2933,1511,448,887,1197,7416
4442,2017-3-17,Washington Wizards,67,16255,2766,5821,0.475,611,1622,0.377,2155,4199,0.513,1163,1479,0.786,681,2202,2883,1601,573,902,1427,7306
4443,2017-3-17,Portland Trail Blazers,67,16330,2650,5778,0.459,688,1861,0.37,1962,3917,0.501,1256,1609,0.781,668,2244,2912,1451,462,900,1458,7244
4444,2017-3-17,Los Angeles Clippers,69,16635,2710,5764,0.47,709,1888,0.376,2001,3876,0.516,1305,1763,0.74,628,2322,2950,1549,524,871,1397,7434
4445,2017-3-17,Boston Celtics,68,16395,2622,5777,0.454,828,2262,0.366,1794,3515,0.51,1246,1533,0.813,611,2214,2825,1694,513,850,1389,7318
4446,2017-3-17,Phoenix Suns,68,16470,2706,5985,0.452,528,1550,0.341,2178,4435,0.491,1371,1743,0.787,790,2237,3027,1315,553,1022,1690,7311
4447,2017-3-17,Toronto Raptors,68,16395,2655,5750,0.462,598,1653,0.362,2057,4097,0.502,1374,1714,0.802,720,2192,2912,1234,571,780,1422,7282
4448,2017-3-17,Oklahoma City Thunder,68,16420,2681,5922,0.453,578,1754,0.33,2103,4168,0.505,1324,1772,0.747,807,2335,3142,1430,529,997,1425,7264
4449,2017-3-17,San Antonio Spurs,67,16180,2650,5604,0.473,615,1552,0.396,2035,4052,0.502,1221,1519,0.804,653,2293,2946,1607,539,870,1234,7136
4450,2017-3-17,Brooklyn Nets,67,16155,2538,5693,0.446,741,2147,0.345,1797,3546,0.507,1283,1627,0.789,585,2331,2916,1423,473,1095,1436,7100
4451,2017-3-17,New York Knicks,69,16735,2742,6137,0.447,619,1737,0.356,2123,4400,0.483,1163,1481,0.785,828,2326,3154,1496,491,919,1424,7266
4452,2017-3-17,Charlotte Hornets,68,16470,2566,5832,0.44,682,1944,0.351,1884,3888,0.485,1318,1618,0.815,605,2426,3031,1576,453,776,1150,7132
4453,2017-3-17,Minnesota Timberwolves,67,16180,2631,5654,0.465,508,1452,0.35,2123,4202,0.505,1257,1590,0.791,778,2118,2896,1576,520,907,1358,7027
4454,2017-3-17,Milwaukee Bucks,67,16155,2619,5495,0.477,579,1553,0.373,2040,3942,0.518,1203,1563,0.77,601,2117,2718,1635,554,898,1372,7020
4455,2017-3-17,Los Angeles Lakers,68,16320,2650,5942,0.446,620,1795,0.345,2030,4147,0.49,1176,1551,0.758,776,2196,2972,1404,551,1003,1420,7096
4456,2017-3-17,Indiana Pacers,68,16445,2649,5713,0.464,574,1551,0.37,2075,4162,0.499,1220,1509,0.808,585,2263,2848,1529,554,919,1328,7092
4457,2017-3-17,Atlanta Hawks,68,16495,2610,5721,0.456,602,1756,0.343,2008,3965,0.506,1229,1701,0.723,677,2314,2991,1602,572,1026,1231,7051
4458,2017-3-17,Sacramento Kings,68,16520,2562,5591,0.458,624,1672,0.373,1938,3919,0.495,1261,1622,0.777,603,2188,2791,1530,540,961,1397,7009
4459,2017-3-17,New Orleans Pelicans,68,16545,2613,5878,0.445,631,1798,0.351,1982,4080,0.486,1146,1540,0.744,583,2406,2989,1519,528,860,1260,7003
4460,2017-3-17,Miami Heat,68,16395,2644,5832,0.453,673,1834,0.367,1971,3998,0.493,1013,1445,0.701,717,2273,2990,1451,481,851,1397,6974
4461,2017-3-17,Philadelphia 76ers,67,16205,2513,5691,0.442,678,1957,0.346,1835,3734,0.491,1136,1491,0.762,647,2220,2867,1584,560,1085,1463,6840
4462,2017-3-17,Detroit Pistons,68,16420,2724,6008,0.453,520,1570,0.331,2204,4438,0.497,961,1324,0.726,726,2328,3054,1441,492,765,1218,6929
4463,2017-3-17,Chicago Bulls,68,16395,2592,5910,0.439,476,1467,0.324,2116,4443,0.476,1265,1585,0.798,849,2290,3139,1482,526,878,1200,6925
4464,2017-3-17,Memphis Grizzlies,69,16760,2522,5802,0.435,637,1807,0.353,1885,3995,0.472,1313,1677,0.783,763,2217,2980,1471,565,857,1602,6994
4465,2017-3-17,Utah Jazz,69,16635,2530,5449,0.464,660,1789,0.369,1870,3660,0.511,1213,1602,0.757,629,2345,2974,1361,466,908,1319,6933
4466,2017-3-17,Orlando Magic,69,16635,2621,5959,0.44,577,1782,0.324,2044,4177,0.489,1069,1461,0.732,686,2279,2965,1500,474,884,1321,6888
4467,2017-3-17,Dallas Mavericks,67,16180,2434,5497,0.443,718,1992,0.36,1716,3505,0.49,1001,1242,0.806,527,2061,2588,1367,505,751,1290,6587
4468,2017-3-18,Golden State Warriors,68,16420,2922,5949,0.491,806,2123,0.38,2116,3826,0.553,1252,1591,0.787,639,2393,3032,2061,663,981,1319,7902
4469,2017-3-18,Houston Rockets,69,16660,2778,6006,0.463,1014,2802,0.362,1764,3204,0.551,1393,1824,0.764,755,2297,3052,1751,579,997,1383,7963
4470,2017-3-18,Denver Nuggets,68,16395,2779,5941,0.468,725,1943,0.373,2054,3998,0.514,1280,1670,0.766,832,2316,3148,1701,477,1007,1318,7563
4471,2017-3-18,Cleveland Cavaliers,67,16180,2665,5679,0.469,887,2270,0.391,1778,3409,0.522,1199,1608,0.746,634,2299,2933,1511,448,887,1197,7416
4472,2017-3-18,Washington Wizards,68,16495,2812,5922,0.475,621,1648,0.377,2191,4274,0.513,1173,1491,0.787,694,2229,2923,1635,578,912,1444,7418
4473,2017-3-18,Portland Trail Blazers,67,16330,2650,5778,0.459,688,1861,0.37,1962,3917,0.501,1256,1609,0.781,668,2244,2912,1451,462,900,1458,7244
4474,2017-3-18,Los Angeles Clippers,69,16635,2710,5764,0.47,709,1888,0.376,2001,3876,0.516,1305,1763,0.74,628,2322,2950,1549,524,871,1397,7434
4475,2017-3-18,Boston Celtics,69,16635,2656,5862,0.453,835,2291,0.364,1821,3571,0.51,1269,1562,0.812,619,2257,2876,1714,520,862,1412,7416
4476,2017-3-18,Phoenix Suns,69,16710,2744,6072,0.452,530,1564,0.339,2214,4508,0.491,1396,1773,0.787,802,2274,3076,1333,562,1038,1712,7414
4477,2017-3-18,Oklahoma City Thunder,68,16420,2681,5922,0.453,578,1754,0.33,2103,4168,0.505,1324,1772,0.747,807,2335,3142,1430,529,997,1425,7264
4478,2017-3-18,Toronto Raptors,69,16635,2685,5828,0.461,607,1680,0.361,2078,4148,0.501,1392,1734,0.803,728,2237,2965,1253,576,792,1443,7369
4479,2017-3-18,San Antonio Spurs,67,16180,2650,5604,0.473,615,1552,0.396,2035,4052,0.502,1221,1519,0.804,653,2293,2946,1607,539,870,1234,7136
4480,2017-3-18,Brooklyn Nets,68,16395,2568,5776,0.445,752,2182,0.345,1816,3594,0.505,1307,1657,0.789,591,2366,2957,1446,480,1105,1461,7195
4481,2017-3-18,New York Knicks,69,16735,2742,6137,0.447,619,1737,0.356,2123,4400,0.483,1163,1481,0.785,828,2326,3154,1496,491,919,1424,7266
4482,2017-3-18,Charlotte Hornets,68,16470,2566,5832,0.44,682,1944,0.351,1884,3888,0.485,1318,1618,0.815,605,2426,3031,1576,453,776,1150,7132
4483,2017-3-18,Minnesota Timberwolves,68,16420,2672,5736,0.466,510,1464,0.348,2162,4272,0.506,1278,1612,0.793,787,2137,2924,1590,526,918,1379,7132
4484,2017-3-18,Milwaukee Bucks,68,16395,2659,5577,0.477,583,1577,0.37,2076,4000,0.519,1226,1593,0.77,611,2150,2761,1657,561,912,1397,7127
4485,2017-3-18,Los Angeles Lakers,69,16560,2688,6026,0.446,631,1824,0.346,2057,4202,0.49,1192,1577,0.756,787,2225,3012,1428,558,1017,1440,7199
4486,2017-3-18,Indiana Pacers,68,16445,2649,5713,0.464,574,1551,0.37,2075,4162,0.499,1220,1509,0.808,585,2263,2848,1529,554,919,1328,7092
4487,2017-3-18,Atlanta Hawks,68,16495,2610,5721,0.456,602,1756,0.343,2008,3965,0.506,1229,1701,0.723,677,2314,2991,1602,572,1026,1231,7051
4488,2017-3-18,New Orleans Pelicans,69,16785,2662,5970,0.446,643,1832,0.351,2019,4138,0.488,1164,1564,0.744,592,2451,3043,1548,536,873,1280,7131
4489,2017-3-18,Sacramento Kings,68,16520,2562,5591,0.458,624,1672,0.373,1938,3919,0.495,1261,1622,0.777,603,2188,2791,1530,540,961,1397,7009
4490,2017-3-18,Miami Heat,69,16635,2694,5917,0.455,681,1860,0.366,2013,4057,0.496,1028,1464,0.702,727,2303,3030,1480,487,866,1413,7097
4491,2017-3-18,Philadelphia 76ers,68,16445,2555,5771,0.443,690,1986,0.347,1865,3785,0.493,1156,1514,0.764,656,2266,2922,1616,568,1101,1484,6956
4492,2017-3-18,Chicago Bulls,69,16635,2636,5998,0.439,483,1494,0.323,2153,4504,0.478,1277,1603,0.797,864,2328,3192,1510,531,896,1219,7032
4493,2017-3-18,Detroit Pistons,69,16660,2753,6091,0.452,523,1590,0.329,2230,4501,0.495,975,1345,0.725,738,2365,3103,1455,497,777,1235,7004
4494,2017-3-18,Memphis Grizzlies,69,16760,2522,5802,0.435,637,1807,0.353,1885,3995,0.472,1313,1677,0.783,763,2217,2980,1471,565,857,1602,6994
4495,2017-3-18,Utah Jazz,69,16635,2530,5449,0.464,660,1789,0.369,1870,3660,0.511,1213,1602,0.757,629,2345,2974,1361,466,908,1319,6933
4496,2017-3-18,Orlando Magic,70,16875,2663,6055,0.44,584,1805,0.324,2079,4250,0.489,1087,1482,0.733,694,2314,3008,1521,484,896,1348,6997
4497,2017-3-18,Dallas Mavericks,68,16420,2464,5584,0.441,723,2015,0.359,1741,3569,0.488,1010,1259,0.802,532,2090,2622,1388,511,763,1310,6661
4498,2017-3-19,Golden State Warriors,69,16660,2967,6024,0.493,818,2146,0.381,2149,3878,0.554,1267,1610,0.787,645,2431,3076,2091,668,993,1335,8019
4499,2017-3-19,Houston Rockets,70,16900,2816,6089,0.462,1019,2826,0.361,1797,3263,0.551,1421,1859,0.764,765,2335,3100,1771,584,1011,1407,8072
4500,2017-3-19,Denver Nuggets,69,16635,2817,6030,0.467,735,1974,0.372,2082,4056,0.513,1299,1700,0.764,845,2348,3193,1729,486,1020,1342,7668
4501,2017-3-19,Cleveland Cavaliers,68,16420,2697,5762,0.468,892,2297,0.388,1805,3465,0.521,1208,1621,0.745,638,2335,2973,1526,453,899,1221,7494
4502,2017-3-19,Washington Wizards,69,16735,2841,6001,0.473,632,1681,0.376,2209,4320,0.511,1197,1522,0.786,702,2265,2967,1656,584,924,1465,7511
4503,2017-3-19,Portland Trail Blazers,68,16570,2694,5865,0.459,696,1879,0.37,1998,3986,0.501,1273,1628,0.782,681,2285,2966,1474,471,920,1480,7357
4504,2017-3-19,Los Angeles Clippers,70,16875,2750,5842,0.471,717,1914,0.375,2033,3928,0.518,1325,1792,0.739,635,2369,3004,1576,528,885,1412,7542
4505,2017-3-19,Boston Celtics,69,16635,2656,5862,0.453,835,2291,0.364,1821,3571,0.51,1269,1562,0.812,619,2257,2876,1714,520,862,1412,7416
4506,2017-3-19,Phoenix Suns,69,16710,2744,6072,0.452,530,1564,0.339,2214,4508,0.491,1396,1773,0.787,802,2274,3076,1333,562,1038,1712,7414
4507,2017-3-19,Oklahoma City Thunder,69,16660,2722,6004,0.453,588,1780,0.33,2134,4224,0.505,1342,1797,0.747,820,2371,3191,1453,536,1011,1446,7374
4508,2017-3-19,Toronto Raptors,69,16635,2685,5828,0.461,607,1680,0.361,2078,4148,0.501,1392,1734,0.803,728,2237,2965,1253,576,792,1443,7369
4509,2017-3-19,San Antonio Spurs,68,16420,2683,5679,0.472,624,1580,0.395,2059,4099,0.502,1242,1541,0.806,662,2326,2988,1625,541,885,1259,7232
4510,2017-3-19,Brooklyn Nets,68,16395,2568,5776,0.445,752,2182,0.345,1816,3594,0.505,1307,1657,0.789,591,2366,2957,1446,480,1105,1461,7195
4511,2017-3-19,New York Knicks,69,16735,2742,6137,0.447,619,1737,0.356,2123,4400,0.483,1163,1481,0.785,828,2326,3154,1496,491,919,1424,7266
4512,2017-3-19,Minnesota Timberwolves,68,16420,2672,5736,0.466,510,1464,0.348,2162,4272,0.506,1278,1612,0.793,787,2137,2924,1590,526,918,1379,7132
4513,2017-3-19,Charlotte Hornets,69,16710,2601,5914,0.44,691,1968,0.351,1910,3946,0.484,1337,1645,0.813,611,2461,3072,1599,461,783,1170,7230
4514,2017-3-19,Milwaukee Bucks,69,16635,2695,5666,0.476,592,1604,0.369,2103,4062,0.518,1237,1607,0.77,623,2173,2796,1676,569,923,1414,7219
4515,2017-3-19,Los Angeles Lakers,69,16560,2688,6026,0.446,631,1824,0.346,2057,4202,0.49,1192,1577,0.756,787,2225,3012,1428,558,1017,1440,7199
4516,2017-3-19,Indiana Pacers,68,16445,2649,5713,0.464,574,1551,0.37,2075,4162,0.499,1220,1509,0.808,585,2263,2848,1529,554,919,1328,7092
4517,2017-3-19,Atlanta Hawks,69,16735,2642,5809,0.455,609,1782,0.342,2033,4027,0.505,1255,1733,0.724,689,2337,3026,1624,585,1039,1243,7148
4518,2017-3-19,New Orleans Pelicans,69,16785,2662,5970,0.446,643,1832,0.351,2019,4138,0.488,1164,1564,0.744,592,2451,3043,1548,536,873,1280,7131
4519,2017-3-19,Miami Heat,69,16635,2694,5917,0.455,681,1860,0.366,2013,4057,0.496,1028,1464,0.702,727,2303,3030,1480,487,866,1413,7097
4520,2017-3-19,Sacramento Kings,69,16760,2597,5676,0.458,629,1693,0.372,1968,3983,0.494,1280,1645,0.778,612,2214,2826,1546,549,973,1419,7103
4521,2017-3-19,Philadelphia 76ers,68,16445,2555,5771,0.443,690,1986,0.347,1865,3785,0.493,1156,1514,0.764,656,2266,2922,1616,568,1101,1484,6956
4522,2017-3-19,Chicago Bulls,70,16875,2674,6078,0.44,490,1513,0.324,2184,4565,0.478,1289,1617,0.797,871,2360,3231,1534,538,906,1237,7127
4523,2017-3-19,Detroit Pistons,69,16660,2753,6091,0.452,523,1590,0.329,2230,4501,0.495,975,1345,0.725,738,2365,3103,1455,497,777,1235,7004
4524,2017-3-19,Memphis Grizzlies,70,17000,2554,5878,0.435,650,1837,0.354,1904,4041,0.471,1340,1708,0.785,770,2245,3015,1491,572,867,1620,7098
4525,2017-3-19,Utah Jazz,70,16875,2561,5530,0.463,667,1814,0.368,1894,3716,0.51,1230,1627,0.756,646,2377,3023,1376,472,922,1331,7019
4526,2017-3-19,Orlando Magic,70,16875,2663,6055,0.44,584,1805,0.324,2079,4250,0.489,1087,1482,0.733,694,2314,3008,1521,484,896,1348,6997
4527,2017-3-19,Dallas Mavericks,68,16420,2464,5584,0.441,723,2015,0.359,1741,3569,0.488,1010,1259,0.802,532,2090,2622,1388,511,763,1310,6661
4528,2017-3-20,Golden State Warriors,69,16660,2967,6024,0.493,818,2146,0.381,2149,3878,0.554,1267,1610,0.787,645,2431,3076,2091,668,993,1335,8019
4529,2017-3-20,Houston Rockets,70,16900,2816,6089,0.462,1019,2826,0.361,1797,3263,0.551,1421,1859,0.764,765,2335,3100,1771,584,1011,1407,8072
4530,2017-3-20,Denver Nuggets,69,16635,2817,6030,0.467,735,1974,0.372,2082,4056,0.513,1299,1700,0.764,845,2348,3193,1729,486,1020,1342,7668
4531,2017-3-20,Cleveland Cavaliers,69,16660,2742,5847,0.469,905,2333,0.388,1837,3514,0.523,1230,1648,0.746,648,2369,3017,1545,457,909,1237,7619
4532,2017-3-20,Washington Wizards,69,16735,2841,6001,0.473,632,1681,0.376,2209,4320,0.511,1197,1522,0.786,702,2265,2967,1656,584,924,1465,7511
4533,2017-3-20,Portland Trail Blazers,69,16810,2736,5948,0.46,709,1905,0.372,2027,4043,0.501,1291,1652,0.781,694,2315,3009,1487,475,931,1500,7472
4534,2017-3-20,Los Angeles Clippers,70,16875,2750,5842,0.471,717,1914,0.375,2033,3928,0.518,1325,1792,0.739,635,2369,3004,1576,528,885,1412,7542
4535,2017-3-20,Boston Celtics,70,16875,2690,5946,0.452,841,2320,0.363,1849,3626,0.51,1294,1591,0.813,627,2290,2917,1741,528,879,1427,7515
4536,2017-3-20,Phoenix Suns,70,16950,2779,6171,0.45,536,1586,0.338,2243,4585,0.489,1415,1803,0.785,813,2310,3123,1349,572,1042,1733,7509
4537,2017-3-20,Oklahoma City Thunder,69,16660,2722,6004,0.453,588,1780,0.33,2134,4224,0.505,1342,1797,0.747,820,2371,3191,1453,536,1011,1446,7374
4538,2017-3-20,Toronto Raptors,70,16875,2730,5919,0.461,619,1707,0.363,2111,4212,0.501,1406,1750,0.803,742,2274,3016,1278,583,808,1463,7485
4539,2017-3-20,San Antonio Spurs,69,16660,2726,5766,0.473,635,1608,0.395,2091,4158,0.503,1263,1568,0.805,677,2356,3033,1656,550,891,1279,7350
4540,2017-3-20,Brooklyn Nets,69,16635,2599,5848,0.444,765,2213,0.346,1834,3635,0.505,1336,1695,0.788,600,2398,2998,1462,482,1120,1483,7299
4541,2017-3-20,New York Knicks,69,16735,2742,6137,0.447,619,1737,0.356,2123,4400,0.483,1163,1481,0.785,828,2326,3154,1496,491,919,1424,7266
4542,2017-3-20,Minnesota Timberwolves,69,16660,2716,5822,0.467,519,1489,0.349,2197,4333,0.507,1290,1629,0.792,795,2164,2959,1620,537,933,1393,7241
4543,2017-3-20,Charlotte Hornets,69,16710,2601,5914,0.44,691,1968,0.351,1910,3946,0.484,1337,1645,0.813,611,2461,3072,1599,461,783,1170,7230
4544,2017-3-20,Milwaukee Bucks,69,16635,2695,5666,0.476,592,1604,0.369,2103,4062,0.518,1237,1607,0.77,623,2173,2796,1676,569,923,1414,7219
4545,2017-3-20,Los Angeles Lakers,70,16800,2735,6117,0.447,642,1851,0.347,2093,4266,0.491,1207,1596,0.756,797,2255,3052,1451,563,1022,1465,7319
4546,2017-3-20,Indiana Pacers,69,16685,2682,5793,0.463,580,1574,0.368,2102,4219,0.498,1239,1535,0.807,594,2287,2881,1551,561,932,1351,7183
4547,2017-3-20,Atlanta Hawks,69,16735,2642,5809,0.455,609,1782,0.342,2033,4027,0.505,1255,1733,0.724,689,2337,3026,1624,585,1039,1243,7148
4548,2017-3-20,New Orleans Pelicans,70,17025,2711,6060,0.447,657,1862,0.353,2054,4198,0.489,1175,1579,0.744,601,2485,3086,1579,543,889,1295,7254
4549,2017-3-20,Miami Heat,70,16875,2735,6005,0.455,690,1890,0.365,2045,4115,0.497,1041,1484,0.701,740,2329,3069,1498,495,875,1435,7201
4550,2017-3-20,Sacramento Kings,70,17000,2638,5759,0.458,636,1703,0.373,2002,4056,0.494,1293,1662,0.778,621,2245,2866,1575,553,984,1439,7205
4551,2017-3-20,Philadelphia 76ers,69,16685,2596,5859,0.443,702,2019,0.348,1894,3840,0.493,1167,1529,0.763,664,2301,2965,1645,577,1116,1507,7061
4552,2017-3-20,Chicago Bulls,70,16875,2674,6078,0.44,490,1513,0.324,2184,4565,0.478,1289,1617,0.797,871,2360,3231,1534,538,906,1237,7127
4553,2017-3-20,Detroit Pistons,70,16900,2793,6183,0.452,535,1615,0.331,2258,4568,0.494,995,1375,0.724,750,2416,3166,1481,499,789,1256,7116
4554,2017-3-20,Memphis Grizzlies,70,17000,2554,5878,0.435,650,1837,0.354,1904,4041,0.471,1340,1708,0.785,770,2245,3015,1491,572,867,1620,7098
4555,2017-3-20,Utah Jazz,70,16875,2561,5530,0.463,667,1814,0.368,1894,3716,0.51,1230,1627,0.756,646,2377,3023,1376,472,922,1331,7019
4556,2017-3-20,Orlando Magic,70,16875,2663,6055,0.44,584,1805,0.324,2079,4250,0.489,1087,1482,0.733,694,2314,3008,1521,484,896,1348,6997
4557,2017-3-20,Dallas Mavericks,69,16660,2505,5660,0.443,733,2040,0.359,1772,3620,0.49,1029,1284,0.801,534,2121,2655,1408,519,773,1334,6772
4558,2017-3-21,Golden State Warriors,70,16900,3007,6107,0.492,833,2179,0.382,2174,3928,0.553,1283,1631,0.787,654,2468,3122,2119,676,1009,1357,8130
4559,2017-3-21,Houston Rockets,71,17140,2861,6178,0.463,1036,2864,0.362,1825,3314,0.551,1439,1882,0.765,771,2364,3135,1798,596,1023,1429,8197
4560,2017-3-21,Denver Nuggets,70,16875,2861,6116,0.468,747,2003,0.373,2114,4113,0.514,1323,1726,0.767,853,2388,3241,1755,493,1039,1360,7792
4561,2017-3-21,Cleveland Cavaliers,69,16660,2742,5847,0.469,905,2333,0.388,1837,3514,0.523,1230,1648,0.746,648,2369,3017,1545,457,909,1237,7619
4562,2017-3-21,Washington Wizards,70,16975,2878,6087,0.473,640,1716,0.373,2238,4371,0.512,1217,1548,0.786,710,2296,3006,1680,590,942,1493,7613
4563,2017-3-21,Portland Trail Blazers,69,16810,2736,5948,0.46,709,1905,0.372,2027,4043,0.501,1291,1652,0.781,694,2315,3009,1487,475,931,1500,7472
4564,2017-3-21,Los Angeles Clippers,71,17115,2793,5929,0.471,727,1945,0.374,2066,3984,0.519,1343,1816,0.74,644,2403,3047,1601,536,894,1431,7656
4565,2017-3-21,Boston Celtics,71,17115,2730,6039,0.452,851,2353,0.362,1879,3686,0.51,1314,1619,0.812,646,2324,2970,1760,538,892,1451,7625
4566,2017-3-21,Phoenix Suns,70,16950,2779,6171,0.45,536,1586,0.338,2243,4585,0.489,1415,1803,0.785,813,2310,3123,1349,572,1042,1733,7509
4567,2017-3-21,Toronto Raptors,70,16875,2730,5919,0.461,619,1707,0.363,2111,4212,0.501,1406,1750,0.803,742,2274,3016,1278,583,808,1463,7485
4568,2017-3-21,Oklahoma City Thunder,70,16900,2759,6091,0.453,592,1801,0.329,2167,4290,0.505,1359,1828,0.743,832,2399,3231,1471,546,1022,1465,7469
4569,2017-3-21,San Antonio Spurs,69,16660,2726,5766,0.473,635,1608,0.395,2091,4158,0.503,1263,1568,0.805,677,2356,3033,1656,550,891,1279,7350
4570,2017-3-21,Brooklyn Nets,69,16635,2599,5848,0.444,765,2213,0.346,1834,3635,0.505,1336,1695,0.788,600,2398,2998,1462,482,1120,1483,7299
4571,2017-3-21,New York Knicks,70,16975,2782,6226,0.447,625,1761,0.355,2157,4465,0.483,1182,1505,0.785,842,2360,3202,1520,497,931,1443,7371
4572,2017-3-21,Minnesota Timberwolves,69,16660,2716,5822,0.467,519,1489,0.349,2197,4333,0.507,1290,1629,0.792,795,2164,2959,1620,537,933,1393,7241
4573,2017-3-21,Charlotte Hornets,70,16950,2641,5994,0.441,703,1998,0.352,1938,3996,0.485,1350,1665,0.811,616,2489,3105,1627,473,790,1183,7335
4574,2017-3-21,Milwaukee Bucks,69,16635,2695,5666,0.476,592,1604,0.369,2103,4062,0.518,1237,1607,0.77,623,2173,2796,1676,569,923,1414,7219
4575,2017-3-21,Los Angeles Lakers,70,16800,2735,6117,0.447,642,1851,0.347,2093,4266,0.491,1207,1596,0.756,797,2255,3052,1451,563,1022,1465,7319
4576,2017-3-21,Indiana Pacers,70,16925,2720,5880,0.463,590,1594,0.37,2130,4286,0.497,1260,1558,0.809,604,2320,2924,1572,570,939,1370,7290
4577,2017-3-21,New Orleans Pelicans,70,17025,2711,6060,0.447,657,1862,0.353,2054,4198,0.489,1175,1579,0.744,601,2485,3086,1579,543,889,1295,7254
4578,2017-3-21,Atlanta Hawks,70,16975,2679,5893,0.455,621,1819,0.341,2058,4074,0.505,1259,1743,0.722,701,2370,3071,1650,588,1054,1260,7238
4579,2017-3-21,Miami Heat,70,16875,2735,6005,0.455,690,1890,0.365,2045,4115,0.497,1041,1484,0.701,740,2329,3069,1498,495,875,1435,7201
4580,2017-3-21,Sacramento Kings,70,17000,2638,5759,0.458,636,1703,0.373,2002,4056,0.494,1293,1662,0.778,621,2245,2866,1575,553,984,1439,7205
4581,2017-3-21,Philadelphia 76ers,70,16950,2635,5961,0.442,711,2053,0.346,1924,3908,0.492,1189,1553,0.766,677,2341,3018,1671,592,1132,1541,7170
4582,2017-3-21,Chicago Bulls,70,16875,2674,6078,0.44,490,1513,0.324,2184,4565,0.478,1289,1617,0.797,871,2360,3231,1534,538,906,1237,7127
4583,2017-3-21,Detroit Pistons,70,16900,2793,6183,0.452,535,1615,0.331,2258,4568,0.494,995,1375,0.724,750,2416,3166,1481,499,789,1256,7116
4584,2017-3-21,Memphis Grizzlies,70,17000,2554,5878,0.435,650,1837,0.354,1904,4041,0.471,1340,1708,0.785,770,2245,3015,1491,572,867,1620,7098
4585,2017-3-21,Utah Jazz,71,17115,2601,5618,0.463,673,1839,0.366,1928,3779,0.51,1244,1647,0.755,659,2413,3072,1396,477,932,1348,7119
4586,2017-3-21,Orlando Magic,71,17140,2698,6149,0.439,588,1828,0.322,2110,4321,0.488,1125,1528,0.736,708,2355,3063,1540,494,914,1370,7109
4587,2017-3-21,Dallas Mavericks,69,16660,2505,5660,0.443,733,2040,0.359,1772,3620,0.49,1029,1284,0.801,534,2121,2655,1408,519,773,1334,6772
4588,2017-3-22,Golden State Warriors,71,17140,3050,6185,0.493,846,2209,0.383,2204,3976,0.554,1296,1647,0.787,658,2510,3168,2153,686,1025,1377,8242
4589,2017-3-22,Houston Rockets,71,17140,2861,6178,0.463,1036,2864,0.362,1825,3314,0.551,1439,1882,0.765,771,2364,3135,1798,596,1023,1429,8197
4590,2017-3-22,Denver Nuggets,70,16875,2861,6116,0.468,747,2003,0.373,2114,4113,0.514,1323,1726,0.767,853,2388,3241,1755,493,1039,1360,7792
4591,2017-3-22,Cleveland Cavaliers,69,16660,2742,5847,0.469,905,2333,0.388,1837,3514,0.523,1230,1648,0.746,648,2369,3017,1545,457,909,1237,7619
4592,2017-3-22,Washington Wizards,70,16975,2878,6087,0.473,640,1716,0.373,2238,4371,0.512,1217,1548,0.786,710,2296,3006,1680,590,942,1493,7613
4593,2017-3-22,Los Angeles Clippers,72,17355,2838,6013,0.472,742,1978,0.375,2096,4035,0.519,1371,1848,0.742,657,2438,3095,1624,540,909,1452,7789
4594,2017-3-22,Portland Trail Blazers,70,17050,2771,6031,0.459,713,1926,0.37,2058,4105,0.501,1307,1678,0.779,707,2351,3058,1502,483,945,1514,7562
4595,2017-3-22,Boston Celtics,71,17115,2730,6039,0.452,851,2353,0.362,1879,3686,0.51,1314,1619,0.812,646,2324,2970,1760,538,892,1451,7625
4596,2017-3-22,Phoenix Suns,71,17190,2815,6253,0.45,540,1602,0.337,2275,4651,0.489,1436,1832,0.784,823,2341,3164,1363,577,1066,1756,7606
4597,2017-3-22,Toronto Raptors,71,17140,2777,6014,0.462,627,1730,0.362,2150,4284,0.502,1426,1777,0.802,758,2308,3066,1296,589,824,1486,7607
4598,2017-3-22,Oklahoma City Thunder,70,16900,2759,6091,0.453,592,1801,0.329,2167,4290,0.505,1359,1828,0.743,832,2399,3231,1471,546,1022,1465,7469
4599,2017-3-22,San Antonio Spurs,70,16900,2763,5843,0.473,643,1632,0.394,2120,4211,0.503,1281,1590,0.806,686,2380,3066,1678,562,906,1298,7450
4600,2017-3-22,Brooklyn Nets,70,16875,2637,5936,0.444,775,2242,0.346,1862,3694,0.504,1348,1714,0.786,611,2433,3044,1484,483,1130,1496,7397
4601,2017-3-22,New York Knicks,70,16975,2782,6226,0.447,625,1761,0.355,2157,4465,0.483,1182,1505,0.785,842,2360,3202,1520,497,931,1443,7371
4602,2017-3-22,Charlotte Hornets,70,16950,2641,5994,0.441,703,1998,0.352,1938,3996,0.485,1350,1665,0.811,616,2489,3105,1627,473,790,1183,7335
4603,2017-3-22,Minnesota Timberwolves,70,16900,2748,5894,0.466,526,1504,0.35,2222,4390,0.506,1312,1654,0.793,807,2191,2998,1640,547,956,1417,7334
4604,2017-3-22,Los Angeles Lakers,71,17040,2778,6209,0.447,648,1871,0.346,2130,4338,0.491,1224,1623,0.754,811,2282,3093,1474,571,1030,1487,7428
4605,2017-3-22,Milwaukee Bucks,70,16875,2733,5756,0.475,599,1620,0.37,2134,4136,0.516,1247,1619,0.77,636,2209,2845,1692,577,936,1436,7312
4606,2017-3-22,Indiana Pacers,70,16925,2720,5880,0.463,590,1594,0.37,2130,4286,0.497,1260,1558,0.809,604,2320,2924,1572,570,939,1370,7290
4607,2017-3-22,New Orleans Pelicans,71,17265,2746,6148,0.447,666,1891,0.352,2080,4257,0.489,1191,1598,0.745,613,2524,3137,1595,551,901,1312,7349
4608,2017-3-22,Atlanta Hawks,70,16975,2679,5893,0.455,621,1819,0.341,2058,4074,0.505,1259,1743,0.722,701,2370,3071,1650,588,1054,1260,7238
4609,2017-3-22,Miami Heat,71,17115,2777,6101,0.455,701,1917,0.366,2076,4184,0.496,1058,1507,0.702,757,2361,3118,1515,508,889,1460,7313
4610,2017-3-22,Sacramento Kings,70,17000,2638,5759,0.458,636,1703,0.373,2002,4056,0.494,1293,1662,0.778,621,2245,2866,1575,553,984,1439,7205
4611,2017-3-22,Philadelphia 76ers,70,16950,2635,5961,0.442,711,2053,0.346,1924,3908,0.492,1189,1553,0.766,677,2341,3018,1671,592,1132,1541,7170
4612,2017-3-22,Chicago Bulls,71,17140,2716,6168,0.44,504,1550,0.325,2212,4618,0.479,1311,1644,0.797,880,2390,3270,1559,547,920,1261,7247
4613,2017-3-22,Detroit Pistons,71,17140,2833,6275,0.451,540,1638,0.33,2293,4637,0.495,1006,1391,0.723,760,2457,3217,1498,507,795,1273,7212
4614,2017-3-22,Memphis Grizzlies,71,17240,2586,5957,0.434,659,1872,0.352,1927,4085,0.472,1349,1721,0.784,774,2282,3056,1508,579,882,1640,7180
4615,2017-3-22,Utah Jazz,71,17115,2601,5618,0.463,673,1839,0.366,1928,3779,0.51,1244,1647,0.755,659,2413,3072,1396,477,932,1348,7119
4616,2017-3-22,Orlando Magic,71,17140,2698,6149,0.439,588,1828,0.322,2110,4321,0.488,1125,1528,0.736,708,2355,3063,1540,494,914,1370,7109
4617,2017-3-22,Dallas Mavericks,70,16900,2538,5752,0.441,744,2074,0.359,1794,3678,0.488,1039,1296,0.802,547,2147,2694,1432,527,784,1348,6859
4618,2017-3-23,Golden State Warriors,71,17140,3050,6185,0.493,846,2209,0.383,2204,3976,0.554,1296,1647,0.787,658,2510,3168,2153,686,1025,1377,8242
4619,2017-3-23,Houston Rockets,71,17140,2861,6178,0.463,1036,2864,0.362,1825,3314,0.551,1439,1882,0.765,771,2364,3135,1798,596,1023,1429,8197
4620,2017-3-23,Denver Nuggets,71,17115,2912,6212,0.469,758,2029,0.374,2154,4183,0.515,1336,1739,0.768,863,2422,3285,1790,500,1045,1376,7918
4621,2017-3-23,Cleveland Cavaliers,70,16900,2785,5932,0.469,920,2370,0.388,1865,3562,0.524,1242,1662,0.747,655,2400,3055,1567,461,919,1249,7732
4622,2017-3-23,Washington Wizards,71,17215,2916,6182,0.472,651,1750,0.372,2265,4432,0.511,1234,1571,0.785,727,2333,3060,1703,599,961,1519,7717
4623,2017-3-23,Los Angeles Clippers,72,17355,2838,6013,0.472,742,1978,0.375,2096,4035,0.519,1371,1848,0.742,657,2438,3095,1624,540,909,1452,7789
4624,2017-3-23,Portland Trail Blazers,70,17050,2771,6031,0.459,713,1926,0.37,2058,4105,0.501,1307,1678,0.779,707,2351,3058,1502,483,945,1514,7562
4625,2017-3-23,Boston Celtics,72,17355,2773,6123,0.453,862,2380,0.362,1911,3743,0.511,1326,1633,0.812,656,2357,3013,1787,543,908,1468,7734
4626,2017-3-23,Phoenix Suns,71,17190,2815,6253,0.45,540,1602,0.337,2275,4651,0.489,1436,1832,0.784,823,2341,3164,1363,577,1066,1756,7606
4627,2017-3-23,Toronto Raptors,71,17140,2777,6014,0.462,627,1730,0.362,2150,4284,0.502,1426,1777,0.802,758,2308,3066,1296,589,824,1486,7607
4628,2017-3-23,Oklahoma City Thunder,71,17140,2807,6179,0.454,596,1817,0.328,2211,4362,0.507,1381,1858,0.743,850,2435,3285,1497,553,1038,1482,7591
4629,2017-3-23,San Antonio Spurs,70,16900,2763,5843,0.473,643,1632,0.394,2120,4211,0.503,1281,1590,0.806,686,2380,3066,1678,562,906,1298,7450
4630,2017-3-23,Brooklyn Nets,70,16875,2637,5936,0.444,775,2242,0.346,1862,3694,0.504,1348,1714,0.786,611,2433,3044,1484,483,1130,1496,7397
4631,2017-3-23,New York Knicks,71,17215,2820,6306,0.447,634,1782,0.356,2186,4524,0.483,1198,1523,0.787,851,2387,3238,1539,502,942,1469,7472
4632,2017-3-23,Charlotte Hornets,71,17190,2683,6084,0.441,712,2025,0.352,1971,4059,0.486,1366,1683,0.812,628,2520,3148,1651,482,800,1195,7444
4633,2017-3-23,Minnesota Timberwolves,70,16900,2748,5894,0.466,526,1504,0.35,2222,4390,0.506,1312,1654,0.793,807,2191,2998,1640,547,956,1417,7334
4634,2017-3-23,Milwaukee Bucks,71,17115,2776,5837,0.476,615,1655,0.372,2161,4182,0.517,1261,1638,0.77,643,2240,2883,1720,586,946,1447,7428
4635,2017-3-23,Los Angeles Lakers,71,17040,2778,6209,0.447,648,1871,0.346,2130,4338,0.491,1224,1623,0.754,811,2282,3093,1474,571,1030,1487,7428
4636,2017-3-23,Indiana Pacers,71,17165,2758,5967,0.462,601,1622,0.371,2157,4345,0.496,1273,1577,0.807,622,2347,2969,1592,583,952,1389,7390
4637,2017-3-23,New Orleans Pelicans,71,17265,2746,6148,0.447,666,1891,0.352,2080,4257,0.489,1191,1598,0.745,613,2524,3137,1595,551,901,1312,7349
4638,2017-3-23,Atlanta Hawks,71,17215,2713,5979,0.454,629,1844,0.341,2084,4135,0.504,1283,1772,0.724,712,2403,3115,1670,599,1070,1279,7338
4639,2017-3-23,Miami Heat,71,17115,2777,6101,0.455,701,1917,0.366,2076,4184,0.496,1058,1507,0.702,757,2361,3118,1515,508,889,1460,7313
4640,2017-3-23,Sacramento Kings,71,17240,2679,5843,0.458,646,1729,0.374,2033,4114,0.494,1299,1672,0.777,629,2274,2903,1594,559,996,1454,7303
4641,2017-3-23,Philadelphia 76ers,71,17190,2672,6048,0.442,719,2078,0.346,1953,3970,0.492,1204,1570,0.767,683,2360,3043,1690,600,1141,1564,7267
4642,2017-3-23,Chicago Bulls,72,17380,2763,6248,0.442,515,1573,0.327,2248,4675,0.481,1323,1663,0.796,887,2419,3306,1595,559,931,1281,7364
4643,2017-3-23,Detroit Pistons,72,17380,2872,6363,0.451,547,1658,0.33,2325,4705,0.494,1016,1408,0.722,776,2485,3261,1516,513,810,1290,7307
4644,2017-3-23,Memphis Grizzlies,71,17240,2586,5957,0.434,659,1872,0.352,1927,4085,0.472,1349,1721,0.784,774,2282,3056,1508,579,882,1640,7180
4645,2017-3-23,Utah Jazz,72,17355,2642,5708,0.463,680,1867,0.364,1962,3841,0.511,1263,1676,0.754,679,2441,3120,1414,482,940,1359,7227
4646,2017-3-23,Orlando Magic,72,17380,2738,6237,0.439,602,1868,0.322,2136,4369,0.489,1133,1538,0.737,721,2385,3106,1566,499,928,1389,7211
4647,2017-3-23,Dallas Mavericks,70,16900,2538,5752,0.441,744,2074,0.359,1794,3678,0.488,1039,1296,0.802,547,2147,2694,1432,527,784,1348,6859
4648,2017-3-24,Golden State Warriors,71,17140,3050,6185,0.493,846,2209,0.383,2204,3976,0.554,1296,1647,0.787,658,2510,3168,2153,686,1025,1377,8242
4649,2017-3-24,Houston Rockets,71,17140,2861,6178,0.463,1036,2864,0.362,1825,3314,0.551,1439,1882,0.765,771,2364,3135,1798,596,1023,1429,8197
4650,2017-3-24,Denver Nuggets,71,17115,2912,6212,0.469,758,2029,0.374,2154,4183,0.515,1336,1739,0.768,863,2422,3285,1790,500,1045,1376,7918
4651,2017-3-24,Cleveland Cavaliers,70,16900,2785,5932,0.469,920,2370,0.388,1865,3562,0.524,1242,1662,0.747,655,2400,3055,1567,461,919,1249,7732
4652,2017-3-24,Washington Wizards,71,17215,2916,6182,0.472,651,1750,0.372,2265,4432,0.511,1234,1571,0.785,727,2333,3060,1703,599,961,1519,7717
4653,2017-3-24,Portland Trail Blazers,71,17290,2810,6111,0.46,724,1947,0.372,2086,4164,0.501,1328,1707,0.778,717,2391,3108,1517,491,958,1534,7672
4654,2017-3-24,Los Angeles Clippers,73,17595,2874,6093,0.472,751,2005,0.375,2123,4088,0.519,1385,1869,0.741,666,2474,3140,1642,546,926,1468,7884
4655,2017-3-24,Boston Celtics,72,17355,2773,6123,0.453,862,2380,0.362,1911,3743,0.511,1326,1633,0.812,656,2357,3013,1787,543,908,1468,7734
4656,2017-3-24,Toronto Raptors,72,17380,2812,6093,0.462,633,1753,0.361,2179,4340,0.502,1451,1809,0.802,769,2348,3117,1306,598,841,1507,7708
4657,2017-3-24,Phoenix Suns,72,17430,2849,6346,0.449,547,1627,0.336,2302,4719,0.488,1459,1866,0.782,838,2376,3214,1379,591,1085,1786,7704
4658,2017-3-24,Oklahoma City Thunder,71,17140,2807,6179,0.454,596,1817,0.328,2211,4362,0.507,1381,1858,0.743,850,2435,3285,1497,553,1038,1482,7591
4659,2017-3-24,San Antonio Spurs,71,17140,2800,5920,0.473,651,1658,0.393,2149,4262,0.504,1296,1613,0.803,692,2409,3101,1704,568,912,1317,7547
4660,2017-3-24,Brooklyn Nets,71,17115,2680,6031,0.444,783,2271,0.345,1897,3760,0.505,1380,1756,0.786,628,2477,3105,1509,494,1147,1522,7523
4661,2017-3-24,New York Knicks,72,17455,2856,6394,0.447,639,1804,0.354,2217,4590,0.483,1216,1543,0.788,860,2418,3278,1562,507,953,1489,7567
4662,2017-3-24,Charlotte Hornets,71,17190,2683,6084,0.441,712,2025,0.352,1971,4059,0.486,1366,1683,0.812,628,2520,3148,1651,482,800,1195,7444
4663,2017-3-24,Minnesota Timberwolves,70,16900,2748,5894,0.466,526,1504,0.35,2222,4390,0.506,1312,1654,0.793,807,2191,2998,1640,547,956,1417,7334
4664,2017-3-24,Milwaukee Bucks,71,17115,2776,5837,0.476,615,1655,0.372,2161,4182,0.517,1261,1638,0.77,643,2240,2883,1720,586,946,1447,7428
4665,2017-3-24,Los Angeles Lakers,71,17040,2778,6209,0.447,648,1871,0.346,2130,4338,0.491,1224,1623,0.754,811,2282,3093,1474,571,1030,1487,7428
4666,2017-3-24,Indiana Pacers,71,17165,2758,5967,0.462,601,1622,0.371,2157,4345,0.496,1273,1577,0.807,622,2347,2969,1592,583,952,1389,7390
4667,2017-3-24,New Orleans Pelicans,71,17265,2746,6148,0.447,666,1891,0.352,2080,4257,0.489,1191,1598,0.745,613,2524,3137,1595,551,901,1312,7349
4668,2017-3-24,Atlanta Hawks,71,17215,2713,5979,0.454,629,1844,0.341,2084,4135,0.504,1283,1772,0.724,712,2403,3115,1670,599,1070,1279,7338
4669,2017-3-24,Sacramento Kings,71,17240,2679,5843,0.458,646,1729,0.374,2033,4114,0.494,1299,1672,0.777,629,2274,2903,1594,559,996,1454,7303
4670,2017-3-24,Miami Heat,72,17355,2809,6183,0.454,707,1940,0.364,2102,4243,0.495,1072,1530,0.701,767,2387,3154,1535,516,905,1483,7397
4671,2017-3-24,Philadelphia 76ers,71,17190,2672,6048,0.442,719,2078,0.346,1953,3970,0.492,1204,1570,0.767,683,2360,3043,1690,600,1141,1564,7267
4672,2017-3-24,Chicago Bulls,72,17380,2763,6248,0.442,515,1573,0.327,2248,4675,0.481,1323,1663,0.796,887,2419,3306,1595,559,931,1281,7364
4673,2017-3-24,Detroit Pistons,72,17380,2872,6363,0.451,547,1658,0.33,2325,4705,0.494,1016,1408,0.722,776,2485,3261,1516,513,810,1290,7307
4674,2017-3-24,Memphis Grizzlies,72,17480,2620,6035,0.434,669,1901,0.352,1951,4134,0.472,1361,1736,0.784,784,2314,3098,1526,583,895,1658,7270
4675,2017-3-24,Utah Jazz,72,17355,2642,5708,0.463,680,1867,0.364,1962,3841,0.511,1263,1676,0.754,679,2441,3120,1414,482,940,1359,7227
4676,2017-3-24,Orlando Magic,72,17380,2738,6237,0.439,602,1868,0.322,2136,4369,0.489,1133,1538,0.737,721,2385,3106,1566,499,928,1389,7211
4677,2017-3-24,Dallas Mavericks,71,17140,2576,5834,0.442,753,2100,0.359,1823,3734,0.488,1051,1314,0.8,551,2177,2728,1458,538,793,1366,6956
4678,2017-3-25,Golden State Warriors,72,17380,3094,6274,0.493,856,2240,0.382,2238,4034,0.555,1312,1665,0.788,671,2541,3212,2190,700,1037,1392,8356
4679,2017-3-25,Houston Rockets,72,17380,2905,6271,0.463,1050,2903,0.362,1855,3368,0.551,1454,1902,0.764,786,2408,3194,1827,601,1041,1448,8314
4680,2017-3-25,Denver Nuggets,72,17355,2951,6294,0.469,765,2056,0.372,2186,4238,0.516,1376,1782,0.772,874,2456,3330,1813,508,1058,1391,8043
4681,2017-3-25,Cleveland Cavaliers,71,17140,2826,6006,0.471,929,2395,0.388,1897,3611,0.525,1263,1686,0.749,658,2435,3093,1593,467,931,1271,7844
4682,2017-3-25,Washington Wizards,72,17455,2965,6279,0.472,661,1776,0.372,2304,4503,0.512,1255,1593,0.788,738,2368,3106,1732,608,971,1538,7846
4683,2017-3-25,Portland Trail Blazers,71,17290,2810,6111,0.46,724,1947,0.372,2086,4164,0.501,1328,1707,0.778,717,2391,3108,1517,491,958,1534,7672
4684,2017-3-25,Los Angeles Clippers,73,17595,2874,6093,0.472,751,2005,0.375,2123,4088,0.519,1385,1869,0.741,666,2474,3140,1642,546,926,1468,7884
4685,2017-3-25,Boston Celtics,73,17595,2817,6217,0.453,876,2421,0.362,1941,3796,0.511,1354,1668,0.812,668,2395,3063,1818,551,923,1500,7864
4686,2017-3-25,Phoenix Suns,73,17670,2888,6432,0.449,553,1646,0.336,2335,4786,0.488,1495,1915,0.781,848,2415,3263,1402,600,1098,1816,7824
4687,2017-3-25,Toronto Raptors,72,17380,2812,6093,0.462,633,1753,0.361,2179,4340,0.502,1451,1809,0.802,769,2348,3117,1306,598,841,1507,7708
4688,2017-3-25,Oklahoma City Thunder,71,17140,2807,6179,0.454,596,1817,0.328,2211,4362,0.507,1381,1858,0.743,850,2435,3285,1497,553,1038,1482,7591
4689,2017-3-25,San Antonio Spurs,71,17140,2800,5920,0.473,651,1658,0.393,2149,4262,0.504,1296,1613,0.803,692,2409,3101,1704,568,912,1317,7547
4690,2017-3-25,Brooklyn Nets,72,17355,2723,6113,0.445,786,2286,0.344,1937,3827,0.506,1399,1782,0.785,634,2509,3143,1533,499,1161,1544,7631
4691,2017-3-25,New York Knicks,72,17455,2856,6394,0.447,639,1804,0.354,2217,4590,0.483,1216,1543,0.788,860,2418,3278,1562,507,953,1489,7567
4692,2017-3-25,Los Angeles Lakers,72,17305,2824,6297,0.448,662,1894,0.35,2162,4403,0.491,1248,1651,0.756,820,2315,3135,1500,577,1050,1510,7558
4693,2017-3-25,Minnesota Timberwolves,71,17165,2794,5989,0.467,533,1525,0.35,2261,4464,0.506,1332,1676,0.795,819,2216,3035,1672,560,969,1437,7453
4694,2017-3-25,Charlotte Hornets,72,17430,2721,6174,0.441,722,2063,0.35,1999,4111,0.486,1385,1707,0.811,642,2548,3190,1669,488,809,1212,7549
4695,2017-3-25,Milwaukee Bucks,72,17355,2815,5925,0.475,623,1682,0.37,2192,4243,0.517,1275,1654,0.771,652,2266,2918,1747,596,954,1470,7528
4696,2017-3-25,Indiana Pacers,72,17405,2806,6062,0.463,614,1646,0.373,2192,4416,0.496,1281,1588,0.807,633,2375,3008,1611,592,964,1418,7507
4697,2017-3-25,New Orleans Pelicans,72,17505,2787,6239,0.447,680,1929,0.353,2107,4310,0.489,1202,1612,0.746,619,2554,3173,1623,560,911,1327,7456
4698,2017-3-25,Atlanta Hawks,72,17455,2747,6062,0.453,637,1866,0.341,2110,4196,0.503,1304,1796,0.726,725,2439,3164,1690,604,1087,1298,7435
4699,2017-3-25,Sacramento Kings,72,17480,2719,5926,0.459,656,1750,0.375,2063,4176,0.494,1309,1685,0.777,635,2305,2940,1621,566,1015,1470,7403
4700,2017-3-25,Miami Heat,72,17355,2809,6183,0.454,707,1940,0.364,2102,4243,0.495,1072,1530,0.701,767,2387,3154,1535,516,905,1483,7397
4701,2017-3-25,Philadelphia 76ers,72,17430,2718,6131,0.443,727,2103,0.346,1991,4028,0.494,1221,1593,0.766,694,2395,3089,1713,610,1159,1586,7384
4702,2017-3-25,Chicago Bulls,73,17620,2800,6339,0.442,525,1597,0.329,2275,4742,0.48,1346,1694,0.795,902,2443,3345,1617,568,945,1296,7471
4703,2017-3-25,Detroit Pistons,73,17620,2906,6459,0.45,549,1680,0.327,2357,4779,0.493,1033,1428,0.723,788,2523,3311,1537,516,818,1307,7394
4704,2017-3-25,Memphis Grizzlies,72,17480,2620,6035,0.434,669,1901,0.352,1951,4134,0.472,1361,1736,0.784,784,2314,3098,1526,583,895,1658,7270
4705,2017-3-25,Orlando Magic,73,17620,2785,6328,0.44,614,1894,0.324,2171,4434,0.49,1142,1551,0.736,727,2426,3153,1602,503,938,1406,7326
4706,2017-3-25,Utah Jazz,72,17355,2642,5708,0.463,680,1867,0.364,1962,3841,0.511,1263,1676,0.754,679,2441,3120,1414,482,940,1359,7227
4707,2017-3-25,Dallas Mavericks,71,17140,2576,5834,0.442,753,2100,0.359,1823,3734,0.488,1051,1314,0.8,551,2177,2728,1458,538,793,1366,6956
4708,2017-3-26,Golden State Warriors,72,17380,3094,6274,0.493,856,2240,0.382,2238,4034,0.555,1312,1665,0.788,671,2541,3212,2190,700,1037,1392,8356
4709,2017-3-26,Houston Rockets,72,17380,2905,6271,0.463,1050,2903,0.362,1855,3368,0.551,1454,1902,0.764,786,2408,3194,1827,601,1041,1448,8314
4710,2017-3-26,Denver Nuggets,72,17355,2951,6294,0.469,765,2056,0.372,2186,4238,0.516,1376,1782,0.772,874,2456,3330,1813,508,1058,1391,8043
4711,2017-3-26,Cleveland Cavaliers,72,17380,2867,6089,0.471,941,2428,0.388,1926,3661,0.526,1284,1713,0.75,669,2456,3125,1617,473,944,1289,7959
4712,2017-3-26,Washington Wizards,73,17695,3014,6361,0.474,669,1794,0.373,2345,4567,0.513,1276,1619,0.788,749,2397,3146,1756,618,982,1561,7973
4713,2017-3-26,Portland Trail Blazers,72,17530,2855,6182,0.462,735,1969,0.373,2120,4213,0.503,1339,1724,0.777,721,2422,3143,1541,496,972,1554,7784
4714,2017-3-26,Los Angeles Clippers,74,17835,2912,6177,0.471,758,2032,0.373,2154,4145,0.52,1410,1897,0.743,677,2510,3187,1656,555,936,1485,7992
4715,2017-3-26,Boston Celtics,73,17595,2817,6217,0.453,876,2421,0.362,1941,3796,0.511,1354,1668,0.812,668,2395,3063,1818,551,923,1500,7864
4716,2017-3-26,Phoenix Suns,73,17670,2888,6432,0.449,553,1646,0.336,2335,4786,0.488,1495,1915,0.781,848,2415,3263,1402,600,1098,1816,7824
4717,2017-3-26,Oklahoma City Thunder,71,17140,2807,6179,0.454,596,1817,0.328,2211,4362,0.507,1381,1858,0.743,850,2435,3285,1497,553,1038,1482,7591
4718,2017-3-26,Toronto Raptors,73,17620,2851,6174,0.462,642,1774,0.362,2209,4400,0.502,1458,1818,0.802,781,2380,3161,1328,607,855,1528,7802
4719,2017-3-26,San Antonio Spurs,72,17380,2845,6019,0.473,661,1683,0.393,2184,4336,0.504,1302,1621,0.803,708,2443,3151,1732,579,926,1335,7653
4720,2017-3-26,Brooklyn Nets,72,17355,2723,6113,0.445,786,2286,0.344,1937,3827,0.506,1399,1782,0.785,634,2509,3143,1533,499,1161,1544,7631
4721,2017-3-26,Los Angeles Lakers,72,17305,2824,6297,0.448,662,1894,0.35,2162,4403,0.491,1248,1651,0.756,820,2315,3135,1500,577,1050,1510,7558
4722,2017-3-26,New York Knicks,73,17695,2897,6481,0.447,642,1814,0.354,2255,4667,0.483,1229,1558,0.789,872,2451,3323,1586,513,969,1505,7665
4723,2017-3-26,Minnesota Timberwolves,72,17405,2831,6065,0.467,535,1535,0.349,2296,4530,0.507,1356,1708,0.794,825,2237,3062,1687,570,976,1451,7553
4724,2017-3-26,Charlotte Hornets,72,17430,2721,6174,0.441,722,2063,0.35,1999,4111,0.486,1385,1707,0.811,642,2548,3190,1669,488,809,1212,7549
4725,2017-3-26,Milwaukee Bucks,72,17355,2815,5925,0.475,623,1682,0.37,2192,4243,0.517,1275,1654,0.771,652,2266,2918,1747,596,954,1470,7528
4726,2017-3-26,Indiana Pacers,72,17405,2806,6062,0.463,614,1646,0.373,2192,4416,0.496,1281,1588,0.807,633,2375,3008,1611,592,964,1418,7507
4727,2017-3-26,New Orleans Pelicans,72,17505,2787,6239,0.447,680,1929,0.353,2107,4310,0.489,1202,1612,0.746,619,2554,3173,1623,560,911,1327,7456
4728,2017-3-26,Atlanta Hawks,72,17455,2747,6062,0.453,637,1866,0.341,2110,4196,0.503,1304,1796,0.726,725,2439,3164,1690,604,1087,1298,7435
4729,2017-3-26,Sacramento Kings,72,17480,2719,5926,0.459,656,1750,0.375,2063,4176,0.494,1309,1685,0.777,635,2305,2940,1621,566,1015,1470,7403
4730,2017-3-26,Miami Heat,72,17355,2809,6183,0.454,707,1940,0.364,2102,4243,0.495,1072,1530,0.701,767,2387,3154,1535,516,905,1483,7397
4731,2017-3-26,Philadelphia 76ers,72,17430,2718,6131,0.443,727,2103,0.346,1991,4028,0.494,1221,1593,0.766,694,2395,3089,1713,610,1159,1586,7384
4732,2017-3-26,Chicago Bulls,73,17620,2800,6339,0.442,525,1597,0.329,2275,4742,0.48,1346,1694,0.795,902,2443,3345,1617,568,945,1296,7471
4733,2017-3-26,Detroit Pistons,73,17620,2906,6459,0.45,549,1680,0.327,2357,4779,0.493,1033,1428,0.723,788,2523,3311,1537,516,818,1307,7394
4734,2017-3-26,Memphis Grizzlies,72,17480,2620,6035,0.434,669,1901,0.352,1951,4134,0.472,1361,1736,0.784,784,2314,3098,1526,583,895,1658,7270
4735,2017-3-26,Orlando Magic,73,17620,2785,6328,0.44,614,1894,0.324,2171,4434,0.49,1142,1551,0.736,727,2426,3153,1602,503,938,1406,7326
4736,2017-3-26,Utah Jazz,73,17595,2679,5794,0.462,688,1893,0.363,1991,3901,0.51,1276,1694,0.753,691,2472,3163,1436,487,954,1381,7322
4737,2017-3-26,Dallas Mavericks,72,17380,2607,5916,0.441,760,2128,0.357,1847,3788,0.488,1068,1334,0.801,563,2205,2768,1478,548,805,1382,7042
4738,2017-3-27,Golden State Warriors,73,17620,3133,6345,0.494,873,2271,0.384,2260,4074,0.555,1323,1680,0.788,678,2571,3249,2220,709,1055,1407,8462
4739,2017-3-27,Houston Rockets,73,17620,2955,6350,0.465,1070,2942,0.364,1885,3408,0.553,1471,1923,0.765,788,2442,3230,1859,609,1060,1471,8451
4740,2017-3-27,Denver Nuggets,73,17595,2987,6389,0.468,771,2081,0.37,2216,4308,0.514,1388,1796,0.773,881,2497,3378,1834,511,1067,1404,8133
4741,2017-3-27,Cleveland Cavaliers,72,17380,2867,6089,0.471,941,2428,0.388,1926,3661,0.526,1284,1713,0.75,669,2456,3125,1617,473,944,1289,7959
4742,2017-3-27,Washington Wizards,73,17695,3014,6361,0.474,669,1794,0.373,2345,4567,0.513,1276,1619,0.788,749,2397,3146,1756,618,982,1561,7973
4743,2017-3-27,Portland Trail Blazers,73,17770,2891,6271,0.461,747,1997,0.374,2144,4274,0.502,1352,1742,0.776,733,2471,3204,1565,504,985,1570,7881
4744,2017-3-27,Los Angeles Clippers,75,18075,2944,6255,0.471,768,2061,0.373,2176,4194,0.519,1433,1925,0.744,683,2549,3232,1676,562,945,1499,8089
4745,2017-3-27,Boston Celtics,74,17835,2858,6294,0.454,884,2445,0.362,1974,3849,0.513,1376,1693,0.813,676,2422,3098,1850,559,939,1519,7976
4746,2017-3-27,Phoenix Suns,74,17910,2929,6513,0.45,559,1662,0.336,2370,4851,0.489,1513,1937,0.781,856,2446,3302,1427,606,1110,1833,7930
4747,2017-3-27,Oklahoma City Thunder,72,17380,2854,6273,0.455,607,1847,0.329,2247,4426,0.508,1401,1886,0.743,865,2461,3326,1524,568,1054,1503,7716
4748,2017-3-27,Toronto Raptors,73,17620,2851,6174,0.462,642,1774,0.362,2209,4400,0.502,1458,1818,0.802,781,2380,3161,1328,607,855,1528,7802
4749,2017-3-27,San Antonio Spurs,72,17380,2845,6019,0.473,661,1683,0.393,2184,4336,0.504,1302,1621,0.803,708,2443,3151,1732,579,926,1335,7653
4750,2017-3-27,Brooklyn Nets,73,17595,2761,6199,0.445,792,2308,0.343,1969,3891,0.506,1424,1812,0.786,646,2547,3193,1554,512,1178,1569,7738
4751,2017-3-27,Charlotte Hornets,73,17670,2763,6261,0.441,736,2093,0.352,2027,4168,0.486,1407,1731,0.813,650,2581,3231,1698,496,816,1226,7669
4752,2017-3-27,New York Knicks,73,17695,2897,6481,0.447,642,1814,0.354,2255,4667,0.483,1229,1558,0.789,872,2451,3323,1586,513,969,1505,7665
4753,2017-3-27,Minnesota Timberwolves,72,17405,2831,6065,0.467,535,1535,0.349,2296,4530,0.507,1356,1708,0.794,825,2237,3062,1687,570,976,1451,7553
4754,2017-3-27,Los Angeles Lakers,73,17545,2857,6381,0.448,667,1915,0.348,2190,4466,0.49,1258,1668,0.754,821,2356,3177,1519,583,1060,1527,7639
4755,2017-3-27,Milwaukee Bucks,73,17595,2852,6009,0.475,630,1705,0.37,2222,4304,0.516,1288,1671,0.771,661,2291,2952,1767,604,963,1479,7622
4756,2017-3-27,Indiana Pacers,73,17645,2844,6151,0.462,621,1663,0.373,2223,4488,0.495,1305,1617,0.807,645,2414,3059,1627,601,973,1431,7614
4757,2017-3-27,New Orleans Pelicans,73,17745,2835,6336,0.447,689,1956,0.352,2146,4380,0.49,1212,1624,0.746,629,2604,3233,1652,566,920,1345,7571
4758,2017-3-27,Atlanta Hawks,73,17695,2781,6160,0.451,642,1893,0.339,2139,4267,0.501,1323,1828,0.724,751,2471,3222,1706,614,1107,1317,7527
4759,2017-3-27,Miami Heat,73,17595,2850,6274,0.454,714,1969,0.363,2136,4305,0.496,1091,1554,0.702,783,2411,3194,1554,525,920,1505,7505
4760,2017-3-27,Sacramento Kings,73,17720,2757,6010,0.459,669,1778,0.376,2088,4232,0.493,1318,1698,0.776,641,2345,2986,1644,571,1027,1495,7501
4761,2017-3-27,Philadelphia 76ers,73,17670,2753,6219,0.443,741,2144,0.346,2012,4075,0.494,1231,1607,0.766,702,2435,3137,1732,617,1173,1609,7478
4762,2017-3-27,Chicago Bulls,74,17860,2846,6424,0.443,535,1618,0.331,2311,4806,0.481,1353,1704,0.794,912,2482,3394,1650,572,959,1312,7580
4763,2017-3-27,Detroit Pistons,73,17620,2906,6459,0.45,549,1680,0.327,2357,4779,0.493,1033,1428,0.723,788,2523,3311,1537,516,818,1307,7394
4764,2017-3-27,Memphis Grizzlies,73,17720,2658,6120,0.434,677,1930,0.351,1981,4190,0.473,1371,1751,0.783,797,2338,3135,1547,594,908,1671,7364
4765,2017-3-27,Orlando Magic,73,17620,2785,6328,0.44,614,1894,0.324,2171,4434,0.49,1142,1551,0.736,727,2426,3153,1602,503,938,1406,7326
4766,2017-3-27,Utah Jazz,73,17595,2679,5794,0.462,688,1893,0.363,1991,3901,0.51,1276,1694,0.753,691,2472,3163,1436,487,954,1381,7322
4767,2017-3-27,Dallas Mavericks,72,17380,2607,5916,0.441,760,2128,0.357,1847,3788,0.488,1068,1334,0.801,563,2205,2768,1478,548,805,1382,7042
4768,2017-3-28,Golden State Warriors,73,17620,3133,6345,0.494,873,2271,0.384,2260,4074,0.555,1323,1680,0.788,678,2571,3249,2220,709,1055,1407,8462
4769,2017-3-28,Houston Rockets,73,17620,2955,6350,0.465,1070,2942,0.364,1885,3408,0.553,1471,1923,0.765,788,2442,3230,1859,609,1060,1471,8451
4770,2017-3-28,Denver Nuggets,73,17595,2987,6389,0.468,771,2081,0.37,2216,4308,0.514,1388,1796,0.773,881,2497,3378,1834,511,1067,1404,8133
4771,2017-3-28,Cleveland Cavaliers,73,17620,2898,6172,0.47,945,2454,0.385,1953,3718,0.525,1292,1726,0.749,678,2487,3165,1637,481,960,1309,8033
4772,2017-3-28,Washington Wizards,73,17695,3014,6361,0.474,669,1794,0.373,2345,4567,0.513,1276,1619,0.788,749,2397,3146,1756,618,982,1561,7973
4773,2017-3-28,Portland Trail Blazers,73,17770,2891,6271,0.461,747,1997,0.374,2144,4274,0.502,1352,1742,0.776,733,2471,3204,1565,504,985,1570,7881
4774,2017-3-28,Los Angeles Clippers,75,18075,2944,6255,0.471,768,2061,0.373,2176,4194,0.519,1433,1925,0.744,683,2549,3232,1676,562,945,1499,8089
4775,2017-3-28,Boston Celtics,74,17835,2858,6294,0.454,884,2445,0.362,1974,3849,0.513,1376,1693,0.813,676,2422,3098,1850,559,939,1519,7976
4776,2017-3-28,Phoenix Suns,74,17910,2929,6513,0.45,559,1662,0.336,2370,4851,0.489,1513,1937,0.781,856,2446,3302,1427,606,1110,1833,7930
4777,2017-3-28,Toronto Raptors,74,17860,2900,6257,0.463,652,1789,0.364,2248,4468,0.503,1481,1853,0.799,790,2414,3204,1352,614,870,1553,7933
4778,2017-3-28,Oklahoma City Thunder,73,17620,2891,6358,0.455,613,1870,0.328,2278,4488,0.508,1413,1900,0.744,876,2498,3374,1541,578,1071,1524,7808
4779,2017-3-28,San Antonio Spurs,73,17620,2886,6105,0.473,668,1709,0.391,2218,4396,0.505,1316,1638,0.803,718,2485,3203,1756,590,938,1353,7756
4780,2017-3-28,Brooklyn Nets,73,17595,2761,6199,0.445,792,2308,0.343,1969,3891,0.506,1424,1812,0.786,646,2547,3193,1554,512,1178,1569,7738
4781,2017-3-28,Charlotte Hornets,73,17670,2763,6261,0.441,736,2093,0.352,2027,4168,0.486,1407,1731,0.813,650,2581,3231,1698,496,816,1226,7669
4782,2017-3-28,New York Knicks,74,17935,2942,6565,0.448,649,1835,0.354,2293,4730,0.485,1241,1571,0.79,876,2484,3360,1612,526,981,1521,7774
4783,2017-3-28,Minnesota Timberwolves,72,17405,2831,6065,0.467,535,1535,0.349,2296,4530,0.507,1356,1708,0.794,825,2237,3062,1687,570,976,1451,7553
4784,2017-3-28,Los Angeles Lakers,73,17545,2857,6381,0.448,667,1915,0.348,2190,4466,0.49,1258,1668,0.754,821,2356,3177,1519,583,1060,1527,7639
4785,2017-3-28,Milwaukee Bucks,73,17595,2852,6009,0.475,630,1705,0.37,2222,4304,0.516,1288,1671,0.771,661,2291,2952,1767,604,963,1479,7622
4786,2017-3-28,Indiana Pacers,73,17645,2844,6151,0.462,621,1663,0.373,2223,4488,0.495,1305,1617,0.807,645,2414,3059,1627,601,973,1431,7614
4787,2017-3-28,New Orleans Pelicans,74,17985,2872,6416,0.448,699,1981,0.353,2173,4435,0.49,1228,1648,0.745,634,2636,3270,1669,573,929,1362,7671
4788,2017-3-28,Atlanta Hawks,73,17695,2781,6160,0.451,642,1893,0.339,2139,4267,0.501,1323,1828,0.724,751,2471,3222,1706,614,1107,1317,7527
4789,2017-3-28,Miami Heat,73,17595,2850,6274,0.454,714,1969,0.363,2136,4305,0.496,1091,1554,0.702,783,2411,3194,1554,525,920,1505,7505
4790,2017-3-28,Sacramento Kings,74,17960,2788,6077,0.459,675,1803,0.374,2113,4274,0.494,1341,1728,0.776,649,2373,3022,1660,575,1038,1518,7592
4791,2017-3-28,Philadelphia 76ers,73,17670,2753,6219,0.443,741,2144,0.346,2012,4075,0.494,1231,1607,0.766,702,2435,3137,1732,617,1173,1609,7478
4792,2017-3-28,Chicago Bulls,74,17860,2846,6424,0.443,535,1618,0.331,2311,4806,0.481,1353,1704,0.794,912,2482,3394,1650,572,959,1312,7580
4793,2017-3-28,Detroit Pistons,74,17860,2942,6543,0.45,558,1703,0.328,2384,4840,0.493,1047,1449,0.723,800,2553,3353,1555,520,836,1323,7489
4794,2017-3-28,Memphis Grizzlies,74,17960,2689,6210,0.433,682,1956,0.349,2007,4254,0.472,1394,1780,0.783,816,2364,3180,1562,598,915,1689,7454
4795,2017-3-28,Orlando Magic,74,17860,2828,6416,0.441,618,1914,0.323,2210,4502,0.491,1164,1579,0.737,735,2451,3186,1621,514,949,1429,7438
4796,2017-3-28,Utah Jazz,74,17835,2720,5879,0.463,703,1920,0.366,2017,3959,0.509,1287,1712,0.752,702,2510,3212,1463,493,964,1403,7430
4797,2017-3-28,Dallas Mavericks,73,17620,2640,5996,0.44,770,2157,0.357,1870,3839,0.487,1083,1353,0.8,571,2236,2807,1501,560,819,1398,7133
4798,2017-3-29,Golden State Warriors,74,17860,3178,6433,0.494,884,2312,0.382,2294,4121,0.557,1335,1696,0.787,686,2607,3293,2253,718,1071,1436,8575
4799,2017-3-29,Houston Rockets,74,17860,2988,6435,0.464,1075,2973,0.362,1913,3462,0.553,1506,1962,0.768,798,2470,3268,1879,618,1074,1485,8557
4800,2017-3-29,Denver Nuggets,74,17835,3031,6483,0.468,780,2111,0.369,2251,4372,0.515,1404,1816,0.773,893,2532,3425,1857,514,1079,1428,8246
4801,2017-3-29,Cleveland Cavaliers,73,17620,2898,6172,0.47,945,2454,0.385,1953,3718,0.525,1292,1726,0.749,678,2487,3165,1637,481,960,1309,8033
4802,2017-3-29,Washington Wizards,74,17935,3062,6455,0.474,675,1817,0.371,2387,4638,0.515,1293,1644,0.786,762,2425,3187,1780,630,994,1581,8092
4803,2017-3-29,Portland Trail Blazers,74,18010,2936,6362,0.461,755,2024,0.373,2181,4338,0.503,1376,1775,0.775,748,2503,3251,1580,512,994,1588,8003
4804,2017-3-29,Los Angeles Clippers,75,18075,2944,6255,0.471,768,2061,0.373,2176,4194,0.519,1433,1925,0.744,683,2549,3232,1676,562,945,1499,8089
4805,2017-3-29,Boston Celtics,74,17835,2858,6294,0.454,884,2445,0.362,1974,3849,0.513,1376,1693,0.813,676,2422,3098,1850,559,939,1519,7976
4806,2017-3-29,Toronto Raptors,74,17860,2900,6257,0.463,652,1789,0.364,2248,4468,0.503,1481,1853,0.799,790,2414,3204,1352,614,870,1553,7933
4807,2017-3-29,Oklahoma City Thunder,73,17620,2891,6358,0.455,613,1870,0.328,2278,4488,0.508,1413,1900,0.744,876,2498,3374,1541,578,1071,1524,7808
4808,2017-3-29,Phoenix Suns,75,18150,2964,6609,0.448,566,1693,0.334,2398,4916,0.488,1527,1961,0.779,870,2480,3350,1452,618,1125,1864,8021
4809,2017-3-29,San Antonio Spurs,73,17620,2886,6105,0.473,668,1709,0.391,2218,4396,0.505,1316,1638,0.803,718,2485,3203,1756,590,938,1353,7756
4810,2017-3-29,Brooklyn Nets,74,17835,2799,6293,0.445,801,2340,0.342,1998,3953,0.505,1440,1836,0.784,659,2584,3243,1576,523,1191,1588,7839
4811,2017-3-29,Charlotte Hornets,74,17910,2802,6341,0.442,743,2121,0.35,2059,4220,0.488,1430,1760,0.813,655,2607,3262,1723,503,818,1238,7777
4812,2017-3-29,New York Knicks,74,17935,2942,6565,0.448,649,1835,0.354,2293,4730,0.485,1241,1571,0.79,876,2484,3360,1612,526,981,1521,7774
4813,2017-3-29,Minnesota Timberwolves,73,17645,2868,6143,0.467,544,1555,0.35,2324,4588,0.507,1388,1745,0.795,836,2261,3097,1709,580,990,1473,7668
4814,2017-3-29,Los Angeles Lakers,74,17785,2900,6466,0.448,675,1937,0.348,2225,4529,0.491,1272,1684,0.755,832,2388,3220,1540,589,1078,1546,7747
4815,2017-3-29,Milwaukee Bucks,74,17835,2898,6083,0.476,644,1735,0.371,2254,4348,0.518,1300,1688,0.77,664,2330,2994,1798,605,977,1505,7740
4816,2017-3-29,Indiana Pacers,74,17885,2884,6232,0.463,626,1681,0.372,2258,4551,0.496,1334,1652,0.808,656,2440,3096,1652,609,987,1453,7728
4817,2017-3-29,New Orleans Pelicans,74,17985,2872,6416,0.448,699,1981,0.353,2173,4435,0.49,1228,1648,0.745,634,2636,3270,1669,573,929,1362,7671
4818,2017-3-29,Atlanta Hawks,74,17935,2815,6245,0.451,648,1920,0.338,2167,4325,0.501,1344,1857,0.724,760,2513,3273,1730,619,1126,1340,7622
4819,2017-3-29,Miami Heat,74,17835,2886,6353,0.454,719,1990,0.361,2167,4363,0.497,1111,1582,0.702,794,2444,3238,1572,530,932,1523,7602
4820,2017-3-29,Sacramento Kings,74,17960,2788,6077,0.459,675,1803,0.374,2113,4274,0.494,1341,1728,0.776,649,2373,3022,1660,575,1038,1518,7592
4821,2017-3-29,Philadelphia 76ers,74,17910,2792,6310,0.442,751,2177,0.345,2041,4133,0.494,1249,1628,0.767,714,2476,3190,1753,624,1189,1632,7584
4822,2017-3-29,Chicago Bulls,74,17860,2846,6424,0.443,535,1618,0.331,2311,4806,0.481,1353,1704,0.794,912,2482,3394,1650,572,959,1312,7580
4823,2017-3-29,Detroit Pistons,75,18100,2978,6628,0.449,566,1730,0.327,2412,4898,0.492,1063,1470,0.723,816,2588,3404,1575,527,848,1346,7585
4824,2017-3-29,Memphis Grizzlies,74,17960,2689,6210,0.433,682,1956,0.349,2007,4254,0.472,1394,1780,0.783,816,2364,3180,1562,598,915,1689,7454
4825,2017-3-29,Orlando Magic,74,17860,2828,6416,0.441,618,1914,0.323,2210,4502,0.491,1164,1579,0.737,735,2451,3186,1621,514,949,1429,7438
4826,2017-3-29,Utah Jazz,74,17835,2720,5879,0.463,703,1920,0.366,2017,3959,0.509,1287,1712,0.752,702,2510,3212,1463,493,964,1403,7430
4827,2017-3-29,Dallas Mavericks,73,17620,2640,5996,0.44,770,2157,0.357,1870,3839,0.487,1083,1353,0.8,571,2236,2807,1501,560,819,1398,7133
4828,2017-3-30,Golden State Warriors,75,18100,3221,6518,0.494,897,2338,0.384,2324,4180,0.556,1346,1707,0.789,696,2632,3328,2284,725,1086,1458,8685
4829,2017-3-30,Houston Rockets,74,17860,2988,6435,0.464,1075,2973,0.362,1913,3462,0.553,1506,1962,0.768,798,2470,3268,1879,618,1074,1485,8557
4830,2017-3-30,Denver Nuggets,74,17835,3031,6483,0.468,780,2111,0.369,2251,4372,0.515,1404,1816,0.773,893,2532,3425,1857,514,1079,1428,8246
4831,2017-3-30,Cleveland Cavaliers,73,17620,2898,6172,0.47,945,2454,0.385,1953,3718,0.525,1292,1726,0.749,678,2487,3165,1637,481,960,1309,8033
4832,2017-3-30,Washington Wizards,75,18175,3108,6548,0.475,688,1851,0.372,2420,4697,0.515,1312,1673,0.784,776,2454,3230,1802,637,1004,1612,8216
4833,2017-3-30,Los Angeles Clippers,76,18315,2991,6338,0.472,780,2091,0.373,2211,4247,0.521,1460,1962,0.744,691,2582,3273,1703,568,955,1521,8222
4834,2017-3-30,Portland Trail Blazers,74,18010,2936,6362,0.461,755,2024,0.373,2181,4338,0.503,1376,1775,0.775,748,2503,3251,1580,512,994,1588,8003
4835,2017-3-30,Boston Celtics,75,18075,2893,6382,0.453,896,2482,0.361,1997,3900,0.512,1394,1716,0.812,691,2449,3140,1874,567,955,1537,8076
4836,2017-3-30,Toronto Raptors,75,18100,2938,6340,0.463,663,1820,0.364,2275,4520,0.503,1500,1877,0.799,803,2445,3248,1375,618,883,1575,8039
4837,2017-3-30,Oklahoma City Thunder,74,17885,2934,6460,0.454,623,1903,0.327,2311,4557,0.507,1431,1928,0.742,887,2544,3431,1559,589,1082,1544,7922
4838,2017-3-30,Phoenix Suns,75,18150,2964,6609,0.448,566,1693,0.334,2398,4916,0.488,1527,1961,0.779,870,2480,3350,1452,618,1125,1864,8021
4839,2017-3-30,San Antonio Spurs,74,17860,2920,6188,0.472,677,1733,0.391,2243,4455,0.503,1337,1664,0.803,734,2511,3245,1776,599,953,1365,7854
4840,2017-3-30,Brooklyn Nets,74,17835,2799,6293,0.445,801,2340,0.342,1998,3953,0.505,1440,1836,0.784,659,2584,3243,1576,523,1191,1588,7839
4841,2017-3-30,Charlotte Hornets,75,18150,2841,6427,0.442,759,2153,0.353,2082,4274,0.487,1446,1781,0.812,666,2634,3300,1746,509,826,1256,7887
4842,2017-3-30,Minnesota Timberwolves,73,17645,2868,6143,0.467,544,1555,0.35,2324,4588,0.507,1388,1745,0.795,836,2261,3097,1709,580,990,1473,7668
4843,2017-3-30,New York Knicks,75,18175,2975,6654,0.447,654,1860,0.352,2321,4794,0.484,1258,1592,0.79,893,2519,3412,1631,528,995,1537,7862
4844,2017-3-30,Los Angeles Lakers,74,17785,2900,6466,0.448,675,1937,0.348,2225,4529,0.491,1272,1684,0.755,832,2388,3220,1540,589,1078,1546,7747
4845,2017-3-30,Milwaukee Bucks,75,18075,2939,6161,0.477,652,1757,0.371,2287,4404,0.519,1313,1705,0.77,671,2358,3029,1825,614,991,1526,7843
4846,2017-3-30,Indiana Pacers,75,18125,2921,6317,0.462,636,1706,0.373,2285,4611,0.496,1347,1667,0.808,668,2471,3139,1671,614,999,1471,7825
4847,2017-3-30,New Orleans Pelicans,75,18225,2914,6500,0.448,711,2011,0.354,2203,4489,0.491,1253,1681,0.745,645,2669,3314,1695,578,935,1380,7792
4848,2017-3-30,Atlanta Hawks,75,18175,2849,6325,0.45,657,1938,0.339,2192,4387,0.5,1366,1883,0.725,775,2545,3320,1749,626,1143,1355,7721
4849,2017-3-30,Miami Heat,75,18075,2926,6437,0.455,731,2015,0.363,2195,4422,0.496,1124,1599,0.703,802,2476,3278,1590,541,942,1546,7707
4850,2017-3-30,Chicago Bulls,74,17860,2846,6424,0.443,535,1618,0.331,2311,4806,0.481,1353,1704,0.794,912,2482,3394,1650,572,959,1312,7580
4851,2017-3-30,Sacramento Kings,75,18200,2822,6152,0.459,677,1818,0.372,2145,4334,0.495,1353,1746,0.775,651,2403,3054,1674,582,1051,1535,7674
4852,2017-3-30,Philadelphia 76ers,75,18150,2828,6397,0.442,762,2216,0.344,2066,4181,0.494,1258,1639,0.768,727,2503,3230,1783,631,1203,1651,7676
4853,2017-3-30,Detroit Pistons,75,18100,2978,6628,0.449,566,1730,0.327,2412,4898,0.492,1063,1470,0.723,816,2588,3404,1575,527,848,1346,7585
4854,2017-3-30,Memphis Grizzlies,75,18200,2730,6298,0.433,694,1988,0.349,2036,4310,0.472,1410,1798,0.784,825,2398,3223,1584,606,923,1708,7564
4855,2017-3-30,Orlando Magic,75,18125,2867,6513,0.44,627,1944,0.323,2240,4569,0.49,1183,1606,0.737,746,2493,3239,1645,523,963,1451,7544
4856,2017-3-30,Utah Jazz,75,18075,2762,5958,0.464,716,1951,0.367,2046,4007,0.511,1302,1731,0.752,709,2546,3255,1485,503,975,1421,7542
4857,2017-3-30,Dallas Mavericks,74,17860,2684,6087,0.441,784,2184,0.359,1900,3903,0.487,1099,1370,0.802,579,2266,2845,1526,563,824,1419,7251
4858,2017-4-1,Golden State Warriors,76,18340,3264,6613,0.494,908,2370,0.383,2356,4243,0.555,1356,1721,0.788,709,2662,3371,2311,735,1096,1478,8792
4859,2017-4-1,Houston Rockets,76,18340,3062,6617,0.463,1095,3044,0.36,1967,3573,0.551,1543,2008,0.768,829,2529,3358,1917,633,1105,1517,8762
4860,2017-4-1,Denver Nuggets,75,18075,3076,6573,0.468,796,2144,0.371,2280,4429,0.515,1412,1827,0.773,903,2571,3474,1889,518,1092,1447,8360
4861,2017-4-1,Cleveland Cavaliers,75,18100,2985,6350,0.47,968,2510,0.386,2017,3840,0.525,1310,1758,0.745,700,2558,3258,1690,495,983,1347,8248
4862,2017-4-1,Washington Wizards,76,18415,3143,6635,0.474,693,1868,0.371,2450,4767,0.514,1325,1689,0.784,790,2485,3275,1814,645,1018,1635,8304
4863,2017-4-1,Los Angeles Clippers,77,18555,3035,6418,0.473,792,2113,0.375,2243,4305,0.521,1484,1996,0.743,698,2614,3312,1723,572,969,1542,8346
4864,2017-4-1,Portland Trail Blazers,75,18250,2979,6452,0.462,768,2057,0.373,2211,4395,0.503,1394,1797,0.776,759,2533,3292,1604,524,1006,1604,8120
4865,2017-4-1,Boston Celtics,76,18315,2931,6466,0.453,908,2515,0.361,2023,3951,0.512,1423,1750,0.813,696,2489,3185,1901,573,966,1555,8193
4866,2017-4-1,Toronto Raptors,76,18340,2975,6422,0.463,677,1847,0.367,2298,4575,0.502,1523,1912,0.797,819,2482,3301,1398,625,897,1598,8150
4867,2017-4-1,Phoenix Suns,76,18390,3013,6701,0.45,573,1716,0.334,2440,4985,0.489,1540,1985,0.776,883,2510,3393,1476,624,1139,1891,8139
4868,2017-4-1,Oklahoma City Thunder,75,18125,2967,6541,0.454,629,1924,0.327,2338,4617,0.506,1454,1955,0.744,900,2577,3477,1580,596,1100,1565,8017
4869,2017-4-1,San Antonio Spurs,75,18100,2957,6273,0.471,686,1760,0.39,2271,4513,0.503,1354,1691,0.801,747,2539,3286,1799,607,966,1388,7954
4870,2017-4-1,Brooklyn Nets,75,18075,2834,6385,0.444,811,2371,0.342,2023,4014,0.504,1449,1848,0.784,667,2622,3289,1593,527,1203,1604,7928
4871,2017-4-1,Charlotte Hornets,76,18390,2881,6513,0.442,776,2189,0.354,2105,4324,0.487,1471,1811,0.812,676,2667,3343,1772,519,832,1273,8009
4872,2017-4-1,Minnesota Timberwolves,74,17885,2911,6232,0.467,554,1576,0.352,2357,4656,0.506,1411,1775,0.795,850,2287,3137,1739,589,1000,1493,7787
4873,2017-4-1,Los Angeles Lakers,75,18025,2940,6550,0.449,684,1964,0.348,2256,4586,0.492,1287,1700,0.757,846,2416,3262,1560,593,1094,1568,7851
4874,2017-4-1,New York Knicks,76,18415,3013,6734,0.447,660,1876,0.352,2353,4858,0.484,1274,1609,0.792,901,2550,3451,1656,537,1009,1555,7960
4875,2017-4-1,Milwaukee Bucks,76,18340,2974,6245,0.476,666,1793,0.371,2308,4452,0.518,1337,1739,0.769,680,2397,3077,1850,620,1003,1544,7951
4876,2017-4-1,Indiana Pacers,76,18365,2957,6404,0.462,647,1732,0.374,2310,4672,0.494,1364,1688,0.808,680,2501,3181,1690,621,1012,1492,7925
4877,2017-4-1,New Orleans Pelicans,76,18465,2960,6595,0.449,721,2044,0.353,2239,4551,0.492,1268,1700,0.746,655,2704,3359,1723,594,947,1393,7909
4878,2017-4-1,Atlanta Hawks,75,18175,2849,6325,0.45,657,1938,0.339,2192,4387,0.5,1366,1883,0.725,775,2545,3320,1749,626,1143,1355,7721
4879,2017-4-1,Miami Heat,76,18315,2960,6520,0.454,739,2048,0.361,2221,4472,0.497,1142,1624,0.703,813,2506,3319,1607,546,955,1563,7801
4880,2017-4-1,Philadelphia 76ers,76,18390,2868,6479,0.443,773,2249,0.344,2095,4230,0.495,1272,1658,0.767,734,2538,3272,1809,638,1220,1672,7781
4881,2017-4-1,Chicago Bulls,75,18100,2884,6514,0.443,547,1643,0.333,2337,4871,0.48,1364,1722,0.792,927,2518,3445,1676,583,971,1327,7679
4882,2017-4-1,Sacramento Kings,76,18440,2857,6242,0.458,683,1838,0.372,2174,4404,0.494,1366,1763,0.775,665,2441,3106,1692,589,1071,1552,7763
4883,2017-4-1,Detroit Pistons,77,18605,3058,6811,0.449,580,1778,0.326,2478,5033,0.492,1084,1503,0.721,840,2671,3511,1620,541,876,1384,7780
4884,2017-4-1,Orlando Magic,76,18365,2907,6611,0.44,639,1974,0.324,2268,4637,0.489,1207,1631,0.74,757,2530,3287,1673,532,972,1472,7660
4885,2017-4-1,Memphis Grizzlies,76,18440,2765,6373,0.434,705,2015,0.35,2060,4358,0.473,1428,1818,0.785,833,2437,3270,1607,610,936,1730,7663
4886,2017-4-1,Utah Jazz,76,18315,2795,6030,0.464,726,1976,0.367,2069,4054,0.51,1321,1762,0.75,716,2581,3297,1505,512,985,1439,7637
4887,2017-4-1,Dallas Mavericks,75,18100,2713,6163,0.44,796,2218,0.359,1917,3945,0.486,1119,1395,0.802,585,2298,2883,1541,570,832,1440,7341
4888,2017-4-2,Golden State Warriors,76,18340,3264,6613,0.494,908,2370,0.383,2356,4243,0.555,1356,1721,0.788,709,2662,3371,2311,735,1096,1478,8792
4889,2017-4-2,Houston Rockets,76,18340,3062,6617,0.463,1095,3044,0.36,1967,3573,0.551,1543,2008,0.768,829,2529,3358,1917,633,1105,1517,8762
4890,2017-4-2,Denver Nuggets,75,18075,3076,6573,0.468,796,2144,0.371,2280,4429,0.515,1412,1827,0.773,903,2571,3474,1889,518,1092,1447,8360
4891,2017-4-2,Cleveland Cavaliers,75,18100,2985,6350,0.47,968,2510,0.386,2017,3840,0.525,1310,1758,0.745,700,2558,3258,1690,495,983,1347,8248
4892,2017-4-2,Washington Wizards,76,18415,3143,6635,0.474,693,1868,0.371,2450,4767,0.514,1325,1689,0.784,790,2485,3275,1814,645,1018,1635,8304
4893,2017-4-2,Portland Trail Blazers,76,18490,3022,6544,0.462,783,2094,0.374,2239,4450,0.503,1423,1828,0.778,770,2563,3333,1625,536,1018,1627,8250
4894,2017-4-2,Los Angeles Clippers,78,18795,3073,6487,0.474,803,2138,0.376,2270,4349,0.522,1512,2030,0.745,702,2649,3351,1747,580,986,1561,8461
4895,2017-4-2,Boston Celtics,76,18315,2931,6466,0.453,908,2515,0.361,2023,3951,0.512,1423,1750,0.813,696,2489,3185,1901,573,966,1555,8193
4896,2017-4-2,Phoenix Suns,77,18630,3057,6785,0.451,576,1726,0.334,2481,5059,0.49,1566,2017,0.776,896,2540,3436,1493,632,1156,1917,8256
4897,2017-4-2,Toronto Raptors,76,18340,2975,6422,0.463,677,1847,0.367,2298,4575,0.502,1523,1912,0.797,819,2482,3301,1398,625,897,1598,8150
4898,2017-4-2,Oklahoma City Thunder,75,18125,2967,6541,0.454,629,1924,0.327,2338,4617,0.506,1454,1955,0.744,900,2577,3477,1580,596,1100,1565,8017
4899,2017-4-2,San Antonio Spurs,75,18100,2957,6273,0.471,686,1760,0.39,2271,4513,0.503,1354,1691,0.801,747,2539,3286,1799,607,966,1388,7954
4900,2017-4-2,Brooklyn Nets,76,18315,2884,6479,0.445,819,2402,0.341,2065,4077,0.506,1462,1864,0.784,676,2657,3333,1619,535,1214,1619,8049
4901,2017-4-2,Charlotte Hornets,76,18390,2881,6513,0.442,776,2189,0.354,2105,4324,0.487,1471,1811,0.812,676,2667,3343,1772,519,832,1273,8009
4902,2017-4-2,Minnesota Timberwolves,75,18125,2950,6319,0.467,563,1603,0.351,2387,4716,0.506,1441,1813,0.795,860,2318,3178,1766,597,1010,1516,7904
4903,2017-4-2,Los Angeles Lakers,76,18265,2979,6640,0.449,690,1987,0.347,2289,4653,0.492,1307,1730,0.755,861,2442,3303,1586,605,1105,1595,7955
4904,2017-4-2,New York Knicks,76,18415,3013,6734,0.447,660,1876,0.352,2353,4858,0.484,1274,1609,0.792,901,2550,3451,1656,537,1009,1555,7960
4905,2017-4-2,Milwaukee Bucks,76,18340,2974,6245,0.476,666,1793,0.371,2308,4452,0.518,1337,1739,0.769,680,2397,3077,1850,620,1003,1544,7951
4906,2017-4-2,Indiana Pacers,76,18365,2957,6404,0.462,647,1732,0.374,2310,4672,0.494,1364,1688,0.808,680,2501,3181,1690,621,1012,1492,7925
4907,2017-4-2,New Orleans Pelicans,76,18465,2960,6595,0.449,721,2044,0.353,2239,4551,0.492,1268,1700,0.746,655,2704,3359,1723,594,947,1393,7909
4908,2017-4-2,Atlanta Hawks,76,18415,2889,6415,0.45,668,1966,0.34,2221,4449,0.499,1379,1900,0.726,786,2579,3365,1774,630,1156,1371,7825
4909,2017-4-2,Miami Heat,76,18315,2960,6520,0.454,739,2048,0.361,2221,4472,0.497,1142,1624,0.703,813,2506,3319,1607,546,955,1563,7801
4910,2017-4-2,Sacramento Kings,77,18680,2901,6320,0.459,694,1857,0.374,2207,4463,0.495,1390,1796,0.774,672,2474,3146,1719,594,1088,1579,7886
4911,2017-4-2,Philadelphia 76ers,76,18390,2868,6479,0.443,773,2249,0.344,2095,4230,0.495,1272,1658,0.767,734,2538,3272,1809,638,1220,1672,7781
4912,2017-4-2,Chicago Bulls,76,18340,2924,6599,0.443,559,1673,0.334,2365,4926,0.48,1378,1736,0.794,933,2552,3485,1701,589,983,1344,7785
4913,2017-4-2,Detroit Pistons,77,18605,3058,6811,0.449,580,1778,0.326,2478,5033,0.492,1084,1503,0.721,840,2671,3511,1620,541,876,1384,7780
4914,2017-4-2,Orlando Magic,77,18605,2952,6702,0.44,649,1999,0.325,2303,4703,0.49,1218,1646,0.74,768,2561,3329,1699,541,986,1487,7771
4915,2017-4-2,Memphis Grizzlies,76,18440,2765,6373,0.434,705,2015,0.35,2060,4358,0.473,1428,1818,0.785,833,2437,3270,1607,610,936,1730,7663
4916,2017-4-2,Utah Jazz,76,18315,2795,6030,0.464,726,1976,0.367,2069,4054,0.51,1321,1762,0.75,716,2581,3297,1505,512,985,1439,7637
4917,2017-4-2,Dallas Mavericks,75,18100,2713,6163,0.44,796,2218,0.359,1917,3945,0.486,1119,1395,0.802,585,2298,2883,1541,570,832,1440,7341
4918,2017-4-3,Golden State Warriors,77,18580,3314,6701,0.495,924,2406,0.384,2390,4295,0.556,1379,1747,0.789,719,2696,3415,2345,742,1112,1498,8931
4919,2017-4-3,Houston Rockets,77,18580,3109,6717,0.463,1109,3082,0.36,2000,3635,0.55,1558,2031,0.767,842,2562,3404,1940,641,1120,1540,8885
4920,2017-4-3,Denver Nuggets,76,18315,3120,6660,0.468,801,2164,0.37,2319,4496,0.516,1435,1854,0.774,909,2605,3514,1914,527,1100,1461,8476
4921,2017-4-3,Cleveland Cavaliers,76,18390,3032,6445,0.47,986,2553,0.386,2046,3892,0.526,1333,1791,0.744,715,2599,3314,1719,502,996,1366,8383
4922,2017-4-3,Washington Wizards,77,18655,3186,6727,0.474,703,1895,0.371,2483,4832,0.514,1344,1714,0.784,799,2514,3313,1842,654,1032,1655,8419
4923,2017-4-3,Portland Trail Blazers,76,18490,3022,6544,0.462,783,2094,0.374,2239,4450,0.503,1423,1828,0.778,770,2563,3333,1625,536,1018,1627,8250
4924,2017-4-3,Los Angeles Clippers,78,18795,3073,6487,0.474,803,2138,0.376,2270,4349,0.522,1512,2030,0.745,702,2649,3351,1747,580,986,1561,8461
4925,2017-4-3,Boston Celtics,77,18555,2971,6538,0.454,920,2552,0.361,2051,3986,0.515,1441,1776,0.811,701,2525,3226,1923,581,983,1580,8303
4926,2017-4-3,Phoenix Suns,78,18870,3099,6885,0.45,584,1760,0.332,2515,5125,0.491,1590,2046,0.777,918,2579,3497,1517,640,1179,1941,8372
4927,2017-4-3,Toronto Raptors,77,18580,3021,6507,0.464,683,1866,0.366,2338,4641,0.504,1538,1931,0.796,829,2509,3338,1423,637,912,1617,8263
4928,2017-4-3,Oklahoma City Thunder,76,18365,3006,6625,0.454,641,1955,0.328,2365,4670,0.506,1465,1967,0.745,907,2612,3519,1599,606,1124,1585,8118
4929,2017-4-3,San Antonio Spurs,76,18340,2997,6350,0.472,696,1779,0.391,2301,4571,0.503,1373,1713,0.802,755,2573,3328,1825,614,979,1405,8063
4930,2017-4-3,Brooklyn Nets,77,18555,2916,6561,0.444,829,2435,0.34,2087,4126,0.506,1479,1884,0.785,684,2700,3384,1640,546,1233,1641,8140
4931,2017-4-3,Charlotte Hornets,77,18630,2918,6590,0.443,787,2219,0.355,2131,4371,0.488,1499,1843,0.813,679,2701,3380,1792,537,848,1286,8122
4932,2017-4-3,Minnesota Timberwolves,75,18125,2950,6319,0.467,563,1603,0.351,2387,4716,0.506,1441,1813,0.795,860,2318,3178,1766,597,1010,1516,7904
4933,2017-4-3,Los Angeles Lakers,77,18505,3019,6725,0.449,697,2006,0.347,2322,4719,0.492,1328,1757,0.756,878,2476,3354,1600,616,1118,1607,8063
4934,2017-4-3,Milwaukee Bucks,77,18580,3013,6322,0.477,678,1827,0.371,2335,4495,0.519,1352,1757,0.769,684,2426,3110,1875,629,1016,1564,8056
4935,2017-4-3,Indiana Pacers,77,18655,3005,6509,0.462,663,1773,0.374,2342,4736,0.495,1382,1708,0.809,692,2535,3227,1722,627,1021,1516,8055
4936,2017-4-3,New York Knicks,77,18655,3046,6819,0.447,667,1901,0.351,2379,4918,0.484,1295,1634,0.793,909,2574,3483,1676,549,1020,1575,8054
4937,2017-4-3,New Orleans Pelicans,77,18705,2993,6676,0.448,731,2074,0.352,2262,4602,0.492,1302,1735,0.75,661,2738,3399,1747,601,959,1407,8019
4938,2017-4-3,Miami Heat,77,18555,3002,6607,0.454,752,2075,0.362,2250,4532,0.496,1158,1645,0.704,820,2540,3360,1633,549,965,1585,7914
4939,2017-4-3,Atlanta Hawks,77,18655,2919,6495,0.449,675,1990,0.339,2244,4505,0.498,1394,1923,0.725,794,2615,3409,1793,639,1175,1390,7907
4940,2017-4-3,Chicago Bulls,77,18580,2969,6691,0.444,572,1699,0.337,2397,4992,0.48,1392,1754,0.794,942,2592,3534,1727,596,994,1367,7902
4941,2017-4-3,Sacramento Kings,77,18680,2901,6320,0.459,694,1857,0.374,2207,4463,0.495,1390,1796,0.774,672,2474,3146,1719,594,1088,1579,7886
4942,2017-4-3,Philadelphia 76ers,77,18630,2904,6559,0.443,784,2285,0.343,2120,4274,0.496,1294,1683,0.769,747,2562,3309,1834,646,1239,1692,7886
4943,2017-4-3,Detroit Pistons,77,18605,3058,6811,0.449,580,1778,0.326,2478,5033,0.492,1084,1503,0.721,840,2671,3511,1620,541,876,1384,7780
4944,2017-4-3,Orlando Magic,77,18605,2952,6702,0.44,649,1999,0.325,2303,4703,0.49,1218,1646,0.74,768,2561,3329,1699,541,986,1487,7771
4945,2017-4-3,Memphis Grizzlies,77,18680,2805,6453,0.435,718,2045,0.351,2087,4408,0.473,1438,1832,0.785,838,2465,3303,1636,618,950,1749,7766
4946,2017-4-3,Utah Jazz,77,18555,2838,6119,0.464,735,2000,0.368,2103,4119,0.511,1329,1775,0.749,728,2605,3333,1529,518,995,1457,7740
4947,2017-4-3,Dallas Mavericks,76,18340,2751,6236,0.441,810,2254,0.359,1941,3982,0.487,1138,1415,0.804,589,2324,2913,1566,577,845,1458,7450
4948,2017-4-4,Golden State Warriors,77,18580,3314,6701,0.495,924,2406,0.384,2390,4295,0.556,1379,1747,0.789,719,2696,3415,2345,742,1112,1498,8931
4949,2017-4-4,Houston Rockets,77,18580,3109,6717,0.463,1109,3082,0.36,2000,3635,0.55,1558,2031,0.767,842,2562,3404,1940,641,1120,1540,8885
4950,2017-4-4,Denver Nuggets,76,18315,3120,6660,0.468,801,2164,0.37,2319,4496,0.516,1435,1854,0.774,909,2605,3514,1914,527,1100,1461,8476
4951,2017-4-4,Cleveland Cavaliers,76,18390,3032,6445,0.47,986,2553,0.386,2046,3892,0.526,1333,1791,0.744,715,2599,3314,1719,502,996,1366,8383
4952,2017-4-4,Washington Wizards,77,18655,3186,6727,0.474,703,1895,0.371,2483,4832,0.514,1344,1714,0.784,799,2514,3313,1842,654,1032,1655,8419
4953,2017-4-4,Portland Trail Blazers,77,18730,3060,6630,0.462,794,2126,0.373,2266,4504,0.503,1445,1853,0.78,781,2587,3368,1649,543,1023,1645,8359
4954,2017-4-4,Los Angeles Clippers,78,18795,3073,6487,0.474,803,2138,0.376,2270,4349,0.522,1512,2030,0.745,702,2649,3351,1747,580,986,1561,8461
4955,2017-4-4,Boston Celtics,77,18555,2971,6538,0.454,920,2552,0.361,2051,3986,0.515,1441,1776,0.811,701,2525,3226,1923,581,983,1580,8303
4956,2017-4-4,Phoenix Suns,78,18870,3099,6885,0.45,584,1760,0.332,2515,5125,0.491,1590,2046,0.777,918,2579,3497,1517,640,1179,1941,8372
4957,2017-4-4,Toronto Raptors,77,18580,3021,6507,0.464,683,1866,0.366,2338,4641,0.504,1538,1931,0.796,829,2509,3338,1423,637,912,1617,8263
4958,2017-4-4,Oklahoma City Thunder,76,18365,3006,6625,0.454,641,1955,0.328,2365,4670,0.506,1465,1967,0.745,907,2612,3519,1599,606,1124,1585,8118
4959,2017-4-4,San Antonio Spurs,76,18340,2997,6350,0.472,696,1779,0.391,2301,4571,0.503,1373,1713,0.802,755,2573,3328,1825,614,979,1405,8063
4960,2017-4-4,Brooklyn Nets,77,18555,2916,6561,0.444,829,2435,0.34,2087,4126,0.506,1479,1884,0.785,684,2700,3384,1640,546,1233,1641,8140
4961,2017-4-4,Charlotte Hornets,77,18630,2918,6590,0.443,787,2219,0.355,2131,4371,0.488,1499,1843,0.813,679,2701,3380,1792,537,848,1286,8122
4962,2017-4-4,Minnesota Timberwolves,76,18365,2991,6403,0.467,567,1612,0.352,2424,4791,0.506,1465,1841,0.796,872,2350,3222,1792,600,1021,1534,8014
4963,2017-4-4,Los Angeles Lakers,77,18505,3019,6725,0.449,697,2006,0.347,2322,4719,0.492,1328,1757,0.756,878,2476,3354,1600,616,1118,1607,8063
4964,2017-4-4,Milwaukee Bucks,77,18580,3013,6322,0.477,678,1827,0.371,2335,4495,0.519,1352,1757,0.769,684,2426,3110,1875,629,1016,1564,8056
4965,2017-4-4,Indiana Pacers,77,18655,3005,6509,0.462,663,1773,0.374,2342,4736,0.495,1382,1708,0.809,692,2535,3227,1722,627,1021,1516,8055
4966,2017-4-4,New York Knicks,77,18655,3046,6819,0.447,667,1901,0.351,2379,4918,0.484,1295,1634,0.793,909,2574,3483,1676,549,1020,1575,8054
4967,2017-4-4,New Orleans Pelicans,77,18705,2993,6676,0.448,731,2074,0.352,2262,4602,0.492,1302,1735,0.75,661,2738,3399,1747,601,959,1407,8019
4968,2017-4-4,Miami Heat,77,18555,3002,6607,0.454,752,2075,0.362,2250,4532,0.496,1158,1645,0.704,820,2540,3360,1633,549,965,1585,7914
4969,2017-4-4,Atlanta Hawks,77,18655,2919,6495,0.449,675,1990,0.339,2244,4505,0.498,1394,1923,0.725,794,2615,3409,1793,639,1175,1390,7907
4970,2017-4-4,Chicago Bulls,77,18580,2969,6691,0.444,572,1699,0.337,2397,4992,0.48,1392,1754,0.794,942,2592,3534,1727,596,994,1367,7902
4971,2017-4-4,Sacramento Kings,77,18680,2901,6320,0.459,694,1857,0.374,2207,4463,0.495,1390,1796,0.774,672,2474,3146,1719,594,1088,1579,7886
4972,2017-4-4,Philadelphia 76ers,77,18630,2904,6559,0.443,784,2285,0.343,2120,4274,0.496,1294,1683,0.769,747,2562,3309,1834,646,1239,1692,7886
4973,2017-4-4,Detroit Pistons,77,18605,3058,6811,0.449,580,1778,0.326,2478,5033,0.492,1084,1503,0.721,840,2671,3511,1620,541,876,1384,7780
4974,2017-4-4,Orlando Magic,77,18605,2952,6702,0.44,649,1999,0.325,2303,4703,0.49,1218,1646,0.74,768,2561,3329,1699,541,986,1487,7771
4975,2017-4-4,Memphis Grizzlies,77,18680,2805,6453,0.435,718,2045,0.351,2087,4408,0.473,1438,1832,0.785,838,2465,3303,1636,618,950,1749,7766
4976,2017-4-4,Utah Jazz,77,18555,2838,6119,0.464,735,2000,0.368,2103,4119,0.511,1329,1775,0.749,728,2605,3333,1529,518,995,1457,7740
4977,2017-4-4,Dallas Mavericks,76,18340,2751,6236,0.441,810,2254,0.359,1941,3982,0.487,1138,1415,0.804,589,2324,2913,1566,577,845,1458,7450
4978,2017-4-5,Golden State Warriors,78,18820,3358,6785,0.495,938,2438,0.385,2420,4347,0.557,1398,1771,0.789,727,2728,3455,2378,751,1125,1517,9052
4979,2017-4-5,Houston Rockets,77,18580,3109,6717,0.463,1109,3082,0.36,2000,3635,0.55,1558,2031,0.767,842,2562,3404,1940,641,1120,1540,8885
4980,2017-4-5,Denver Nuggets,77,18555,3173,6759,0.469,814,2194,0.371,2359,4565,0.517,1450,1875,0.773,924,2640,3564,1945,530,1110,1481,8610
4981,2017-4-5,Cleveland Cavaliers,77,18630,3076,6527,0.471,1004,2589,0.388,2072,3938,0.526,1349,1812,0.744,720,2636,3356,1749,511,1008,1384,8505
4982,2017-4-5,Washington Wizards,78,18895,3229,6812,0.474,720,1929,0.373,2509,4883,0.514,1359,1732,0.785,805,2544,3349,1873,664,1044,1673,8537
4983,2017-4-5,Los Angeles Clippers,78,18795,3073,6487,0.474,803,2138,0.376,2270,4349,0.522,1512,2030,0.745,702,2649,3351,1747,580,986,1561,8461
4984,2017-4-5,Portland Trail Blazers,78,18970,3093,6713,0.461,800,2152,0.372,2293,4561,0.503,1460,1870,0.781,788,2609,3397,1659,551,1030,1665,8446
4985,2017-4-5,Boston Celtics,77,18555,2971,6538,0.454,920,2552,0.361,2051,3986,0.515,1441,1776,0.811,701,2525,3226,1923,581,983,1580,8303
4986,2017-4-5,Phoenix Suns,78,18870,3099,6885,0.45,584,1760,0.332,2515,5125,0.491,1590,2046,0.777,918,2579,3497,1517,640,1179,1941,8372
4987,2017-4-5,Toronto Raptors,78,18820,3055,6583,0.464,688,1889,0.364,2367,4694,0.504,1555,1950,0.797,835,2543,3378,1434,644,925,1636,8353
4988,2017-4-5,Oklahoma City Thunder,77,18605,3046,6709,0.454,650,1983,0.328,2396,4726,0.507,1486,1992,0.746,918,2654,3572,1628,615,1137,1605,8228
4989,2017-4-5,Brooklyn Nets,78,18795,2964,6636,0.447,845,2466,0.343,2119,4170,0.508,1508,1917,0.787,685,2735,3420,1676,555,1250,1659,8281
4990,2017-4-5,San Antonio Spurs,77,18605,3032,6430,0.472,707,1800,0.393,2325,4630,0.502,1387,1731,0.801,763,2611,3374,1847,622,994,1425,8158
4991,2017-4-5,Charlotte Hornets,78,18870,2958,6669,0.444,799,2253,0.355,2159,4416,0.489,1518,1865,0.814,688,2729,3417,1813,542,864,1303,8233
4992,2017-4-5,Minnesota Timberwolves,77,18605,3032,6499,0.467,571,1631,0.35,2461,4868,0.506,1486,1867,0.796,891,2381,3272,1814,609,1034,1553,8121
4993,2017-4-5,Los Angeles Lakers,77,18505,3019,6725,0.449,697,2006,0.347,2322,4719,0.492,1328,1757,0.756,878,2476,3354,1600,616,1118,1607,8063
4994,2017-4-5,Indiana Pacers,78,18895,3044,6598,0.461,675,1798,0.375,2369,4800,0.494,1400,1726,0.811,702,2568,3270,1738,634,1032,1533,8163
4995,2017-4-5,New Orleans Pelicans,78,18945,3044,6776,0.449,745,2106,0.354,2299,4670,0.492,1317,1752,0.752,671,2763,3434,1777,606,966,1423,8150
4996,2017-4-5,New York Knicks,78,18895,3088,6908,0.447,673,1924,0.35,2415,4984,0.485,1305,1650,0.791,925,2612,3537,1702,553,1034,1597,8154
4997,2017-4-5,Milwaukee Bucks,78,18820,3042,6403,0.475,681,1845,0.369,2361,4558,0.518,1370,1783,0.768,694,2454,3148,1891,638,1027,1583,8135
4998,2017-4-5,Miami Heat,77,18555,3002,6607,0.454,752,2075,0.362,2250,4532,0.496,1158,1645,0.704,820,2540,3360,1633,549,965,1585,7914
4999,2017-4-5,Atlanta Hawks,77,18655,2919,6495,0.449,675,1990,0.339,2244,4505,0.498,1394,1923,0.725,794,2615,3409,1793,639,1175,1390,7907
5000,2017-4-5,Philadelphia 76ers,78,18870,2947,6656,0.443,796,2323,0.343,2151,4333,0.496,1314,1710,0.768,761,2584,3345,1866,653,1250,1714,8004
5001,2017-4-5,Chicago Bulls,78,18820,3001,6776,0.443,578,1726,0.335,2423,5050,0.48,1413,1777,0.795,953,2618,3571,1749,603,1008,1382,7993
5002,2017-4-5,Sacramento Kings,78,18920,2937,6401,0.459,706,1879,0.376,2231,4522,0.493,1404,1813,0.774,683,2514,3197,1736,605,1106,1589,7984
5003,2017-4-5,Detroit Pistons,77,18605,3058,6811,0.449,580,1778,0.326,2478,5033,0.492,1084,1503,0.721,840,2671,3511,1620,541,876,1384,7780
5004,2017-4-5,Orlando Magic,78,18845,2985,6788,0.44,660,2032,0.325,2325,4756,0.489,1243,1672,0.743,779,2593,3372,1722,549,1000,1508,7873
5005,2017-4-5,Memphis Grizzlies,78,18945,2840,6542,0.434,726,2070,0.351,2114,4472,0.473,1449,1850,0.783,850,2503,3353,1662,627,965,1769,7855
5006,2017-4-5,Utah Jazz,78,18795,2877,6193,0.465,748,2023,0.37,2129,4170,0.511,1344,1794,0.749,735,2645,3380,1550,522,1009,1473,7846
5007,2017-4-5,Dallas Mavericks,77,18580,2783,6316,0.441,822,2297,0.358,1961,4019,0.488,1149,1429,0.804,597,2355,2952,1587,586,861,1471,7537
5008,2017-4-6,Golden State Warriors,79,19060,3403,6874,0.495,951,2468,0.385,2452,4406,0.557,1415,1795,0.788,734,2760,3494,2403,764,1140,1536,9172
5009,2017-4-6,Houston Rockets,78,18820,3146,6804,0.462,1119,3116,0.359,2027,3688,0.55,1584,2069,0.766,853,2607,3460,1959,648,1136,1560,8995
5010,2017-4-6,Denver Nuggets,78,18795,3214,6863,0.468,821,2232,0.368,2393,4631,0.517,1465,1893,0.774,936,2679,3615,1971,540,1122,1505,8714
5011,2017-4-6,Cleveland Cavaliers,78,18870,3119,6619,0.471,1015,2625,0.387,2104,3994,0.527,1366,1830,0.746,733,2674,3407,1768,518,1018,1410,8619
5012,2017-4-6,Washington Wizards,78,18895,3229,6812,0.474,720,1929,0.373,2509,4883,0.514,1359,1732,0.785,805,2544,3349,1873,664,1044,1673,8537
5013,2017-4-6,Los Angeles Clippers,79,19035,3111,6562,0.474,815,2169,0.376,2296,4393,0.523,1536,2061,0.745,707,2684,3391,1769,591,1001,1580,8573
5014,2017-4-6,Portland Trail Blazers,78,18970,3093,6713,0.461,800,2152,0.372,2293,4561,0.503,1460,1870,0.781,788,2609,3397,1659,551,1030,1665,8446
5015,2017-4-6,Boston Celtics,78,18795,3004,6619,0.454,927,2585,0.359,2077,4034,0.515,1459,1805,0.808,709,2555,3264,1944,587,995,1598,8394
5016,2017-4-6,Phoenix Suns,79,19110,3142,6988,0.45,591,1787,0.331,2551,5201,0.49,1608,2072,0.776,938,2614,3552,1543,653,1195,1963,8483
5017,2017-4-6,Toronto Raptors,79,19060,3096,6670,0.464,698,1919,0.364,2398,4751,0.505,1568,1965,0.798,842,2572,3414,1463,651,936,1650,8458
5018,2017-4-6,Oklahoma City Thunder,78,18845,3083,6794,0.454,664,2014,0.33,2419,4780,0.506,1501,2016,0.745,930,2686,3616,1647,623,1149,1625,8331
5019,2017-4-6,Brooklyn Nets,78,18795,2964,6636,0.447,845,2466,0.343,2119,4170,0.508,1508,1917,0.787,685,2735,3420,1676,555,1250,1659,8281
5020,2017-4-6,San Antonio Spurs,78,18845,3071,6519,0.471,720,1835,0.392,2351,4684,0.502,1391,1737,0.801,770,2641,3411,1875,630,1008,1438,8253
5021,2017-4-6,Charlotte Hornets,79,19110,2993,6747,0.444,807,2278,0.354,2186,4469,0.489,1539,1889,0.815,692,2761,3453,1832,544,870,1318,8332
5022,2017-4-6,Minnesota Timberwolves,77,18605,3032,6499,0.467,571,1631,0.35,2461,4868,0.506,1486,1867,0.796,891,2381,3272,1814,609,1034,1553,8121
5023,2017-4-6,Los Angeles Lakers,78,18745,3061,6811,0.449,704,2020,0.349,2357,4791,0.492,1339,1771,0.756,886,2515,3401,1623,624,1134,1620,8165
5024,2017-4-6,Indiana Pacers,78,18895,3044,6598,0.461,675,1798,0.375,2369,4800,0.494,1400,1726,0.811,702,2568,3270,1738,634,1032,1533,8163
5025,2017-4-6,New Orleans Pelicans,78,18945,3044,6776,0.449,745,2106,0.354,2299,4670,0.492,1317,1752,0.752,671,2763,3434,1777,606,966,1423,8150
5026,2017-4-6,New York Knicks,78,18895,3088,6908,0.447,673,1924,0.35,2415,4984,0.485,1305,1650,0.791,925,2612,3537,1702,553,1034,1597,8154
5027,2017-4-6,Milwaukee Bucks,78,18820,3042,6403,0.475,681,1845,0.369,2361,4558,0.518,1370,1783,0.768,694,2454,3148,1891,638,1027,1583,8135
5028,2017-4-6,Miami Heat,78,18795,3042,6691,0.455,773,2115,0.365,2269,4576,0.496,1169,1657,0.705,827,2573,3400,1656,554,971,1601,8026
5029,2017-4-6,Atlanta Hawks,77,18655,2919,6495,0.449,675,1990,0.339,2244,4505,0.498,1394,1923,0.725,794,2615,3409,1793,639,1175,1390,7907
5030,2017-4-6,Philadelphia 76ers,78,18870,2947,6656,0.443,796,2323,0.343,2151,4333,0.496,1314,1710,0.768,761,2584,3345,1866,653,1250,1714,8004
5031,2017-4-6,Chicago Bulls,78,18820,3001,6776,0.443,578,1726,0.335,2423,5050,0.48,1413,1777,0.795,953,2618,3571,1749,603,1008,1382,7993
5032,2017-4-6,Sacramento Kings,78,18920,2937,6401,0.459,706,1879,0.376,2231,4522,0.493,1404,1813,0.774,683,2514,3197,1736,605,1106,1589,7984
5033,2017-4-6,Detroit Pistons,78,18845,3100,6892,0.45,587,1799,0.326,2513,5093,0.493,1095,1521,0.72,852,2704,3556,1642,546,890,1405,7882
5034,2017-4-6,Orlando Magic,78,18845,2985,6788,0.44,660,2032,0.325,2325,4756,0.489,1243,1672,0.743,779,2593,3372,1722,549,1000,1508,7873
5035,2017-4-6,Memphis Grizzlies,79,19185,2877,6620,0.435,735,2096,0.351,2142,4524,0.473,1466,1871,0.784,857,2534,3391,1683,634,978,1787,7955
5036,2017-4-6,Utah Jazz,78,18795,2877,6193,0.465,748,2023,0.37,2129,4170,0.511,1344,1794,0.749,735,2645,3380,1550,522,1009,1473,7846
5037,2017-4-6,Dallas Mavericks,78,18820,2821,6402,0.441,833,2328,0.358,1988,4074,0.488,1163,1447,0.804,608,2388,2996,1611,591,877,1497,7638
5038,2017-4-7,Golden State Warriors,79,19060,3403,6874,0.495,951,2468,0.385,2452,4406,0.557,1415,1795,0.788,734,2760,3494,2403,764,1140,1536,9172
5039,2017-4-7,Houston Rockets,78,18820,3146,6804,0.462,1119,3116,0.359,2027,3688,0.55,1584,2069,0.766,853,2607,3460,1959,648,1136,1560,8995
5040,2017-4-7,Denver Nuggets,78,18795,3214,6863,0.468,821,2232,0.368,2393,4631,0.517,1465,1893,0.774,936,2679,3615,1971,540,1122,1505,8714
5041,2017-4-7,Cleveland Cavaliers,78,18870,3119,6619,0.471,1015,2625,0.387,2104,3994,0.527,1366,1830,0.746,733,2674,3407,1768,518,1018,1410,8619
5042,2017-4-7,Washington Wizards,79,19135,3265,6886,0.474,734,1963,0.374,2531,4923,0.514,1379,1760,0.784,814,2574,3388,1890,669,1057,1695,8643
5043,2017-4-7,Los Angeles Clippers,79,19035,3111,6562,0.474,815,2169,0.376,2296,4393,0.523,1536,2061,0.745,707,2684,3391,1769,591,1001,1580,8573
5044,2017-4-7,Portland Trail Blazers,79,19210,3128,6794,0.46,814,2185,0.373,2314,4609,0.502,1481,1896,0.781,792,2646,3438,1678,559,1042,1685,8551
5045,2017-4-7,Boston Celtics,79,19035,3041,6709,0.453,942,2628,0.358,2099,4081,0.514,1486,1839,0.808,719,2583,3302,1972,596,1007,1627,8510
5046,2017-4-7,Phoenix Suns,79,19110,3142,6988,0.45,591,1787,0.331,2551,5201,0.49,1608,2072,0.776,938,2614,3552,1543,653,1195,1963,8483
5047,2017-4-7,Toronto Raptors,79,19060,3096,6670,0.464,698,1919,0.364,2398,4751,0.505,1568,1965,0.798,842,2572,3414,1463,651,936,1650,8458
5048,2017-4-7,Oklahoma City Thunder,78,18845,3083,6794,0.454,664,2014,0.33,2419,4780,0.506,1501,2016,0.745,930,2686,3616,1647,623,1149,1625,8331
5049,2017-4-7,Brooklyn Nets,79,19035,3004,6723,0.447,856,2496,0.343,2148,4227,0.508,1524,1939,0.786,692,2767,3459,1697,562,1264,1678,8388
5050,2017-4-7,San Antonio Spurs,78,18845,3071,6519,0.471,720,1835,0.392,2351,4684,0.502,1391,1737,0.801,770,2641,3411,1875,630,1008,1438,8253
5051,2017-4-7,Charlotte Hornets,79,19110,2993,6747,0.444,807,2278,0.354,2186,4469,0.489,1539,1889,0.815,692,2761,3453,1832,544,870,1318,8332
5052,2017-4-7,Minnesota Timberwolves,78,18845,3070,6586,0.466,575,1649,0.349,2495,4937,0.505,1504,1887,0.797,900,2419,3319,1830,616,1047,1573,8219
5053,2017-4-7,Los Angeles Lakers,78,18745,3061,6811,0.449,704,2020,0.349,2357,4791,0.492,1339,1771,0.756,886,2515,3401,1623,624,1134,1620,8165
5054,2017-4-7,Indiana Pacers,79,19135,3082,6678,0.462,683,1823,0.375,2399,4855,0.494,1420,1752,0.811,714,2600,3314,1758,649,1048,1545,8267
5055,2017-4-7,New Orleans Pelicans,78,18945,3044,6776,0.449,745,2106,0.354,2299,4670,0.492,1317,1752,0.752,671,2763,3434,1777,606,966,1423,8150
5056,2017-4-7,New York Knicks,79,19135,3128,7003,0.447,680,1944,0.35,2448,5059,0.484,1321,1671,0.791,945,2641,3586,1722,562,1045,1616,8257
5057,2017-4-7,Milwaukee Bucks,79,19060,3075,6474,0.475,692,1869,0.37,2383,4605,0.517,1382,1797,0.769,700,2480,3180,1912,646,1048,1605,8224
5058,2017-4-7,Atlanta Hawks,78,18895,2963,6584,0.45,686,2013,0.341,2277,4571,0.498,1418,1957,0.725,807,2654,3461,1819,646,1192,1420,8030
5059,2017-4-7,Miami Heat,78,18795,3042,6691,0.455,773,2115,0.365,2269,4576,0.496,1169,1657,0.705,827,2573,3400,1656,554,971,1601,8026
5060,2017-4-7,Philadelphia 76ers,79,19110,2980,6747,0.442,803,2356,0.341,2177,4391,0.496,1331,1732,0.768,771,2624,3395,1885,663,1263,1733,8094
5061,2017-4-7,Chicago Bulls,79,19060,3040,6867,0.443,586,1751,0.335,2454,5116,0.48,1429,1794,0.797,963,2665,3628,1776,610,1024,1401,8095
5062,2017-4-7,Sacramento Kings,78,18920,2937,6401,0.459,706,1879,0.376,2231,4522,0.493,1404,1813,0.774,683,2514,3197,1736,605,1106,1589,7984
5063,2017-4-7,Detroit Pistons,78,18845,3100,6892,0.45,587,1799,0.326,2513,5093,0.493,1095,1521,0.72,852,2704,3556,1642,546,890,1405,7882
5064,2017-4-7,Orlando Magic,79,19085,3027,6878,0.44,669,2057,0.325,2358,4821,0.489,1265,1698,0.745,788,2632,3420,1746,558,1013,1528,7988
5065,2017-4-7,Memphis Grizzlies,79,19185,2877,6620,0.435,735,2096,0.351,2142,4524,0.473,1466,1871,0.784,857,2534,3391,1683,634,978,1787,7955
5066,2017-4-7,Utah Jazz,78,18795,2877,6193,0.465,748,2023,0.37,2129,4170,0.511,1344,1794,0.749,735,2645,3380,1550,522,1009,1473,7846
5067,2017-4-7,Dallas Mavericks,78,18820,2821,6402,0.441,833,2328,0.358,1988,4074,0.488,1163,1447,0.804,608,2388,2996,1611,591,877,1497,7638
5068,2017-4-8,Golden State Warriors,79,19060,3403,6874,0.495,951,2468,0.385,2452,4406,0.557,1415,1795,0.788,734,2760,3494,2403,764,1140,1536,9172
5069,2017-4-8,Houston Rockets,79,19060,3182,6891,0.462,1135,3167,0.358,2047,3724,0.55,1605,2097,0.765,862,2647,3509,1984,651,1147,1575,9104
5070,2017-4-8,Denver Nuggets,79,19035,3257,6941,0.469,834,2264,0.368,2423,4677,0.518,1488,1925,0.773,947,2718,3665,2002,549,1143,1520,8836
5071,2017-4-8,Cleveland Cavaliers,79,19110,3158,6700,0.471,1024,2661,0.385,2134,4039,0.528,1379,1847,0.747,736,2709,3445,1791,523,1031,1420,8719
5072,2017-4-8,Washington Wizards,79,19135,3265,6886,0.474,734,1963,0.374,2531,4923,0.514,1379,1760,0.784,814,2574,3388,1890,669,1057,1695,8643
5073,2017-4-8,Los Angeles Clippers,79,19035,3111,6562,0.474,815,2169,0.376,2296,4393,0.523,1536,2061,0.745,707,2684,3391,1769,591,1001,1580,8573
5074,2017-4-8,Portland Trail Blazers,79,19210,3128,6794,0.46,814,2185,0.373,2314,4609,0.502,1481,1896,0.781,792,2646,3438,1678,559,1042,1685,8551
5075,2017-4-8,Boston Celtics,79,19035,3041,6709,0.453,942,2628,0.358,2099,4081,0.514,1486,1839,0.808,719,2583,3302,1972,596,1007,1627,8510
5076,2017-4-8,Phoenix Suns,80,19350,3185,7071,0.45,599,1805,0.332,2586,5266,0.491,1634,2103,0.777,950,2647,3597,1559,659,1202,1989,8603
5077,2017-4-8,Toronto Raptors,80,19300,3131,6755,0.464,707,1939,0.365,2424,4816,0.503,1585,1989,0.797,854,2604,3458,1477,661,951,1674,8554
5078,2017-4-8,Oklahoma City Thunder,79,19085,3117,6886,0.453,671,2044,0.328,2446,4842,0.505,1525,2049,0.744,952,2712,3664,1660,624,1158,1651,8430
5079,2017-4-8,Brooklyn Nets,79,19035,3004,6723,0.447,856,2496,0.343,2148,4227,0.508,1524,1939,0.786,692,2767,3459,1697,562,1264,1678,8388
5080,2017-4-8,San Antonio Spurs,79,19085,3111,6615,0.47,729,1863,0.391,2382,4752,0.501,1404,1759,0.798,786,2683,3469,1901,636,1014,1449,8355
5081,2017-4-8,Charlotte Hornets,79,19110,2993,6747,0.444,807,2278,0.354,2186,4469,0.489,1539,1889,0.815,692,2761,3453,1832,544,870,1318,8332
5082,2017-4-8,Minnesota Timberwolves,79,19085,3109,6665,0.466,582,1665,0.35,2527,5000,0.505,1532,1915,0.8,909,2444,3353,1852,627,1059,1598,8332
5083,2017-4-8,Los Angeles Lakers,79,18985,3099,6897,0.449,708,2044,0.346,2391,4853,0.493,1357,1796,0.756,902,2540,3442,1643,636,1148,1635,8263
5084,2017-4-8,Indiana Pacers,79,19135,3082,6678,0.462,683,1823,0.375,2399,4855,0.494,1420,1752,0.811,714,2600,3314,1758,649,1048,1545,8267
5085,2017-4-8,New Orleans Pelicans,79,19185,3091,6875,0.45,748,2129,0.351,2343,4746,0.494,1326,1765,0.751,681,2786,3467,1796,617,977,1442,8256
5086,2017-4-8,New York Knicks,80,19375,3166,7091,0.446,686,1972,0.348,2480,5119,0.484,1327,1684,0.788,960,2667,3627,1742,570,1051,1632,8345
5087,2017-4-8,Milwaukee Bucks,79,19060,3075,6474,0.475,692,1869,0.37,2383,4605,0.517,1382,1797,0.769,700,2480,3180,1912,646,1048,1605,8224
5088,2017-4-8,Atlanta Hawks,79,19135,3008,6673,0.451,702,2050,0.342,2306,4623,0.499,1426,1965,0.726,813,2690,3503,1858,653,1203,1437,8144
5089,2017-4-8,Miami Heat,79,19035,3075,6774,0.454,781,2138,0.365,2294,4636,0.495,1189,1686,0.705,841,2603,3444,1672,564,990,1622,8120
5090,2017-4-8,Philadelphia 76ers,79,19110,2980,6747,0.442,803,2356,0.341,2177,4391,0.496,1331,1732,0.768,771,2624,3395,1885,663,1263,1733,8094
5091,2017-4-8,Chicago Bulls,79,19060,3040,6867,0.443,586,1751,0.335,2454,5116,0.48,1429,1794,0.797,963,2665,3628,1776,610,1024,1401,8095
5092,2017-4-8,Sacramento Kings,79,19160,2975,6476,0.459,714,1899,0.376,2261,4577,0.494,1414,1826,0.774,693,2544,3237,1763,610,1129,1608,8078
5093,2017-4-8,Detroit Pistons,79,19085,3146,7000,0.449,596,1825,0.327,2550,5175,0.493,1108,1537,0.721,870,2741,3611,1669,551,896,1422,7996
5094,2017-4-8,Orlando Magic,79,19085,3027,6878,0.44,669,2057,0.325,2358,4821,0.489,1265,1698,0.745,788,2632,3420,1746,558,1013,1528,7988
5095,2017-4-8,Utah Jazz,79,19035,2922,6268,0.466,762,2048,0.372,2160,4220,0.512,1360,1816,0.749,741,2672,3413,1579,530,1023,1494,7966
5096,2017-4-8,Memphis Grizzlies,80,19425,2915,6695,0.435,750,2123,0.353,2165,4572,0.474,1476,1883,0.784,864,2565,3429,1703,637,990,1801,8056
5097,2017-4-8,Dallas Mavericks,79,19060,2859,6490,0.441,841,2354,0.357,2018,4136,0.488,1168,1455,0.803,614,2426,3040,1637,592,886,1514,7727
5098,2017-4-9,Golden State Warriors,80,19300,3452,6970,0.495,961,2501,0.384,2491,4469,0.557,1430,1811,0.79,748,2799,3547,2440,766,1149,1551,9295
5099,2017-4-9,Houston Rockets,79,19060,3182,6891,0.462,1135,3167,0.358,2047,3724,0.55,1605,2097,0.765,862,2647,3509,1984,651,1147,1575,9104
5100,2017-4-9,Denver Nuggets,79,19035,3257,6941,0.469,834,2264,0.368,2423,4677,0.518,1488,1925,0.773,947,2718,3665,2002,549,1143,1520,8836
5101,2017-4-9,Cleveland Cavaliers,79,19110,3158,6700,0.471,1024,2661,0.385,2134,4039,0.528,1379,1847,0.747,736,2709,3445,1791,523,1031,1420,8719
5102,2017-4-9,Washington Wizards,80,19375,3304,6967,0.474,742,1985,0.374,2562,4982,0.514,1396,1782,0.783,826,2606,3432,1911,676,1076,1719,8746
5103,2017-4-9,Los Angeles Clippers,80,19275,3153,6646,0.474,821,2191,0.375,2332,4455,0.523,1544,2075,0.744,715,2721,3436,1790,599,1007,1595,8671
5104,2017-4-9,Portland Trail Blazers,80,19450,3165,6885,0.46,827,2215,0.373,2338,4670,0.501,1495,1912,0.782,804,2681,3485,1693,564,1045,1701,8652
5105,2017-4-9,Boston Celtics,80,19275,3086,6796,0.454,959,2667,0.36,2127,4129,0.515,1500,1856,0.808,724,2621,3345,2007,598,1016,1646,8631
5106,2017-4-9,Phoenix Suns,80,19350,3185,7071,0.45,599,1805,0.332,2586,5266,0.491,1634,2103,0.777,950,2647,3597,1559,659,1202,1989,8603
5107,2017-4-9,Toronto Raptors,80,19300,3131,6755,0.464,707,1939,0.365,2424,4816,0.503,1585,1989,0.797,854,2604,3458,1477,661,951,1674,8554
5108,2017-4-9,Oklahoma City Thunder,79,19085,3117,6886,0.453,671,2044,0.328,2446,4842,0.505,1525,2049,0.744,952,2712,3664,1660,624,1158,1651,8430
5109,2017-4-9,Brooklyn Nets,80,19275,3043,6815,0.447,866,2527,0.343,2177,4288,0.508,1543,1963,0.786,702,2801,3503,1721,577,1277,1691,8495
5110,2017-4-9,Charlotte Hornets,80,19350,3031,6831,0.444,816,2306,0.354,2215,4525,0.49,1568,1921,0.816,699,2796,3495,1854,549,877,1333,8446
5111,2017-4-9,San Antonio Spurs,80,19325,3145,6695,0.47,737,1885,0.391,2408,4810,0.501,1415,1773,0.798,793,2716,3509,1921,639,1027,1466,8442
5112,2017-4-9,Minnesota Timberwolves,79,19085,3109,6665,0.466,582,1665,0.35,2527,5000,0.505,1532,1915,0.8,909,2444,3353,1852,627,1059,1598,8332
5113,2017-4-9,Indiana Pacers,80,19375,3133,6764,0.463,694,1845,0.376,2439,4919,0.496,1434,1771,0.81,720,2639,3359,1793,655,1063,1560,8394
5114,2017-4-9,Los Angeles Lakers,79,18985,3099,6897,0.449,708,2044,0.346,2391,4853,0.493,1357,1796,0.756,902,2540,3442,1643,636,1148,1635,8263
5115,2017-4-9,New Orleans Pelicans,80,19425,3133,6961,0.45,753,2150,0.35,2380,4811,0.495,1338,1784,0.75,687,2814,3501,1820,620,985,1457,8357
5116,2017-4-9,New York Knicks,80,19375,3166,7091,0.446,686,1972,0.348,2480,5119,0.484,1327,1684,0.788,960,2667,3627,1742,570,1051,1632,8345
5117,2017-4-9,Milwaukee Bucks,80,19300,3110,6553,0.475,698,1896,0.368,2412,4657,0.518,1396,1817,0.768,706,2517,3223,1930,656,1063,1626,8314
5118,2017-4-9,Atlanta Hawks,79,19135,3008,6673,0.451,702,2050,0.342,2306,4623,0.499,1426,1965,0.726,813,2690,3503,1858,653,1203,1437,8144
5119,2017-4-9,Miami Heat,80,19275,3112,6854,0.454,788,2156,0.365,2324,4698,0.495,1214,1722,0.705,849,2631,3480,1695,577,1003,1641,8226
5120,2017-4-9,Chicago Bulls,80,19300,3080,6957,0.443,597,1775,0.336,2483,5182,0.479,1444,1811,0.797,974,2706,3680,1790,616,1041,1421,8201
5121,2017-4-9,Sacramento Kings,79,19160,2975,6476,0.459,714,1899,0.376,2261,4577,0.494,1414,1826,0.774,693,2544,3237,1763,610,1129,1608,8078
5122,2017-4-9,Philadelphia 76ers,80,19350,3007,6824,0.441,811,2387,0.34,2196,4437,0.495,1351,1755,0.77,781,2661,3442,1908,672,1280,1749,8176
5123,2017-4-9,Orlando Magic,80,19325,3068,6962,0.441,683,2087,0.327,2385,4875,0.489,1281,1720,0.745,792,2661,3453,1775,568,1026,1544,8100
5124,2017-4-9,Detroit Pistons,79,19085,3146,7000,0.449,596,1825,0.327,2550,5175,0.493,1108,1537,0.721,870,2741,3611,1669,551,896,1422,7996
5125,2017-4-9,Utah Jazz,80,19275,2953,6346,0.465,768,2067,0.372,2185,4279,0.511,1378,1840,0.749,750,2710,3460,1598,532,1033,1512,8052
5126,2017-4-9,Memphis Grizzlies,80,19425,2915,6695,0.435,750,2123,0.353,2165,4572,0.474,1476,1883,0.784,864,2565,3429,1703,637,990,1801,8056
5127,2017-4-9,Dallas Mavericks,79,19060,2859,6490,0.441,841,2354,0.357,2018,4136,0.488,1168,1455,0.803,614,2426,3040,1637,592,886,1514,7727
5128,2017-4-10,Golden State Warriors,80,19300,3452,6970,0.495,961,2501,0.384,2491,4469,0.557,1430,1811,0.79,748,2799,3547,2440,766,1149,1551,9295
5129,2017-4-10,Houston Rockets,80,19300,3227,6971,0.463,1153,3210,0.359,2074,3761,0.551,1632,2128,0.767,867,2683,3550,2010,654,1163,1597,9239
5130,2017-4-10,Denver Nuggets,80,19275,3297,7025,0.469,845,2298,0.368,2452,4727,0.519,1502,1940,0.774,951,2756,3707,2024,555,1155,1536,8941
5131,2017-4-10,Cleveland Cavaliers,80,19375,3203,6798,0.471,1043,2707,0.385,2160,4091,0.528,1395,1867,0.747,749,2749,3498,1819,527,1045,1447,8844
5132,2017-4-10,Washington Wizards,80,19375,3304,6967,0.474,742,1985,0.374,2562,4982,0.514,1396,1782,0.783,826,2606,3432,1911,676,1076,1719,8746
5133,2017-4-10,Los Angeles Clippers,80,19275,3153,6646,0.474,821,2191,0.375,2332,4455,0.523,1544,2075,0.744,715,2721,3436,1790,599,1007,1595,8671
5134,2017-4-10,Portland Trail Blazers,80,19450,3165,6885,0.46,827,2215,0.373,2338,4670,0.501,1495,1912,0.782,804,2681,3485,1693,564,1045,1701,8652
5135,2017-4-10,Boston Celtics,80,19275,3086,6796,0.454,959,2667,0.36,2127,4129,0.515,1500,1856,0.808,724,2621,3345,2007,598,1016,1646,8631
5136,2017-4-10,Phoenix Suns,81,19590,3229,7151,0.452,607,1824,0.333,2622,5327,0.492,1662,2135,0.778,958,2682,3640,1585,665,1214,2007,8727
5137,2017-4-10,Toronto Raptors,81,19540,3171,6832,0.464,717,1970,0.364,2454,4862,0.505,1605,2012,0.798,859,2640,3499,1497,669,961,1688,8664
5138,2017-4-10,Oklahoma City Thunder,80,19325,3157,6982,0.452,677,2069,0.327,2480,4913,0.505,1545,2071,0.746,970,2748,3718,1679,631,1170,1670,8536
5139,2017-4-10,Brooklyn Nets,80,19275,3043,6815,0.447,866,2527,0.343,2177,4288,0.508,1543,1963,0.786,702,2801,3503,1721,577,1277,1691,8495
5140,2017-4-10,Charlotte Hornets,80,19350,3031,6831,0.444,816,2306,0.354,2215,4525,0.49,1568,1921,0.816,699,2796,3495,1854,549,877,1333,8446
5141,2017-4-10,San Antonio Spurs,80,19325,3145,6695,0.47,737,1885,0.391,2408,4810,0.501,1415,1773,0.798,793,2716,3509,1921,639,1027,1466,8442
5142,2017-4-10,Minnesota Timberwolves,80,19325,3149,6745,0.467,585,1680,0.348,2564,5065,0.506,1558,1946,0.801,917,2477,3394,1879,635,1073,1614,8441
5143,2017-4-10,Indiana Pacers,80,19375,3133,6764,0.463,694,1845,0.376,2439,4919,0.496,1434,1771,0.81,720,2639,3359,1793,655,1063,1560,8394
5144,2017-4-10,Los Angeles Lakers,80,19225,3141,6983,0.45,718,2071,0.347,2423,4912,0.493,1373,1816,0.756,914,2568,3482,1669,646,1164,1658,8373
5145,2017-4-10,New Orleans Pelicans,80,19425,3133,6961,0.45,753,2150,0.35,2380,4811,0.495,1338,1784,0.75,687,2814,3501,1820,620,985,1457,8357
5146,2017-4-10,New York Knicks,81,19615,3203,7173,0.447,695,2000,0.348,2508,5173,0.485,1341,1699,0.789,966,2697,3663,1769,576,1062,1650,8442
5147,2017-4-10,Milwaukee Bucks,80,19300,3110,6553,0.475,698,1896,0.368,2412,4657,0.518,1396,1817,0.768,706,2517,3223,1930,656,1063,1626,8314
5148,2017-4-10,Atlanta Hawks,80,19400,3052,6767,0.451,711,2081,0.342,2341,4686,0.5,1455,2002,0.727,823,2725,3548,1889,661,1215,1459,8270
5149,2017-4-10,Miami Heat,80,19275,3112,6854,0.454,788,2156,0.365,2324,4698,0.495,1214,1722,0.705,849,2631,3480,1695,577,1003,1641,8226
5150,2017-4-10,Sacramento Kings,80,19400,3022,6570,0.46,723,1930,0.375,2299,4640,0.495,1439,1856,0.775,700,2575,3275,1789,618,1134,1626,8206
5151,2017-4-10,Chicago Bulls,80,19300,3080,6957,0.443,597,1775,0.336,2483,5182,0.479,1444,1811,0.797,974,2706,3680,1790,616,1041,1421,8201
5152,2017-4-10,Philadelphia 76ers,80,19350,3007,6824,0.441,811,2387,0.34,2196,4437,0.495,1351,1755,0.77,781,2661,3442,1908,672,1280,1749,8176
5153,2017-4-10,Orlando Magic,80,19325,3068,6962,0.441,683,2087,0.327,2385,4875,0.489,1281,1720,0.745,792,2661,3453,1775,568,1026,1544,8100
5154,2017-4-10,Detroit Pistons,80,19325,3185,7082,0.45,610,1853,0.329,2575,5229,0.492,1119,1553,0.721,885,2772,3657,1690,559,914,1434,8099
5155,2017-4-10,Utah Jazz,80,19275,2953,6346,0.465,768,2067,0.372,2185,4279,0.511,1378,1840,0.749,750,2710,3460,1598,532,1033,1512,8052
5156,2017-4-10,Memphis Grizzlies,81,19665,2951,6770,0.436,759,2144,0.354,2192,4626,0.474,1485,1896,0.783,870,2589,3459,1726,649,1005,1817,8146
5157,2017-4-10,Dallas Mavericks,80,19300,2900,6587,0.44,857,2399,0.357,2043,4188,0.488,1181,1474,0.801,631,2453,3084,1660,597,896,1537,7838
5158,2017-4-11,Golden State Warriors,81,19540,3491,7050,0.495,970,2526,0.384,2521,4524,0.557,1442,1828,0.789,756,2833,3589,2465,771,1162,1568,9394
5159,2017-4-11,Houston Rockets,81,19540,3260,7055,0.462,1162,3250,0.358,2098,3805,0.551,1653,2155,0.767,876,2715,3591,2033,659,1178,1620,9335
5160,2017-4-11,Denver Nuggets,80,19275,3297,7025,0.469,845,2298,0.368,2452,4727,0.519,1502,1940,0.774,951,2756,3707,2024,555,1155,1536,8941
5161,2017-4-11,Cleveland Cavaliers,81,19640,3247,6887,0.471,1057,2742,0.385,2190,4145,0.528,1414,1889,0.749,756,2789,3545,1838,534,1066,1472,8965
5162,2017-4-11,Washington Wizards,81,19615,3346,7050,0.475,749,2004,0.374,2597,5046,0.515,1410,1798,0.784,835,2645,3480,1938,684,1093,1732,8851
5163,2017-4-11,Los Angeles Clippers,81,19515,3199,6737,0.475,831,2217,0.375,2368,4520,0.524,1567,2103,0.745,727,2758,3485,1819,608,1016,1611,8796
5164,2017-4-11,Portland Trail Blazers,81,19690,3202,6974,0.459,839,2242,0.374,2363,4732,0.499,1508,1927,0.783,816,2711,3527,1711,570,1054,1718,8751
5165,2017-4-11,Boston Celtics,81,19515,3127,6887,0.454,973,2705,0.36,2154,4182,0.515,1518,1877,0.809,733,2663,3396,2038,605,1029,1669,8745
5166,2017-4-11,Phoenix Suns,81,19590,3229,7151,0.452,607,1824,0.333,2622,5327,0.492,1662,2135,0.778,958,2682,3640,1585,665,1214,2007,8727
5167,2017-4-11,Toronto Raptors,81,19540,3171,6832,0.464,717,1970,0.364,2454,4862,0.505,1605,2012,0.798,859,2640,3499,1497,669,961,1688,8664
5168,2017-4-11,Oklahoma City Thunder,80,19325,3157,6982,0.452,677,2069,0.327,2480,4913,0.505,1545,2071,0.746,970,2748,3718,1679,631,1170,1670,8536
5169,2017-4-11,Brooklyn Nets,81,19515,3074,6901,0.445,874,2558,0.342,2200,4343,0.507,1578,2002,0.788,711,2841,3552,1739,585,1289,1710,8600
5170,2017-4-11,Minnesota Timberwolves,80,19325,3149,6745,0.467,585,1680,0.348,2564,5065,0.506,1558,1946,0.801,917,2477,3394,1879,635,1073,1614,8441
5171,2017-4-11,San Antonio Spurs,81,19565,3183,6778,0.47,745,1906,0.391,2438,4872,0.5,1429,1793,0.797,806,2750,3556,1938,643,1042,1481,8540
5172,2017-4-11,Charlotte Hornets,81,19590,3064,6912,0.443,821,2324,0.353,2243,4588,0.489,1576,1934,0.815,706,2828,3534,1875,560,886,1343,8525
5173,2017-4-11,Indiana Pacers,81,19615,3182,6849,0.465,699,1861,0.376,2483,4988,0.498,1451,1792,0.81,734,2669,3403,1823,664,1077,1583,8514
5174,2017-4-11,Los Angeles Lakers,80,19225,3141,6983,0.45,718,2071,0.347,2423,4912,0.493,1373,1816,0.756,914,2568,3482,1669,646,1164,1658,8373
5175,2017-4-11,New Orleans Pelicans,80,19425,3133,6961,0.45,753,2150,0.35,2380,4811,0.495,1338,1784,0.75,687,2814,3501,1820,620,985,1457,8357
5176,2017-4-11,New York Knicks,81,19615,3203,7173,0.447,695,2000,0.348,2508,5173,0.485,1341,1699,0.789,966,2697,3663,1769,576,1062,1650,8442
5177,2017-4-11,Milwaukee Bucks,81,19540,3145,6631,0.474,714,1923,0.371,2431,4708,0.516,1399,1822,0.768,714,2555,3269,1958,660,1079,1640,8403
5178,2017-4-11,Atlanta Hawks,80,19400,3052,6767,0.451,711,2081,0.342,2341,4686,0.5,1455,2002,0.727,823,2725,3548,1889,661,1215,1459,8270
5179,2017-4-11,Miami Heat,81,19540,3156,6949,0.454,800,2189,0.365,2356,4760,0.495,1238,1756,0.705,858,2668,3526,1723,586,1016,1667,8350
5180,2017-4-11,Chicago Bulls,81,19540,3128,7046,0.444,609,1801,0.338,2519,5245,0.48,1458,1827,0.798,985,2749,3734,1823,628,1053,1437,8323
5181,2017-4-11,Sacramento Kings,80,19400,3022,6570,0.46,723,1930,0.375,2299,4640,0.495,1439,1856,0.775,700,2575,3275,1789,618,1134,1626,8206
5182,2017-4-11,Philadelphia 76ers,81,19590,3042,6899,0.441,824,2420,0.34,2218,4479,0.495,1379,1786,0.772,791,2684,3475,1928,682,1298,1768,8287
5183,2017-4-11,Detroit Pistons,81,19565,3228,7176,0.45,620,1879,0.33,2608,5297,0.492,1124,1558,0.721,891,2802,3693,1712,568,924,1452,8200
5184,2017-4-11,Orlando Magic,81,19565,3097,7046,0.44,688,2114,0.325,2409,4932,0.488,1293,1736,0.745,801,2689,3490,1793,573,1042,1562,8175
5185,2017-4-11,Utah Jazz,81,19515,2994,6438,0.465,781,2102,0.372,2213,4336,0.51,1388,1855,0.748,764,2745,3509,1627,540,1044,1529,8157
5186,2017-4-11,Memphis Grizzlies,81,19665,2951,6770,0.436,759,2144,0.354,2192,4626,0.474,1485,1896,0.783,870,2589,3459,1726,649,1005,1817,8146
5187,2017-4-11,Dallas Mavericks,80,19300,2900,6587,0.44,857,2399,0.357,2043,4188,0.488,1181,1474,0.801,631,2453,3084,1660,597,896,1537,7838
5188,2017-4-12,Golden State Warriors,81,19540,3491,7050,0.495,970,2526,0.384,2521,4524,0.557,1442,1828,0.789,756,2833,3589,2465,771,1162,1568,9394
5189,2017-4-12,Houston Rockets,81,19540,3260,7055,0.462,1162,3250,0.358,2098,3805,0.551,1653,2155,0.767,876,2715,3591,2033,659,1178,1620,9335
5190,2017-4-12,Denver Nuggets,81,19515,3338,7109,0.47,863,2340,0.369,2475,4769,0.519,1511,1954,0.773,961,2799,3760,2055,562,1171,1550,9050
5191,2017-4-12,Cleveland Cavaliers,81,19640,3247,6887,0.471,1057,2742,0.385,2190,4145,0.528,1414,1889,0.749,756,2789,3545,1838,534,1066,1472,8965
5192,2017-4-12,Washington Wizards,81,19615,3346,7050,0.475,749,2004,0.374,2597,5046,0.515,1410,1798,0.784,835,2645,3480,1938,684,1093,1732,8851
5193,2017-4-12,Los Angeles Clippers,81,19515,3199,6737,0.475,831,2217,0.375,2368,4520,0.524,1567,2103,0.745,727,2758,3485,1819,608,1016,1611,8796
5194,2017-4-12,Portland Trail Blazers,81,19690,3202,6974,0.459,839,2242,0.374,2363,4732,0.499,1508,1927,0.783,816,2711,3527,1711,570,1054,1718,8751
5195,2017-4-12,Boston Celtics,81,19515,3127,6887,0.454,973,2705,0.36,2154,4182,0.515,1518,1877,0.809,733,2663,3396,2038,605,1029,1669,8745
5196,2017-4-12,Phoenix Suns,82,19830,3270,7260,0.45,615,1854,0.332,2655,5406,0.491,1676,2159,0.776,976,2712,3688,1604,673,1223,2030,8831
5197,2017-4-12,Toronto Raptors,81,19540,3171,6832,0.464,717,1970,0.364,2454,4862,0.505,1605,2012,0.798,859,2640,3499,1497,669,961,1688,8664
5198,2017-4-12,Oklahoma City Thunder,81,19565,3194,7068,0.452,684,2091,0.327,2510,4977,0.504,1564,2096,0.746,988,2784,3772,1701,638,1187,1691,8636
5199,2017-4-12,Brooklyn Nets,81,19515,3074,6901,0.445,874,2558,0.342,2200,4343,0.507,1578,2002,0.788,711,2841,3552,1739,585,1289,1710,8600
5200,2017-4-12,San Antonio Spurs,81,19565,3183,6778,0.47,745,1906,0.391,2438,4872,0.5,1429,1793,0.797,806,2750,3556,1938,643,1042,1481,8540
5201,2017-4-12,Minnesota Timberwolves,81,19565,3187,6831,0.467,590,1700,0.347,2597,5131,0.506,1575,1971,0.799,928,2501,3429,1903,647,1084,1631,8539
5202,2017-4-12,Indiana Pacers,81,19615,3182,6849,0.465,699,1861,0.376,2483,4988,0.498,1451,1792,0.81,734,2669,3403,1823,664,1077,1583,8514
5203,2017-4-12,Charlotte Hornets,82,19830,3093,7000,0.442,824,2347,0.351,2269,4653,0.488,1591,1953,0.815,721,2853,3574,1891,571,899,1360,8601
5204,2017-4-12,Los Angeles Lakers,81,19465,3183,7071,0.45,726,2093,0.347,2457,4978,0.494,1389,1839,0.755,922,2607,3529,1693,661,1175,1676,8481
5205,2017-4-12,New Orleans Pelicans,81,19665,3170,7040,0.45,760,2172,0.35,2410,4868,0.495,1353,1804,0.75,692,2848,3540,1849,625,1001,1473,8453
5206,2017-4-12,New York Knicks,81,19615,3203,7173,0.447,695,2000,0.348,2508,5173,0.485,1341,1699,0.789,966,2697,3663,1769,576,1062,1650,8442
5207,2017-4-12,Milwaukee Bucks,81,19540,3145,6631,0.474,714,1923,0.371,2431,4708,0.516,1399,1822,0.768,714,2555,3269,1958,660,1079,1640,8403
5208,2017-4-12,Atlanta Hawks,81,19640,3093,6846,0.452,718,2108,0.341,2375,4738,0.501,1469,2020,0.727,834,2764,3598,1919,667,1231,1476,8373
5209,2017-4-12,Miami Heat,81,19540,3156,6949,0.454,800,2189,0.365,2356,4760,0.495,1238,1756,0.705,858,2668,3526,1723,586,1016,1667,8350
5210,2017-4-12,Sacramento Kings,81,19640,3065,6653,0.461,732,1949,0.376,2333,4704,0.496,1473,1899,0.776,708,2622,3330,1817,625,1147,1649,8335
5211,2017-4-12,Chicago Bulls,81,19540,3128,7046,0.444,609,1801,0.338,2519,5245,0.48,1458,1827,0.798,985,2749,3734,1823,628,1053,1437,8323
5212,2017-4-12,Philadelphia 76ers,81,19590,3042,6899,0.441,824,2420,0.34,2218,4479,0.495,1379,1786,0.772,791,2684,3475,1928,682,1298,1768,8287
5213,2017-4-12,Detroit Pistons,81,19565,3228,7176,0.45,620,1879,0.33,2608,5297,0.492,1124,1558,0.721,891,2802,3693,1712,568,924,1452,8200
5214,2017-4-12,Orlando Magic,81,19565,3097,7046,0.44,688,2114,0.325,2409,4932,0.488,1293,1736,0.745,801,2689,3490,1793,573,1042,1562,8175
5215,2017-4-12,Utah Jazz,81,19515,2994,6438,0.465,781,2102,0.372,2213,4336,0.51,1388,1855,0.748,764,2745,3509,1627,540,1044,1529,8157
5216,2017-4-12,Memphis Grizzlies,81,19665,2951,6770,0.436,759,2144,0.354,2192,4626,0.474,1485,1896,0.783,870,2589,3459,1726,649,1005,1817,8146
5217,2017-4-12,Dallas Mavericks,81,19540,2935,6675,0.44,869,2439,0.356,2066,4236,0.488,1190,1485,0.801,639,2487,3126,1684,605,909,1548,7929
5218,2017-4-13,Golden State Warriors,82,19780,3532,7140,0.495,982,2562,0.383,2550,4578,0.557,1457,1850,0.788,770,2873,3643,2491,785,1182,1585,9503
5219,2017-4-13,Houston Rockets,82,19780,3305,7152,0.462,1181,3306,0.357,2124,3846,0.552,1667,2177,0.766,892,2746,3638,2070,670,1188,1634,9458
5220,2017-4-13,Denver Nuggets,82,19755,3377,7194,0.469,870,2365,0.368,2507,4829,0.519,1537,1986,0.774,966,2837,3803,2077,568,1186,1567,9161
5221,2017-4-13,Cleveland Cavaliers,82,19880,3275,6963,0.47,1067,2779,0.384,2208,4184,0.528,1431,1913,0.748,766,2821,3587,1858,539,1081,1486,9048
5222,2017-4-13,Washington Wizards,82,19855,3388,7137,0.475,756,2030,0.372,2632,5107,0.515,1421,1812,0.784,843,2671,3514,1956,693,1103,1745,8953
5223,2017-4-13,Los Angeles Clippers,82,19755,3242,6820,0.475,841,2245,0.375,2401,4575,0.525,1586,2128,0.745,738,2790,3528,1848,612,1022,1626,8911
5224,2017-4-13,Boston Celtics,82,19755,3168,6978,0.454,985,2742,0.359,2183,4236,0.515,1536,1903,0.807,744,2698,3442,2069,617,1037,1686,8857
5225,2017-4-13,Portland Trail Blazers,82,19930,3243,7059,0.459,852,2272,0.375,2391,4787,0.499,1513,1940,0.78,830,2750,3580,1733,574,1077,1736,8851
5226,2017-4-13,Phoenix Suns,82,19830,3270,7260,0.45,615,1854,0.332,2655,5406,0.491,1676,2159,0.776,976,2712,3688,1604,673,1223,2030,8831
5227,2017-4-13,Toronto Raptors,82,19780,3211,6918,0.464,725,1996,0.363,2486,4922,0.505,1615,2028,0.796,871,2676,3547,1517,677,969,1708,8762
5228,2017-4-13,Oklahoma City Thunder,82,19805,3237,7169,0.452,692,2116,0.327,2545,5053,0.504,1575,2113,0.745,1002,2821,3823,1721,648,1199,1715,8741
5229,2017-4-13,Brooklyn Nets,82,19755,3102,6987,0.444,877,2591,0.338,2225,4396,0.506,1592,2020,0.788,721,2879,3600,1756,593,1307,1726,8673
5230,2017-4-13,Minnesota Timberwolves,82,19805,3235,6922,0.467,601,1723,0.349,2634,5199,0.507,1586,1986,0.799,938,2540,3478,1940,654,1099,1646,8657
5231,2017-4-13,San Antonio Spurs,82,19805,3222,6864,0.469,753,1927,0.391,2469,4937,0.5,1440,1806,0.797,821,2777,3598,1954,655,1057,1498,8637
5232,2017-4-13,Indiana Pacers,82,19855,3221,6931,0.465,709,1885,0.376,2512,5046,0.498,1467,1811,0.81,742,2702,3444,1844,669,1087,1597,8618
5233,2017-4-13,Charlotte Hornets,82,19830,3093,7000,0.442,824,2347,0.351,2269,4653,0.488,1591,1953,0.815,721,2853,3574,1891,571,899,1360,8601
5234,2017-4-13,Los Angeles Lakers,82,19705,3224,7164,0.45,730,2110,0.346,2494,5054,0.493,1397,1853,0.754,933,2636,3569,1716,674,1193,1698,8575
5235,2017-4-13,New Orleans Pelicans,82,19905,3210,7130,0.45,768,2196,0.35,2442,4934,0.495,1368,1825,0.75,703,2879,3582,1869,638,1012,1490,8556
5236,2017-4-13,New York Knicks,82,19855,3244,7256,0.447,704,2022,0.348,2540,5234,0.485,1364,1731,0.788,983,2723,3706,1786,581,1081,1668,8556
5237,2017-4-13,Milwaukee Bucks,82,19780,3182,6715,0.474,720,1946,0.37,2462,4769,0.516,1413,1839,0.768,723,2589,3312,1984,666,1096,1660,8497
5238,2017-4-13,Atlanta Hawks,82,19880,3123,6918,0.451,729,2137,0.341,2394,4781,0.501,1484,2039,0.728,842,2793,3635,1938,672,1249,1491,8459
5239,2017-4-13,Miami Heat,82,19780,3202,7037,0.455,808,2213,0.365,2394,4824,0.496,1248,1768,0.706,872,2705,3577,1742,588,1033,1680,8460
5240,2017-4-13,Chicago Bulls,82,19780,3169,7141,0.444,623,1831,0.34,2546,5310,0.479,1474,1848,0.798,999,2797,3796,1851,643,1065,1455,8435
5241,2017-4-13,Sacramento Kings,82,19880,3105,6734,0.461,737,1960,0.376,2368,4774,0.496,1483,1913,0.775,715,2652,3367,1844,627,1157,1667,8430
5242,2017-4-13,Philadelphia 76ers,82,19830,3088,6992,0.442,831,2443,0.34,2257,4549,0.496,1393,1806,0.771,807,2706,3513,1949,692,1310,1793,8400
5243,2017-4-13,Detroit Pistons,82,19805,3269,7282,0.449,631,1915,0.33,2638,5367,0.492,1140,1586,0.719,908,2838,3746,1732,574,932,1467,8309
5244,2017-4-13,Orlando Magic,82,19805,3139,7133,0.44,701,2139,0.328,2438,4994,0.488,1309,1753,0.747,807,2734,3541,1820,580,1053,1584,8288
5245,2017-4-13,Utah Jazz,82,19755,3033,6515,0.466,791,2128,0.372,2242,4387,0.511,1401,1875,0.747,771,2774,3545,1651,550,1060,1545,8258
5246,2017-4-13,Memphis Grizzlies,82,19905,2984,6854,0.435,767,2169,0.354,2217,4685,0.473,1504,1918,0.784,886,2621,3507,1744,653,1019,1840,8239
5247,2017-4-13,Dallas Mavericks,82,19780,2968,6750,0.44,878,2473,0.355,2090,4277,0.489,1215,1516,0.801,647,2516,3163,1705,614,921,1567,8029
5248,2017-4-14,Golden State Warriors,82,19780,3532,7140,0.495,982,2562,0.383,2550,4578,0.557,1457,1850,0.788,770,2873,3643,2491,785,1182,1585,9503
5249,2017-4-14,Houston Rockets,82,19780,3305,7152,0.462,1181,3306,0.357,2124,3846,0.552,1667,2177,0.766,892,2746,3638,2070,670,1188,1634,9458
5250,2017-4-14,Denver Nuggets,82,19755,3377,7194,0.469,870,2365,0.368,2507,4829,0.519,1537,1986,0.774,966,2837,3803,2077,568,1186,1567,9161
5251,2017-4-14,Cleveland Cavaliers,82,19880,3275,6963,0.47,1067,2779,0.384,2208,4184,0.528,1431,1913,0.748,766,2821,3587,1858,539,1081,1486,9048
5252,2017-4-14,Washington Wizards,82,19855,3388,7137,0.475,756,2030,0.372,2632,5107,0.515,1421,1812,0.784,843,2671,3514,1956,693,1103,1745,8953
5253,2017-4-14,Los Angeles Clippers,82,19755,3242,6820,0.475,841,2245,0.375,2401,4575,0.525,1586,2128,0.745,738,2790,3528,1848,612,1022,1626,8911
5254,2017-4-14,Boston Celtics,82,19755,3168,6978,0.454,985,2742,0.359,2183,4236,0.515,1536,1903,0.807,744,2698,3442,2069,617,1037,1686,8857
5255,2017-4-14,Portland Trail Blazers,82,19930,3243,7059,0.459,852,2272,0.375,2391,4787,0.499,1513,1940,0.78,830,2750,3580,1733,574,1077,1736,8851
5256,2017-4-14,Phoenix Suns,82,19830,3270,7260,0.45,615,1854,0.332,2655,5406,0.491,1676,2159,0.776,976,2712,3688,1604,673,1223,2030,8831
5257,2017-4-14,Toronto Raptors,82,19780,3211,6918,0.464,725,1996,0.363,2486,4922,0.505,1615,2028,0.796,871,2676,3547,1517,677,969,1708,8762
5258,2017-4-14,Oklahoma City Thunder,82,19805,3237,7169,0.452,692,2116,0.327,2545,5053,0.504,1575,2113,0.745,1002,2821,3823,1721,648,1199,1715,8741
5259,2017-4-14,Brooklyn Nets,82,19755,3102,6987,0.444,877,2591,0.338,2225,4396,0.506,1592,2020,0.788,721,2879,3600,1756,593,1307,1726,8673
5260,2017-4-14,Minnesota Timberwolves,82,19805,3235,6922,0.467,601,1723,0.349,2634,5199,0.507,1586,1986,0.799,938,2540,3478,1940,654,1099,1646,8657
5261,2017-4-14,San Antonio Spurs,82,19805,3222,6864,0.469,753,1927,0.391,2469,4937,0.5,1440,1806,0.797,821,2777,3598,1954,655,1057,1498,8637
5262,2017-4-14,Indiana Pacers,82,19855,3221,6931,0.465,709,1885,0.376,2512,5046,0.498,1467,1811,0.81,742,2702,3444,1844,669,1087,1597,8618
5263,2017-4-14,Charlotte Hornets,82,19830,3093,7000,0.442,824,2347,0.351,2269,4653,0.488,1591,1953,0.815,721,2853,3574,1891,571,899,1360,8601
5264,2017-4-14,Los Angeles Lakers,82,19705,3224,7164,0.45,730,2110,0.346,2494,5054,0.493,1397,1853,0.754,933,2636,3569,1716,674,1193,1698,8575
5265,2017-4-14,New Orleans Pelicans,82,19905,3210,7130,0.45,768,2196,0.35,2442,4934,0.495,1368,1825,0.75,703,2879,3582,1869,638,1012,1490,8556
5266,2017-4-14,New York Knicks,82,19855,3244,7256,0.447,704,2022,0.348,2540,5234,0.485,1364,1731,0.788,983,2723,3706,1786,581,1081,1668,8556
5267,2017-4-14,Milwaukee Bucks,82,19780,3182,6715,0.474,720,1946,0.37,2462,4769,0.516,1413,1839,0.768,723,2589,3312,1984,666,1096,1660,8497
5268,2017-4-14,Atlanta Hawks,82,19880,3123,6918,0.451,729,2137,0.341,2394,4781,0.501,1484,2039,0.728,842,2793,3635,1938,672,1249,1491,8459
5269,2017-4-14,Miami Heat,82,19780,3202,7037,0.455,808,2213,0.365,2394,4824,0.496,1248,1768,0.706,872,2705,3577,1742,588,1033,1680,8460
5270,2017-4-14,Chicago Bulls,82,19780,3169,7141,0.444,623,1831,0.34,2546,5310,0.479,1474,1848,0.798,999,2797,3796,1851,643,1065,1455,8435
5271,2017-4-14,Sacramento Kings,82,19880,3105,6734,0.461,737,1960,0.376,2368,4774,0.496,1483,1913,0.775,715,2652,3367,1844,627,1157,1667,8430
5272,2017-4-14,Philadelphia 76ers,82,19830,3088,6992,0.442,831,2443,0.34,2257,4549,0.496,1393,1806,0.771,807,2706,3513,1949,692,1310,1793,8400
5273,2017-4-14,Detroit Pistons,82,19805,3269,7282,0.449,631,1915,0.33,2638,5367,0.492,1140,1586,0.719,908,2838,3746,1732,574,932,1467,8309
5274,2017-4-14,Orlando Magic,82,19805,3139,7133,0.44,701,2139,0.328,2438,4994,0.488,1309,1753,0.747,807,2734,3541,1820,580,1053,1584,8288
5275,2017-4-14,Utah Jazz,82,19755,3033,6515,0.466,791,2128,0.372,2242,4387,0.511,1401,1875,0.747,771,2774,3545,1651,550,1060,1545,8258
5276,2017-4-14,Memphis Grizzlies,82,19905,2984,6854,0.435,767,2169,0.354,2217,4685,0.473,1504,1918,0.784,886,2621,3507,1744,653,1019,1840,8239
5277,2017-4-14,Dallas Mavericks,82,19780,2968,6750,0.44,878,2473,0.355,2090,4277,0.489,1215,1516,0.801,647,2516,3163,1705,614,921,1567,8029
5278,2017-4-15,Golden State Warriors,82,19780,3532,7140,0.495,982,2562,0.383,2550,4578,0.557,1457,1850,0.788,770,2873,3643,2491,785,1182,1585,9503
5279,2017-4-15,Houston Rockets,82,19780,3305,7152,0.462,1181,3306,0.357,2124,3846,0.552,1667,2177,0.766,892,2746,3638,2070,670,1188,1634,9458
5280,2017-4-15,Denver Nuggets,82,19755,3377,7194,0.469,870,2365,0.368,2507,4829,0.519,1537,1986,0.774,966,2837,3803,2077,568,1186,1567,9161
5281,2017-4-15,Cleveland Cavaliers,82,19880,3275,6963,0.47,1067,2779,0.384,2208,4184,0.528,1431,1913,0.748,766,2821,3587,1858,539,1081,1486,9048
5282,2017-4-15,Washington Wizards,82,19855,3388,7137,0.475,756,2030,0.372,2632,5107,0.515,1421,1812,0.784,843,2671,3514,1956,693,1103,1745,8953
5283,2017-4-15,Los Angeles Clippers,82,19755,3242,6820,0.475,841,2245,0.375,2401,4575,0.525,1586,2128,0.745,738,2790,3528,1848,612,1022,1626,8911
5284,2017-4-15,Boston Celtics,82,19755,3168,6978,0.454,985,2742,0.359,2183,4236,0.515,1536,1903,0.807,744,2698,3442,2069,617,1037,1686,8857
5285,2017-4-15,Portland Trail Blazers,82,19930,3243,7059,0.459,852,2272,0.375,2391,4787,0.499,1513,1940,0.78,830,2750,3580,1733,574,1077,1736,8851
5286,2017-4-15,Phoenix Suns,82,19830,3270,7260,0.45,615,1854,0.332,2655,5406,0.491,1676,2159,0.776,976,2712,3688,1604,673,1223,2030,8831
5287,2017-4-15,Toronto Raptors,82,19780,3211,6918,0.464,725,1996,0.363,2486,4922,0.505,1615,2028,0.796,871,2676,3547,1517,677,969,1708,8762
5288,2017-4-15,Oklahoma City Thunder,82,19805,3237,7169,0.452,692,2116,0.327,2545,5053,0.504,1575,2113,0.745,1002,2821,3823,1721,648,1199,1715,8741
5289,2017-4-15,Brooklyn Nets,82,19755,3102,6987,0.444,877,2591,0.338,2225,4396,0.506,1592,2020,0.788,721,2879,3600,1756,593,1307,1726,8673
5290,2017-4-15,Minnesota Timberwolves,82,19805,3235,6922,0.467,601,1723,0.349,2634,5199,0.507,1586,1986,0.799,938,2540,3478,1940,654,1099,1646,8657
5291,2017-4-15,San Antonio Spurs,82,19805,3222,6864,0.469,753,1927,0.391,2469,4937,0.5,1440,1806,0.797,821,2777,3598,1954,655,1057,1498,8637
5292,2017-4-15,Indiana Pacers,82,19855,3221,6931,0.465,709,1885,0.376,2512,5046,0.498,1467,1811,0.81,742,2702,3444,1844,669,1087,1597,8618
5293,2017-4-15,Charlotte Hornets,82,19830,3093,7000,0.442,824,2347,0.351,2269,4653,0.488,1591,1953,0.815,721,2853,3574,1891,571,899,1360,8601
5294,2017-4-15,Los Angeles Lakers,82,19705,3224,7164,0.45,730,2110,0.346,2494,5054,0.493,1397,1853,0.754,933,2636,3569,1716,674,1193,1698,8575
5295,2017-4-15,New Orleans Pelicans,82,19905,3210,7130,0.45,768,2196,0.35,2442,4934,0.495,1368,1825,0.75,703,2879,3582,1869,638,1012,1490,8556
5296,2017-4-15,New York Knicks,82,19855,3244,7256,0.447,704,2022,0.348,2540,5234,0.485,1364,1731,0.788,983,2723,3706,1786,581,1081,1668,8556
5297,2017-4-15,Milwaukee Bucks,82,19780,3182,6715,0.474,720,1946,0.37,2462,4769,0.516,1413,1839,0.768,723,2589,3312,1984,666,1096,1660,8497
5298,2017-4-15,Atlanta Hawks,82,19880,3123,6918,0.451,729,2137,0.341,2394,4781,0.501,1484,2039,0.728,842,2793,3635,1938,672,1249,1491,8459
5299,2017-4-15,Miami Heat,82,19780,3202,7037,0.455,808,2213,0.365,2394,4824,0.496,1248,1768,0.706,872,2705,3577,1742,588,1033,1680,8460
5300,2017-4-15,Chicago Bulls,82,19780,3169,7141,0.444,623,1831,0.34,2546,5310,0.479,1474,1848,0.798,999,2797,3796,1851,643,1065,1455,8435
5301,2017-4-15,Sacramento Kings,82,19880,3105,6734,0.461,737,1960,0.376,2368,4774,0.496,1483,1913,0.775,715,2652,3367,1844,627,1157,1667,8430
5302,2017-4-15,Philadelphia 76ers,82,19830,3088,6992,0.442,831,2443,0.34,2257,4549,0.496,1393,1806,0.771,807,2706,3513,1949,692,1310,1793,8400
5303,2017-4-15,Detroit Pistons,82,19805,3269,7282,0.449,631,1915,0.33,2638,5367,0.492,1140,1586,0.719,908,2838,3746,1732,574,932,1467,8309
5304,2017-4-15,Orlando Magic,82,19805,3139,7133,0.44,701,2139,0.328,2438,4994,0.488,1309,1753,0.747,807,2734,3541,1820,580,1053,1584,8288
5305,2017-4-15,Utah Jazz,82,19755,3033,6515,0.466,791,2128,0.372,2242,4387,0.511,1401,1875,0.747,771,2774,3545,1651,550,1060,1545,8258
5306,2017-4-15,Memphis Grizzlies,82,19905,2984,6854,0.435,767,2169,0.354,2217,4685,0.473,1504,1918,0.784,886,2621,3507,1744,653,1019,1840,8239
5307,2017-4-15,Dallas Mavericks,82,19780,2968,6750,0.44,878,2473,0.355,2090,4277,0.489,1215,1516,0.801,647,2516,3163,1705,614,921,1567,8029
5308,2017-4-16,Golden State Warriors,82,19780,3532,7140,0.495,982,2562,0.383,2550,4578,0.557,1457,1850,0.788,770,2873,3643,2491,785,1182,1585,9503
5309,2017-4-16,Houston Rockets,82,19780,3305,7152,0.462,1181,3306,0.357,2124,3846,0.552,1667,2177,0.766,892,2746,3638,2070,670,1188,1634,9458
5310,2017-4-16,Denver Nuggets,82,19755,3377,7194,0.469,870,2365,0.368,2507,4829,0.519,1537,1986,0.774,966,2837,3803,2077,568,1186,1567,9161
5311,2017-4-16,Cleveland Cavaliers,82,19880,3275,6963,0.47,1067,2779,0.384,2208,4184,0.528,1431,1913,0.748,766,2821,3587,1858,539,1081,1486,9048
5312,2017-4-16,Washington Wizards,82,19855,3388,7137,0.475,756,2030,0.372,2632,5107,0.515,1421,1812,0.784,843,2671,3514,1956,693,1103,1745,8953
5313,2017-4-16,Los Angeles Clippers,82,19755,3242,6820,0.475,841,2245,0.375,2401,4575,0.525,1586,2128,0.745,738,2790,3528,1848,612,1022,1626,8911
5314,2017-4-16,Boston Celtics,82,19755,3168,6978,0.454,985,2742,0.359,2183,4236,0.515,1536,1903,0.807,744,2698,3442,2069,617,1037,1686,8857
5315,2017-4-16,Portland Trail Blazers,82,19930,3243,7059,0.459,852,2272,0.375,2391,4787,0.499,1513,1940,0.78,830,2750,3580,1733,574,1077,1736,8851
5316,2017-4-16,Phoenix Suns,82,19830,3270,7260,0.45,615,1854,0.332,2655,5406,0.491,1676,2159,0.776,976,2712,3688,1604,673,1223,2030,8831
5317,2017-4-16,Toronto Raptors,82,19780,3211,6918,0.464,725,1996,0.363,2486,4922,0.505,1615,2028,0.796,871,2676,3547,1517,677,969,1708,8762
5318,2017-4-16,Oklahoma City Thunder,82,19805,3237,7169,0.452,692,2116,0.327,2545,5053,0.504,1575,2113,0.745,1002,2821,3823,1721,648,1199,1715,8741
5319,2017-4-16,Brooklyn Nets,82,19755,3102,6987,0.444,877,2591,0.338,2225,4396,0.506,1592,2020,0.788,721,2879,3600,1756,593,1307,1726,8673
5320,2017-4-16,Minnesota Timberwolves,82,19805,3235,6922,0.467,601,1723,0.349,2634,5199,0.507,1586,1986,0.799,938,2540,3478,1940,654,1099,1646,8657
5321,2017-4-16,San Antonio Spurs,82,19805,3222,6864,0.469,753,1927,0.391,2469,4937,0.5,1440,1806,0.797,821,2777,3598,1954,655,1057,1498,8637
5322,2017-4-16,Indiana Pacers,82,19855,3221,6931,0.465,709,1885,0.376,2512,5046,0.498,1467,1811,0.81,742,2702,3444,1844,669,1087,1597,8618
5323,2017-4-16,Charlotte Hornets,82,19830,3093,7000,0.442,824,2347,0.351,2269,4653,0.488,1591,1953,0.815,721,2853,3574,1891,571,899,1360,8601
5324,2017-4-16,Los Angeles Lakers,82,19705,3224,7164,0.45,730,2110,0.346,2494,5054,0.493,1397,1853,0.754,933,2636,3569,1716,674,1193,1698,8575
5325,2017-4-16,New Orleans Pelicans,82,19905,3210,7130,0.45,768,2196,0.35,2442,4934,0.495,1368,1825,0.75,703,2879,3582,1869,638,1012,1490,8556
5326,2017-4-16,New York Knicks,82,19855,3244,7256,0.447,704,2022,0.348,2540,5234,0.485,1364,1731,0.788,983,2723,3706,1786,581,1081,1668,8556
5327,2017-4-16,Milwaukee Bucks,82,19780,3182,6715,0.474,720,1946,0.37,2462,4769,0.516,1413,1839,0.768,723,2589,3312,1984,666,1096,1660,8497
5328,2017-4-16,Atlanta Hawks,82,19880,3123,6918,0.451,729,2137,0.341,2394,4781,0.501,1484,2039,0.728,842,2793,3635,1938,672,1249,1491,8459
5329,2017-4-16,Miami Heat,82,19780,3202,7037,0.455,808,2213,0.365,2394,4824,0.496,1248,1768,0.706,872,2705,3577,1742,588,1033,1680,8460
5330,2017-4-16,Chicago Bulls,82,19780,3169,7141,0.444,623,1831,0.34,2546,5310,0.479,1474,1848,0.798,999,2797,3796,1851,643,1065,1455,8435
5331,2017-4-16,Sacramento Kings,82,19880,3105,6734,0.461,737,1960,0.376,2368,4774,0.496,1483,1913,0.775,715,2652,3367,1844,627,1157,1667,8430
5332,2017-4-16,Philadelphia 76ers,82,19830,3088,6992,0.442,831,2443,0.34,2257,4549,0.496,1393,1806,0.771,807,2706,3513,1949,692,1310,1793,8400
5333,2017-4-16,Detroit Pistons,82,19805,3269,7282,0.449,631,1915,0.33,2638,5367,0.492,1140,1586,0.719,908,2838,3746,1732,574,932,1467,8309
5334,2017-4-16,Orlando Magic,82,19805,3139,7133,0.44,701,2139,0.328,2438,4994,0.488,1309,1753,0.747,807,2734,3541,1820,580,1053,1584,8288
5335,2017-4-16,Utah Jazz,82,19755,3033,6515,0.466,791,2128,0.372,2242,4387,0.511,1401,1875,0.747,771,2774,3545,1651,550,1060,1545,8258
5336,2017-4-16,Memphis Grizzlies,82,19905,2984,6854,0.435,767,2169,0.354,2217,4685,0.473,1504,1918,0.784,886,2621,3507,1744,653,1019,1840,8239
5337,2017-4-16,Dallas Mavericks,82,19780,2968,6750,0.44,878,2473,0.355,2090,4277,0.489,1215,1516,0.801,647,2516,3163,1705,614,921,1567,8029
5338,2017-4-17,Golden State Warriors,82,19780,3532,7140,0.495,982,2562,0.383,2550,4578,0.557,1457,1850,0.788,770,2873,3643,2491,785,1182,1585,9503
5339,2017-4-17,Houston Rockets,82,19780,3305,7152,0.462,1181,3306,0.357,2124,3846,0.552,1667,2177,0.766,892,2746,3638,2070,670,1188,1634,9458
5340,2017-4-17,Denver Nuggets,82,19755,3377,7194,0.469,870,2365,0.368,2507,4829,0.519,1537,1986,0.774,966,2837,3803,2077,568,1186,1567,9161
5341,2017-4-17,Cleveland Cavaliers,82,19880,3275,6963,0.47,1067,2779,0.384,2208,4184,0.528,1431,1913,0.748,766,2821,3587,1858,539,1081,1486,9048
5342,2017-4-17,Washington Wizards,82,19855,3388,7137,0.475,756,2030,0.372,2632,5107,0.515,1421,1812,0.784,843,2671,3514,1956,693,1103,1745,8953
5343,2017-4-17,Los Angeles Clippers,82,19755,3242,6820,0.475,841,2245,0.375,2401,4575,0.525,1586,2128,0.745,738,2790,3528,1848,612,1022,1626,8911
5344,2017-4-17,Boston Celtics,82,19755,3168,6978,0.454,985,2742,0.359,2183,4236,0.515,1536,1903,0.807,744,2698,3442,2069,617,1037,1686,8857
5345,2017-4-17,Portland Trail Blazers,82,19930,3243,7059,0.459,852,2272,0.375,2391,4787,0.499,1513,1940,0.78,830,2750,3580,1733,574,1077,1736,8851
5346,2017-4-17,Phoenix Suns,82,19830,3270,7260,0.45,615,1854,0.332,2655,5406,0.491,1676,2159,0.776,976,2712,3688,1604,673,1223,2030,8831
5347,2017-4-17,Toronto Raptors,82,19780,3211,6918,0.464,725,1996,0.363,2486,4922,0.505,1615,2028,0.796,871,2676,3547,1517,677,969,1708,8762
5348,2017-4-17,Oklahoma City Thunder,82,19805,3237,7169,0.452,692,2116,0.327,2545,5053,0.504,1575,2113,0.745,1002,2821,3823,1721,648,1199,1715,8741
5349,2017-4-17,Brooklyn Nets,82,19755,3102,6987,0.444,877,2591,0.338,2225,4396,0.506,1592,2020,0.788,721,2879,3600,1756,593,1307,1726,8673
5350,2017-4-17,Minnesota Timberwolves,82,19805,3235,6922,0.467,601,1723,0.349,2634,5199,0.507,1586,1986,0.799,938,2540,3478,1940,654,1099,1646,8657
5351,2017-4-17,San Antonio Spurs,82,19805,3222,6864,0.469,753,1927,0.391,2469,4937,0.5,1440,1806,0.797,821,2777,3598,1954,655,1057,1498,8637
5352,2017-4-17,Indiana Pacers,82,19855,3221,6931,0.465,709,1885,0.376,2512,5046,0.498,1467,1811,0.81,742,2702,3444,1844,669,1087,1597,8618
5353,2017-4-17,Charlotte Hornets,82,19830,3093,7000,0.442,824,2347,0.351,2269,4653,0.488,1591,1953,0.815,721,2853,3574,1891,571,899,1360,8601
5354,2017-4-17,Los Angeles Lakers,82,19705,3224,7164,0.45,730,2110,0.346,2494,5054,0.493,1397,1853,0.754,933,2636,3569,1716,674,1193,1698,8575
5355,2017-4-17,New Orleans Pelicans,82,19905,3210,7130,0.45,768,2196,0.35,2442,4934,0.495,1368,1825,0.75,703,2879,3582,1869,638,1012,1490,8556
5356,2017-4-17,New York Knicks,82,19855,3244,7256,0.447,704,2022,0.348,2540,5234,0.485,1364,1731,0.788,983,2723,3706,1786,581,1081,1668,8556
5357,2017-4-17,Milwaukee Bucks,82,19780,3182,6715,0.474,720,1946,0.37,2462,4769,0.516,1413,1839,0.768,723,2589,3312,1984,666,1096,1660,8497
5358,2017-4-17,Atlanta Hawks,82,19880,3123,6918,0.451,729,2137,0.341,2394,4781,0.501,1484,2039,0.728,842,2793,3635,1938,672,1249,1491,8459
5359,2017-4-17,Miami Heat,82,19780,3202,7037,0.455,808,2213,0.365,2394,4824,0.496,1248,1768,0.706,872,2705,3577,1742,588,1033,1680,8460
5360,2017-4-17,Chicago Bulls,82,19780,3169,7141,0.444,623,1831,0.34,2546,5310,0.479,1474,1848,0.798,999,2797,3796,1851,643,1065,1455,8435
5361,2017-4-17,Sacramento Kings,82,19880,3105,6734,0.461,737,1960,0.376,2368,4774,0.496,1483,1913,0.775,715,2652,3367,1844,627,1157,1667,8430
5362,2017-4-17,Philadelphia 76ers,82,19830,3088,6992,0.442,831,2443,0.34,2257,4549,0.496,1393,1806,0.771,807,2706,3513,1949,692,1310,1793,8400
5363,2017-4-17,Detroit Pistons,82,19805,3269,7282,0.449,631,1915,0.33,2638,5367,0.492,1140,1586,0.719,908,2838,3746,1732,574,932,1467,8309
5364,2017-4-17,Orlando Magic,82,19805,3139,7133,0.44,701,2139,0.328,2438,4994,0.488,1309,1753,0.747,807,2734,3541,1820,580,1053,1584,8288
5365,2017-4-17,Utah Jazz,82,19755,3033,6515,0.466,791,2128,0.372,2242,4387,0.511,1401,1875,0.747,771,2774,3545,1651,550,1060,1545,8258
5366,2017-4-17,Memphis Grizzlies,82,19905,2984,6854,0.435,767,2169,0.354,2217,4685,0.473,1504,1918,0.784,886,2621,3507,1744,653,1019,1840,8239
5367,2017-4-17,Dallas Mavericks,82,19780,2968,6750,0.44,878,2473,0.355,2090,4277,0.489,1215,1516,0.801,647,2516,3163,1705,614,921,1567,8029
5368,2017-4-18,Golden State Warriors,82,19780,3532,7140,0.495,982,2562,0.383,2550,4578,0.557,1457,1850,0.788,770,2873,3643,2491,785,1182,1585,9503
5369,2017-4-18,Houston Rockets,82,19780,3305,7152,0.462,1181,3306,0.357,2124,3846,0.552,1667,2177,0.766,892,2746,3638,2070,670,1188,1634,9458
5370,2017-4-18,Denver Nuggets,82,19755,3377,7194,0.469,870,2365,0.368,2507,4829,0.519,1537,1986,0.774,966,2837,3803,2077,568,1186,1567,9161
5371,2017-4-18,Cleveland Cavaliers,82,19880,3275,6963,0.47,1067,2779,0.384,2208,4184,0.528,1431,1913,0.748,766,2821,3587,1858,539,1081,1486,9048
5372,2017-4-18,Washington Wizards,82,19855,3388,7137,0.475,756,2030,0.372,2632,5107,0.515,1421,1812,0.784,843,2671,3514,1956,693,1103,1745,8953
5373,2017-4-18,Los Angeles Clippers,82,19755,3242,6820,0.475,841,2245,0.375,2401,4575,0.525,1586,2128,0.745,738,2790,3528,1848,612,1022,1626,8911
5374,2017-4-18,Boston Celtics,82,19755,3168,6978,0.454,985,2742,0.359,2183,4236,0.515,1536,1903,0.807,744,2698,3442,2069,617,1037,1686,8857
5375,2017-4-18,Portland Trail Blazers,82,19930,3243,7059,0.459,852,2272,0.375,2391,4787,0.499,1513,1940,0.78,830,2750,3580,1733,574,1077,1736,8851
5376,2017-4-18,Phoenix Suns,82,19830,3270,7260,0.45,615,1854,0.332,2655,5406,0.491,1676,2159,0.776,976,2712,3688,1604,673,1223,2030,8831
5377,2017-4-18,Toronto Raptors,82,19780,3211,6918,0.464,725,1996,0.363,2486,4922,0.505,1615,2028,0.796,871,2676,3547,1517,677,969,1708,8762
5378,2017-4-18,Oklahoma City Thunder,82,19805,3237,7169,0.452,692,2116,0.327,2545,5053,0.504,1575,2113,0.745,1002,2821,3823,1721,648,1199,1715,8741
5379,2017-4-18,Brooklyn Nets,82,19755,3102,6987,0.444,877,2591,0.338,2225,4396,0.506,1592,2020,0.788,721,2879,3600,1756,593,1307,1726,8673
5380,2017-4-18,Minnesota Timberwolves,82,19805,3235,6922,0.467,601,1723,0.349,2634,5199,0.507,1586,1986,0.799,938,2540,3478,1940,654,1099,1646,8657
5381,2017-4-18,San Antonio Spurs,82,19805,3222,6864,0.469,753,1927,0.391,2469,4937,0.5,1440,1806,0.797,821,2777,3598,1954,655,1057,1498,8637
5382,2017-4-18,Indiana Pacers,82,19855,3221,6931,0.465,709,1885,0.376,2512,5046,0.498,1467,1811,0.81,742,2702,3444,1844,669,1087,1597,8618
5383,2017-4-18,Charlotte Hornets,82,19830,3093,7000,0.442,824,2347,0.351,2269,4653,0.488,1591,1953,0.815,721,2853,3574,1891,571,899,1360,8601
5384,2017-4-18,Los Angeles Lakers,82,19705,3224,7164,0.45,730,2110,0.346,2494,5054,0.493,1397,1853,0.754,933,2636,3569,1716,674,1193,1698,8575
5385,2017-4-18,New Orleans Pelicans,82,19905,3210,7130,0.45,768,2196,0.35,2442,4934,0.495,1368,1825,0.75,703,2879,3582,1869,638,1012,1490,8556
5386,2017-4-18,New York Knicks,82,19855,3244,7256,0.447,704,2022,0.348,2540,5234,0.485,1364,1731,0.788,983,2723,3706,1786,581,1081,1668,8556
5387,2017-4-18,Milwaukee Bucks,82,19780,3182,6715,0.474,720,1946,0.37,2462,4769,0.516,1413,1839,0.768,723,2589,3312,1984,666,1096,1660,8497
5388,2017-4-18,Atlanta Hawks,82,19880,3123,6918,0.451,729,2137,0.341,2394,4781,0.501,1484,2039,0.728,842,2793,3635,1938,672,1249,1491,8459
5389,2017-4-18,Miami Heat,82,19780,3202,7037,0.455,808,2213,0.365,2394,4824,0.496,1248,1768,0.706,872,2705,3577,1742,588,1033,1680,8460
5390,2017-4-18,Chicago Bulls,82,19780,3169,7141,0.444,623,1831,0.34,2546,5310,0.479,1474,1848,0.798,999,2797,3796,1851,643,1065,1455,8435
5391,2017-4-18,Sacramento Kings,82,19880,3105,6734,0.461,737,1960,0.376,2368,4774,0.496,1483,1913,0.775,715,2652,3367,1844,627,1157,1667,8430
5392,2017-4-18,Philadelphia 76ers,82,19830,3088,6992,0.442,831,2443,0.34,2257,4549,0.496,1393,1806,0.771,807,2706,3513,1949,692,1310,1793,8400
5393,2017-4-18,Detroit Pistons,82,19805,3269,7282,0.449,631,1915,0.33,2638,5367,0.492,1140,1586,0.719,908,2838,3746,1732,574,932,1467,8309
5394,2017-4-18,Orlando Magic,82,19805,3139,7133,0.44,701,2139,0.328,2438,4994,0.488,1309,1753,0.747,807,2734,3541,1820,580,1053,1584,8288
5395,2017-4-18,Utah Jazz,82,19755,3033,6515,0.466,791,2128,0.372,2242,4387,0.511,1401,1875,0.747,771,2774,3545,1651,550,1060,1545,8258
5396,2017-4-18,Memphis Grizzlies,82,19905,2984,6854,0.435,767,2169,0.354,2217,4685,0.473,1504,1918,0.784,886,2621,3507,1744,653,1019,1840,8239
5397,2017-4-18,Dallas Mavericks,82,19780,2968,6750,0.44,878,2473,0.355,2090,4277,0.489,1215,1516,0.801,647,2516,3163,1705,614,921,1567,8029
5398,2017-4-19,Golden State Warriors,82,19780,3532,7140,0.495,982,2562,0.383,2550,4578,0.557,1457,1850,0.788,770,2873,3643,2491,785,1182,1585,9503
5399,2017-4-19,Houston Rockets,82,19780,3305,7152,0.462,1181,3306,0.357,2124,3846,0.552,1667,2177,0.766,892,2746,3638,2070,670,1188,1634,9458
5400,2017-4-19,Denver Nuggets,82,19755,3377,7194,0.469,870,2365,0.368,2507,4829,0.519,1537,1986,0.774,966,2837,3803,2077,568,1186,1567,9161
5401,2017-4-19,Cleveland Cavaliers,82,19880,3275,6963,0.47,1067,2779,0.384,2208,4184,0.528,1431,1913,0.748,766,2821,3587,1858,539,1081,1486,9048
5402,2017-4-19,Washington Wizards,82,19855,3388,7137,0.475,756,2030,0.372,2632,5107,0.515,1421,1812,0.784,843,2671,3514,1956,693,1103,1745,8953
5403,2017-4-19,Los Angeles Clippers,82,19755,3242,6820,0.475,841,2245,0.375,2401,4575,0.525,1586,2128,0.745,738,2790,3528,1848,612,1022,1626,8911
5404,2017-4-19,Boston Celtics,82,19755,3168,6978,0.454,985,2742,0.359,2183,4236,0.515,1536,1903,0.807,744,2698,3442,2069,617,1037,1686,8857
5405,2017-4-19,Portland Trail Blazers,82,19930,3243,7059,0.459,852,2272,0.375,2391,4787,0.499,1513,1940,0.78,830,2750,3580,1733,574,1077,1736,8851
5406,2017-4-19,Phoenix Suns,82,19830,3270,7260,0.45,615,1854,0.332,2655,5406,0.491,1676,2159,0.776,976,2712,3688,1604,673,1223,2030,8831
5407,2017-4-19,Toronto Raptors,82,19780,3211,6918,0.464,725,1996,0.363,2486,4922,0.505,1615,2028,0.796,871,2676,3547,1517,677,969,1708,8762
5408,2017-4-19,Oklahoma City Thunder,82,19805,3237,7169,0.452,692,2116,0.327,2545,5053,0.504,1575,2113,0.745,1002,2821,3823,1721,648,1199,1715,8741
5409,2017-4-19,Brooklyn Nets,82,19755,3102,6987,0.444,877,2591,0.338,2225,4396,0.506,1592,2020,0.788,721,2879,3600,1756,593,1307,1726,8673
5410,2017-4-19,Minnesota Timberwolves,82,19805,3235,6922,0.467,601,1723,0.349,2634,5199,0.507,1586,1986,0.799,938,2540,3478,1940,654,1099,1646,8657
5411,2017-4-19,San Antonio Spurs,82,19805,3222,6864,0.469,753,1927,0.391,2469,4937,0.5,1440,1806,0.797,821,2777,3598,1954,655,1057,1498,8637
5412,2017-4-19,Indiana Pacers,82,19855,3221,6931,0.465,709,1885,0.376,2512,5046,0.498,1467,1811,0.81,742,2702,3444,1844,669,1087,1597,8618
5413,2017-4-19,Charlotte Hornets,82,19830,3093,7000,0.442,824,2347,0.351,2269,4653,0.488,1591,1953,0.815,721,2853,3574,1891,571,899,1360,8601
5414,2017-4-19,Los Angeles Lakers,82,19705,3224,7164,0.45,730,2110,0.346,2494,5054,0.493,1397,1853,0.754,933,2636,3569,1716,674,1193,1698,8575
5415,2017-4-19,New Orleans Pelicans,82,19905,3210,7130,0.45,768,2196,0.35,2442,4934,0.495,1368,1825,0.75,703,2879,3582,1869,638,1012,1490,8556
5416,2017-4-19,New York Knicks,82,19855,3244,7256,0.447,704,2022,0.348,2540,5234,0.485,1364,1731,0.788,983,2723,3706,1786,581,1081,1668,8556
5417,2017-4-19,Milwaukee Bucks,82,19780,3182,6715,0.474,720,1946,0.37,2462,4769,0.516,1413,1839,0.768,723,2589,3312,1984,666,1096,1660,8497
5418,2017-4-19,Atlanta Hawks,82,19880,3123,6918,0.451,729,2137,0.341,2394,4781,0.501,1484,2039,0.728,842,2793,3635,1938,672,1249,1491,8459
5419,2017-4-19,Miami Heat,82,19780,3202,7037,0.455,808,2213,0.365,2394,4824,0.496,1248,1768,0.706,872,2705,3577,1742,588,1033,1680,8460
5420,2017-4-19,Chicago Bulls,82,19780,3169,7141,0.444,623,1831,0.34,2546,5310,0.479,1474,1848,0.798,999,2797,3796,1851,643,1065,1455,8435
5421,2017-4-19,Sacramento Kings,82,19880,3105,6734,0.461,737,1960,0.376,2368,4774,0.496,1483,1913,0.775,715,2652,3367,1844,627,1157,1667,8430
5422,2017-4-19,Philadelphia 76ers,82,19830,3088,6992,0.442,831,2443,0.34,2257,4549,0.496,1393,1806,0.771,807,2706,3513,1949,692,1310,1793,8400
5423,2017-4-19,Detroit Pistons,82,19805,3269,7282,0.449,631,1915,0.33,2638,5367,0.492,1140,1586,0.719,908,2838,3746,1732,574,932,1467,8309
5424,2017-4-19,Orlando Magic,82,19805,3139,7133,0.44,701,2139,0.328,2438,4994,0.488,1309,1753,0.747,807,2734,3541,1820,580,1053,1584,8288
5425,2017-4-19,Utah Jazz,82,19755,3033,6515,0.466,791,2128,0.372,2242,4387,0.511,1401,1875,0.747,771,2774,3545,1651,550,1060,1545,8258
5426,2017-4-19,Memphis Grizzlies,82,19905,2984,6854,0.435,767,2169,0.354,2217,4685,0.473,1504,1918,0.784,886,2621,3507,1744,653,1019,1840,8239
5427,2017-4-19,Dallas Mavericks,82,19780,2968,6750,0.44,878,2473,0.355,2090,4277,0.489,1215,1516,0.801,647,2516,3163,1705,614,921,1567,8029
5428,2017-4-20,Golden State Warriors,82,19780,3532,7140,0.495,982,2562,0.383,2550,4578,0.557,1457,1850,0.788,770,2873,3643,2491,785,1182,1585,9503
5429,2017-4-20,Houston Rockets,82,19780,3305,7152,0.462,1181,3306,0.357,2124,3846,0.552,1667,2177,0.766,892,2746,3638,2070,670,1188,1634,9458
5430,2017-4-20,Denver Nuggets,82,19755,3377,7194,0.469,870,2365,0.368,2507,4829,0.519,1537,1986,0.774,966,2837,3803,2077,568,1186,1567,9161
5431,2017-4-20,Cleveland Cavaliers,82,19880,3275,6963,0.47,1067,2779,0.384,2208,4184,0.528,1431,1913,0.748,766,2821,3587,1858,539,1081,1486,9048
5432,2017-4-20,Washington Wizards,82,19855,3388,7137,0.475,756,2030,0.372,2632,5107,0.515,1421,1812,0.784,843,2671,3514,1956,693,1103,1745,8953
5433,2017-4-20,Los Angeles Clippers,82,19755,3242,6820,0.475,841,2245,0.375,2401,4575,0.525,1586,2128,0.745,738,2790,3528,1848,612,1022,1626,8911
5434,2017-4-20,Boston Celtics,82,19755,3168,6978,0.454,985,2742,0.359,2183,4236,0.515,1536,1903,0.807,744,2698,3442,2069,617,1037,1686,8857
5435,2017-4-20,Portland Trail Blazers,82,19930,3243,7059,0.459,852,2272,0.375,2391,4787,0.499,1513,1940,0.78,830,2750,3580,1733,574,1077,1736,8851
5436,2017-4-20,Phoenix Suns,82,19830,3270,7260,0.45,615,1854,0.332,2655,5406,0.491,1676,2159,0.776,976,2712,3688,1604,673,1223,2030,8831
5437,2017-4-20,Toronto Raptors,82,19780,3211,6918,0.464,725,1996,0.363,2486,4922,0.505,1615,2028,0.796,871,2676,3547,1517,677,969,1708,8762
5438,2017-4-20,Oklahoma City Thunder,82,19805,3237,7169,0.452,692,2116,0.327,2545,5053,0.504,1575,2113,0.745,1002,2821,3823,1721,648,1199,1715,8741
5439,2017-4-20,Brooklyn Nets,82,19755,3102,6987,0.444,877,2591,0.338,2225,4396,0.506,1592,2020,0.788,721,2879,3600,1756,593,1307,1726,8673
5440,2017-4-20,Minnesota Timberwolves,82,19805,3235,6922,0.467,601,1723,0.349,2634,5199,0.507,1586,1986,0.799,938,2540,3478,1940,654,1099,1646,8657
5441,2017-4-20,San Antonio Spurs,82,19805,3222,6864,0.469,753,1927,0.391,2469,4937,0.5,1440,1806,0.797,821,2777,3598,1954,655,1057,1498,8637
5442,2017-4-20,Indiana Pacers,82,19855,3221,6931,0.465,709,1885,0.376,2512,5046,0.498,1467,1811,0.81,742,2702,3444,1844,669,1087,1597,8618
5443,2017-4-20,Charlotte Hornets,82,19830,3093,7000,0.442,824,2347,0.351,2269,4653,0.488,1591,1953,0.815,721,2853,3574,1891,571,899,1360,8601
5444,2017-4-20,Los Angeles Lakers,82,19705,3224,7164,0.45,730,2110,0.346,2494,5054,0.493,1397,1853,0.754,933,2636,3569,1716,674,1193,1698,8575
5445,2017-4-20,New Orleans Pelicans,82,19905,3210,7130,0.45,768,2196,0.35,2442,4934,0.495,1368,1825,0.75,703,2879,3582,1869,638,1012,1490,8556
5446,2017-4-20,New York Knicks,82,19855,3244,7256,0.447,704,2022,0.348,2540,5234,0.485,1364,1731,0.788,983,2723,3706,1786,581,1081,1668,8556
5447,2017-4-20,Milwaukee Bucks,82,19780,3182,6715,0.474,720,1946,0.37,2462,4769,0.516,1413,1839,0.768,723,2589,3312,1984,666,1096,1660,8497
5448,2017-4-20,Atlanta Hawks,82,19880,3123,6918,0.451,729,2137,0.341,2394,4781,0.501,1484,2039,0.728,842,2793,3635,1938,672,1249,1491,8459
5449,2017-4-20,Miami Heat,82,19780,3202,7037,0.455,808,2213,0.365,2394,4824,0.496,1248,1768,0.706,872,2705,3577,1742,588,1033,1680,8460
5450,2017-4-20,Chicago Bulls,82,19780,3169,7141,0.444,623,1831,0.34,2546,5310,0.479,1474,1848,0.798,999,2797,3796,1851,643,1065,1455,8435
5451,2017-4-20,Sacramento Kings,82,19880,3105,6734,0.461,737,1960,0.376,2368,4774,0.496,1483,1913,0.775,715,2652,3367,1844,627,1157,1667,8430
5452,2017-4-20,Philadelphia 76ers,82,19830,3088,6992,0.442,831,2443,0.34,2257,4549,0.496,1393,1806,0.771,807,2706,3513,1949,692,1310,1793,8400
5453,2017-4-20,Detroit Pistons,82,19805,3269,7282,0.449,631,1915,0.33,2638,5367,0.492,1140,1586,0.719,908,2838,3746,1732,574,932,1467,8309
5454,2017-4-20,Orlando Magic,82,19805,3139,7133,0.44,701,2139,0.328,2438,4994,0.488,1309,1753,0.747,807,2734,3541,1820,580,1053,1584,8288
5455,2017-4-20,Utah Jazz,82,19755,3033,6515,0.466,791,2128,0.372,2242,4387,0.511,1401,1875,0.747,771,2774,3545,1651,550,1060,1545,8258
5456,2017-4-20,Memphis Grizzlies,82,19905,2984,6854,0.435,767,2169,0.354,2217,4685,0.473,1504,1918,0.784,886,2621,3507,1744,653,1019,1840,8239
5457,2017-4-20,Dallas Mavericks,82,19780,2968,6750,0.44,878,2473,0.355,2090,4277,0.489,1215,1516,0.801,647,2516,3163,1705,614,921,1567,8029
5458,2017-4-21,Golden State Warriors,82,19780,3532,7140,0.495,982,2562,0.383,2550,4578,0.557,1457,1850,0.788,770,2873,3643,2491,785,1182,1585,9503
5459,2017-4-21,Houston Rockets,82,19780,3305,7152,0.462,1181,3306,0.357,2124,3846,0.552,1667,2177,0.766,892,2746,3638,2070,670,1188,1634,9458
5460,2017-4-21,Denver Nuggets,82,19755,3377,7194,0.469,870,2365,0.368,2507,4829,0.519,1537,1986,0.774,966,2837,3803,2077,568,1186,1567,9161
5461,2017-4-21,Cleveland Cavaliers,82,19880,3275,6963,0.47,1067,2779,0.384,2208,4184,0.528,1431,1913,0.748,766,2821,3587,1858,539,1081,1486,9048
5462,2017-4-21,Washington Wizards,82,19855,3388,7137,0.475,756,2030,0.372,2632,5107,0.515,1421,1812,0.784,843,2671,3514,1956,693,1103,1745,8953
5463,2017-4-21,Los Angeles Clippers,82,19755,3242,6820,0.475,841,2245,0.375,2401,4575,0.525,1586,2128,0.745,738,2790,3528,1848,612,1022,1626,8911
5464,2017-4-21,Boston Celtics,82,19755,3168,6978,0.454,985,2742,0.359,2183,4236,0.515,1536,1903,0.807,744,2698,3442,2069,617,1037,1686,8857
5465,2017-4-21,Portland Trail Blazers,82,19930,3243,7059,0.459,852,2272,0.375,2391,4787,0.499,1513,1940,0.78,830,2750,3580,1733,574,1077,1736,8851
5466,2017-4-21,Phoenix Suns,82,19830,3270,7260,0.45,615,1854,0.332,2655,5406,0.491,1676,2159,0.776,976,2712,3688,1604,673,1223,2030,8831
5467,2017-4-21,Toronto Raptors,82,19780,3211,6918,0.464,725,1996,0.363,2486,4922,0.505,1615,2028,0.796,871,2676,3547,1517,677,969,1708,8762
5468,2017-4-21,Oklahoma City Thunder,82,19805,3237,7169,0.452,692,2116,0.327,2545,5053,0.504,1575,2113,0.745,1002,2821,3823,1721,648,1199,1715,8741
5469,2017-4-21,Brooklyn Nets,82,19755,3102,6987,0.444,877,2591,0.338,2225,4396,0.506,1592,2020,0.788,721,2879,3600,1756,593,1307,1726,8673
5470,2017-4-21,Minnesota Timberwolves,82,19805,3235,6922,0.467,601,1723,0.349,2634,5199,0.507,1586,1986,0.799,938,2540,3478,1940,654,1099,1646,8657
5471,2017-4-21,San Antonio Spurs,82,19805,3222,6864,0.469,753,1927,0.391,2469,4937,0.5,1440,1806,0.797,821,2777,3598,1954,655,1057,1498,8637
5472,2017-4-21,Indiana Pacers,82,19855,3221,6931,0.465,709,1885,0.376,2512,5046,0.498,1467,1811,0.81,742,2702,3444,1844,669,1087,1597,8618
5473,2017-4-21,Charlotte Hornets,82,19830,3093,7000,0.442,824,2347,0.351,2269,4653,0.488,1591,1953,0.815,721,2853,3574,1891,571,899,1360,8601
5474,2017-4-21,Los Angeles Lakers,82,19705,3224,7164,0.45,730,2110,0.346,2494,5054,0.493,1397,1853,0.754,933,2636,3569,1716,674,1193,1698,8575
5475,2017-4-21,New Orleans Pelicans,82,19905,3210,7130,0.45,768,2196,0.35,2442,4934,0.495,1368,1825,0.75,703,2879,3582,1869,638,1012,1490,8556
5476,2017-4-21,New York Knicks,82,19855,3244,7256,0.447,704,2022,0.348,2540,5234,0.485,1364,1731,0.788,983,2723,3706,1786,581,1081,1668,8556
5477,2017-4-21,Milwaukee Bucks,82,19780,3182,6715,0.474,720,1946,0.37,2462,4769,0.516,1413,1839,0.768,723,2589,3312,1984,666,1096,1660,8497
5478,2017-4-21,Atlanta Hawks,82,19880,3123,6918,0.451,729,2137,0.341,2394,4781,0.501,1484,2039,0.728,842,2793,3635,1938,672,1249,1491,8459
5479,2017-4-21,Miami Heat,82,19780,3202,7037,0.455,808,2213,0.365,2394,4824,0.496,1248,1768,0.706,872,2705,3577,1742,588,1033,1680,8460
5480,2017-4-21,Chicago Bulls,82,19780,3169,7141,0.444,623,1831,0.34,2546,5310,0.479,1474,1848,0.798,999,2797,3796,1851,643,1065,1455,8435
5481,2017-4-21,Sacramento Kings,82,19880,3105,6734,0.461,737,1960,0.376,2368,4774,0.496,1483,1913,0.775,715,2652,3367,1844,627,1157,1667,8430
5482,2017-4-21,Philadelphia 76ers,82,19830,3088,6992,0.442,831,2443,0.34,2257,4549,0.496,1393,1806,0.771,807,2706,3513,1949,692,1310,1793,8400
5483,2017-4-21,Detroit Pistons,82,19805,3269,7282,0.449,631,1915,0.33,2638,5367,0.492,1140,1586,0.719,908,2838,3746,1732,574,932,1467,8309
5484,2017-4-21,Orlando Magic,82,19805,3139,7133,0.44,701,2139,0.328,2438,4994,0.488,1309,1753,0.747,807,2734,3541,1820,580,1053,1584,8288
5485,2017-4-21,Utah Jazz,82,19755,3033,6515,0.466,791,2128,0.372,2242,4387,0.511,1401,1875,0.747,771,2774,3545,1651,550,1060,1545,8258
5486,2017-4-21,Memphis Grizzlies,82,19905,2984,6854,0.435,767,2169,0.354,2217,4685,0.473,1504,1918,0.784,886,2621,3507,1744,653,1019,1840,8239
5487,2017-4-21,Dallas Mavericks,82,19780,2968,6750,0.44,878,2473,0.355,2090,4277,0.489,1215,1516,0.801,647,2516,3163,1705,614,921,1567,8029
5488,2017-4-22,Golden State Warriors,82,19780,3532,7140,0.495,982,2562,0.383,2550,4578,0.557,1457,1850,0.788,770,2873,3643,2491,785,1182,1585,9503
5489,2017-4-22,Houston Rockets,82,19780,3305,7152,0.462,1181,3306,0.357,2124,3846,0.552,1667,2177,0.766,892,2746,3638,2070,670,1188,1634,9458
5490,2017-4-22,Denver Nuggets,82,19755,3377,7194,0.469,870,2365,0.368,2507,4829,0.519,1537,1986,0.774,966,2837,3803,2077,568,1186,1567,9161
5491,2017-4-22,Cleveland Cavaliers,82,19880,3275,6963,0.47,1067,2779,0.384,2208,4184,0.528,1431,1913,0.748,766,2821,3587,1858,539,1081,1486,9048
5492,2017-4-22,Washington Wizards,82,19855,3388,7137,0.475,756,2030,0.372,2632,5107,0.515,1421,1812,0.784,843,2671,3514,1956,693,1103,1745,8953
5493,2017-4-22,Los Angeles Clippers,82,19755,3242,6820,0.475,841,2245,0.375,2401,4575,0.525,1586,2128,0.745,738,2790,3528,1848,612,1022,1626,8911
5494,2017-4-22,Boston Celtics,82,19755,3168,6978,0.454,985,2742,0.359,2183,4236,0.515,1536,1903,0.807,744,2698,3442,2069,617,1037,1686,8857
5495,2017-4-22,Portland Trail Blazers,82,19930,3243,7059,0.459,852,2272,0.375,2391,4787,0.499,1513,1940,0.78,830,2750,3580,1733,574,1077,1736,8851
5496,2017-4-22,Phoenix Suns,82,19830,3270,7260,0.45,615,1854,0.332,2655,5406,0.491,1676,2159,0.776,976,2712,3688,1604,673,1223,2030,8831
5497,2017-4-22,Toronto Raptors,82,19780,3211,6918,0.464,725,1996,0.363,2486,4922,0.505,1615,2028,0.796,871,2676,3547,1517,677,969,1708,8762
5498,2017-4-22,Oklahoma City Thunder,82,19805,3237,7169,0.452,692,2116,0.327,2545,5053,0.504,1575,2113,0.745,1002,2821,3823,1721,648,1199,1715,8741
5499,2017-4-22,Brooklyn Nets,82,19755,3102,6987,0.444,877,2591,0.338,2225,4396,0.506,1592,2020,0.788,721,2879,3600,1756,593,1307,1726,8673
5500,2017-4-22,Minnesota Timberwolves,82,19805,3235,6922,0.467,601,1723,0.349,2634,5199,0.507,1586,1986,0.799,938,2540,3478,1940,654,1099,1646,8657
5501,2017-4-22,San Antonio Spurs,82,19805,3222,6864,0.469,753,1927,0.391,2469,4937,0.5,1440,1806,0.797,821,2777,3598,1954,655,1057,1498,8637
5502,2017-4-22,Indiana Pacers,82,19855,3221,6931,0.465,709,1885,0.376,2512,5046,0.498,1467,1811,0.81,742,2702,3444,1844,669,1087,1597,8618
5503,2017-4-22,Charlotte Hornets,82,19830,3093,7000,0.442,824,2347,0.351,2269,4653,0.488,1591,1953,0.815,721,2853,3574,1891,571,899,1360,8601
5504,2017-4-22,Los Angeles Lakers,82,19705,3224,7164,0.45,730,2110,0.346,2494,5054,0.493,1397,1853,0.754,933,2636,3569,1716,674,1193,1698,8575
5505,2017-4-22,New Orleans Pelicans,82,19905,3210,7130,0.45,768,2196,0.35,2442,4934,0.495,1368,1825,0.75,703,2879,3582,1869,638,1012,1490,8556
5506,2017-4-22,New York Knicks,82,19855,3244,7256,0.447,704,2022,0.348,2540,5234,0.485,1364,1731,0.788,983,2723,3706,1786,581,1081,1668,8556
5507,2017-4-22,Milwaukee Bucks,82,19780,3182,6715,0.474,720,1946,0.37,2462,4769,0.516,1413,1839,0.768,723,2589,3312,1984,666,1096,1660,8497
5508,2017-4-22,Atlanta Hawks,82,19880,3123,6918,0.451,729,2137,0.341,2394,4781,0.501,1484,2039,0.728,842,2793,3635,1938,672,1249,1491,8459
5509,2017-4-22,Miami Heat,82,19780,3202,7037,0.455,808,2213,0.365,2394,4824,0.496,1248,1768,0.706,872,2705,3577,1742,588,1033,1680,8460
5510,2017-4-22,Chicago Bulls,82,19780,3169,7141,0.444,623,1831,0.34,2546,5310,0.479,1474,1848,0.798,999,2797,3796,1851,643,1065,1455,8435
5511,2017-4-22,Sacramento Kings,82,19880,3105,6734,0.461,737,1960,0.376,2368,4774,0.496,1483,1913,0.775,715,2652,3367,1844,627,1157,1667,8430
5512,2017-4-22,Philadelphia 76ers,82,19830,3088,6992,0.442,831,2443,0.34,2257,4549,0.496,1393,1806,0.771,807,2706,3513,1949,692,1310,1793,8400
5513,2017-4-22,Detroit Pistons,82,19805,3269,7282,0.449,631,1915,0.33,2638,5367,0.492,1140,1586,0.719,908,2838,3746,1732,574,932,1467,8309
5514,2017-4-22,Orlando Magic,82,19805,3139,7133,0.44,701,2139,0.328,2438,4994,0.488,1309,1753,0.747,807,2734,3541,1820,580,1053,1584,8288
5515,2017-4-22,Utah Jazz,82,19755,3033,6515,0.466,791,2128,0.372,2242,4387,0.511,1401,1875,0.747,771,2774,3545,1651,550,1060,1545,8258
5516,2017-4-22,Memphis Grizzlies,82,19905,2984,6854,0.435,767,2169,0.354,2217,4685,0.473,1504,1918,0.784,886,2621,3507,1744,653,1019,1840,8239
5517,2017-4-22,Dallas Mavericks,82,19780,2968,6750,0.44,878,2473,0.355,2090,4277,0.489,1215,1516,0.801,647,2516,3163,1705,614,921,1567,8029
5518,2017-4-23,Golden State Warriors,82,19780,3532,7140,0.495,982,2562,0.383,2550,4578,0.557,1457,1850,0.788,770,2873,3643,2491,785,1182,1585,9503
5519,2017-4-23,Houston Rockets,82,19780,3305,7152,0.462,1181,3306,0.357,2124,3846,0.552,1667,2177,0.766,892,2746,3638,2070,670,1188,1634,9458
5520,2017-4-23,Denver Nuggets,82,19755,3377,7194,0.469,870,2365,0.368,2507,4829,0.519,1537,1986,0.774,966,2837,3803,2077,568,1186,1567,9161
5521,2017-4-23,Cleveland Cavaliers,82,19880,3275,6963,0.47,1067,2779,0.384,2208,4184,0.528,1431,1913,0.748,766,2821,3587,1858,539,1081,1486,9048
5522,2017-4-23,Washington Wizards,82,19855,3388,7137,0.475,756,2030,0.372,2632,5107,0.515,1421,1812,0.784,843,2671,3514,1956,693,1103,1745,8953
5523,2017-4-23,Los Angeles Clippers,82,19755,3242,6820,0.475,841,2245,0.375,2401,4575,0.525,1586,2128,0.745,738,2790,3528,1848,612,1022,1626,8911
5524,2017-4-23,Boston Celtics,82,19755,3168,6978,0.454,985,2742,0.359,2183,4236,0.515,1536,1903,0.807,744,2698,3442,2069,617,1037,1686,8857
5525,2017-4-23,Portland Trail Blazers,82,19930,3243,7059,0.459,852,2272,0.375,2391,4787,0.499,1513,1940,0.78,830,2750,3580,1733,574,1077,1736,8851
5526,2017-4-23,Phoenix Suns,82,19830,3270,7260,0.45,615,1854,0.332,2655,5406,0.491,1676,2159,0.776,976,2712,3688,1604,673,1223,2030,8831
5527,2017-4-23,Toronto Raptors,82,19780,3211,6918,0.464,725,1996,0.363,2486,4922,0.505,1615,2028,0.796,871,2676,3547,1517,677,969,1708,8762
5528,2017-4-23,Oklahoma City Thunder,82,19805,3237,7169,0.452,692,2116,0.327,2545,5053,0.504,1575,2113,0.745,1002,2821,3823,1721,648,1199,1715,8741
5529,2017-4-23,Brooklyn Nets,82,19755,3102,6987,0.444,877,2591,0.338,2225,4396,0.506,1592,2020,0.788,721,2879,3600,1756,593,1307,1726,8673
5530,2017-4-23,Minnesota Timberwolves,82,19805,3235,6922,0.467,601,1723,0.349,2634,5199,0.507,1586,1986,0.799,938,2540,3478,1940,654,1099,1646,8657
5531,2017-4-23,San Antonio Spurs,82,19805,3222,6864,0.469,753,1927,0.391,2469,4937,0.5,1440,1806,0.797,821,2777,3598,1954,655,1057,1498,8637
5532,2017-4-23,Indiana Pacers,82,19855,3221,6931,0.465,709,1885,0.376,2512,5046,0.498,1467,1811,0.81,742,2702,3444,1844,669,1087,1597,8618
5533,2017-4-23,Charlotte Hornets,82,19830,3093,7000,0.442,824,2347,0.351,2269,4653,0.488,1591,1953,0.815,721,2853,3574,1891,571,899,1360,8601
5534,2017-4-23,Los Angeles Lakers,82,19705,3224,7164,0.45,730,2110,0.346,2494,5054,0.493,1397,1853,0.754,933,2636,3569,1716,674,1193,1698,8575
5535,2017-4-23,New Orleans Pelicans,82,19905,3210,7130,0.45,768,2196,0.35,2442,4934,0.495,1368,1825,0.75,703,2879,3582,1869,638,1012,1490,8556
5536,2017-4-23,New York Knicks,82,19855,3244,7256,0.447,704,2022,0.348,2540,5234,0.485,1364,1731,0.788,983,2723,3706,1786,581,1081,1668,8556
5537,2017-4-23,Milwaukee Bucks,82,19780,3182,6715,0.474,720,1946,0.37,2462,4769,0.516,1413,1839,0.768,723,2589,3312,1984,666,1096,1660,8497
5538,2017-4-23,Atlanta Hawks,82,19880,3123,6918,0.451,729,2137,0.341,2394,4781,0.501,1484,2039,0.728,842,2793,3635,1938,672,1249,1491,8459
5539,2017-4-23,Miami Heat,82,19780,3202,7037,0.455,808,2213,0.365,2394,4824,0.496,1248,1768,0.706,872,2705,3577,1742,588,1033,1680,8460
5540,2017-4-23,Chicago Bulls,82,19780,3169,7141,0.444,623,1831,0.34,2546,5310,0.479,1474,1848,0.798,999,2797,3796,1851,643,1065,1455,8435
5541,2017-4-23,Sacramento Kings,82,19880,3105,6734,0.461,737,1960,0.376,2368,4774,0.496,1483,1913,0.775,715,2652,3367,1844,627,1157,1667,8430
5542,2017-4-23,Philadelphia 76ers,82,19830,3088,6992,0.442,831,2443,0.34,2257,4549,0.496,1393,1806,0.771,807,2706,3513,1949,692,1310,1793,8400
5543,2017-4-23,Detroit Pistons,82,19805,3269,7282,0.449,631,1915,0.33,2638,5367,0.492,1140,1586,0.719,908,2838,3746,1732,574,932,1467,8309
5544,2017-4-23,Orlando Magic,82,19805,3139,7133,0.44,701,2139,0.328,2438,4994,0.488,1309,1753,0.747,807,2734,3541,1820,580,1053,1584,8288
5545,2017-4-23,Utah Jazz,82,19755,3033,6515,0.466,791,2128,0.372,2242,4387,0.511,1401,1875,0.747,771,2774,3545,1651,550,1060,1545,8258
5546,2017-4-23,Memphis Grizzlies,82,19905,2984,6854,0.435,767,2169,0.354,2217,4685,0.473,1504,1918,0.784,886,2621,3507,1744,653,1019,1840,8239
5547,2017-4-23,Dallas Mavericks,82,19780,2968,6750,0.44,878,2473,0.355,2090,4277,0.489,1215,1516,0.801,647,2516,3163,1705,614,921,1567,8029
5548,2017-4-24,Golden State Warriors,82,19780,3532,7140,0.495,982,2562,0.383,2550,4578,0.557,1457,1850,0.788,770,2873,3643,2491,785,1182,1585,9503
5549,2017-4-24,Houston Rockets,82,19780,3305,7152,0.462,1181,3306,0.357,2124,3846,0.552,1667,2177,0.766,892,2746,3638,2070,670,1188,1634,9458
5550,2017-4-24,Denver Nuggets,82,19755,3377,7194,0.469,870,2365,0.368,2507,4829,0.519,1537,1986,0.774,966,2837,3803,2077,568,1186,1567,9161
5551,2017-4-24,Cleveland Cavaliers,82,19880,3275,6963,0.47,1067,2779,0.384,2208,4184,0.528,1431,1913,0.748,766,2821,3587,1858,539,1081,1486,9048
5552,2017-4-24,Washington Wizards,82,19855,3388,7137,0.475,756,2030,0.372,2632,5107,0.515,1421,1812,0.784,843,2671,3514,1956,693,1103,1745,8953
5553,2017-4-24,Los Angeles Clippers,82,19755,3242,6820,0.475,841,2245,0.375,2401,4575,0.525,1586,2128,0.745,738,2790,3528,1848,612,1022,1626,8911
5554,2017-4-24,Boston Celtics,82,19755,3168,6978,0.454,985,2742,0.359,2183,4236,0.515,1536,1903,0.807,744,2698,3442,2069,617,1037,1686,8857
5555,2017-4-24,Portland Trail Blazers,82,19930,3243,7059,0.459,852,2272,0.375,2391,4787,0.499,1513,1940,0.78,830,2750,3580,1733,574,1077,1736,8851
5556,2017-4-24,Phoenix Suns,82,19830,3270,7260,0.45,615,1854,0.332,2655,5406,0.491,1676,2159,0.776,976,2712,3688,1604,673,1223,2030,8831
5557,2017-4-24,Toronto Raptors,82,19780,3211,6918,0.464,725,1996,0.363,2486,4922,0.505,1615,2028,0.796,871,2676,3547,1517,677,969,1708,8762
5558,2017-4-24,Oklahoma City Thunder,82,19805,3237,7169,0.452,692,2116,0.327,2545,5053,0.504,1575,2113,0.745,1002,2821,3823,1721,648,1199,1715,8741
5559,2017-4-24,Brooklyn Nets,82,19755,3102,6987,0.444,877,2591,0.338,2225,4396,0.506,1592,2020,0.788,721,2879,3600,1756,593,1307,1726,8673
5560,2017-4-24,Minnesota Timberwolves,82,19805,3235,6922,0.467,601,1723,0.349,2634,5199,0.507,1586,1986,0.799,938,2540,3478,1940,654,1099,1646,8657
5561,2017-4-24,San Antonio Spurs,82,19805,3222,6864,0.469,753,1927,0.391,2469,4937,0.5,1440,1806,0.797,821,2777,3598,1954,655,1057,1498,8637
5562,2017-4-24,Indiana Pacers,82,19855,3221,6931,0.465,709,1885,0.376,2512,5046,0.498,1467,1811,0.81,742,2702,3444,1844,669,1087,1597,8618
5563,2017-4-24,Charlotte Hornets,82,19830,3093,7000,0.442,824,2347,0.351,2269,4653,0.488,1591,1953,0.815,721,2853,3574,1891,571,899,1360,8601
5564,2017-4-24,Los Angeles Lakers,82,19705,3224,7164,0.45,730,2110,0.346,2494,5054,0.493,1397,1853,0.754,933,2636,3569,1716,674,1193,1698,8575
5565,2017-4-24,New Orleans Pelicans,82,19905,3210,7130,0.45,768,2196,0.35,2442,4934,0.495,1368,1825,0.75,703,2879,3582,1869,638,1012,1490,8556
5566,2017-4-24,New York Knicks,82,19855,3244,7256,0.447,704,2022,0.348,2540,5234,0.485,1364,1731,0.788,983,2723,3706,1786,581,1081,1668,8556
5567,2017-4-24,Milwaukee Bucks,82,19780,3182,6715,0.474,720,1946,0.37,2462,4769,0.516,1413,1839,0.768,723,2589,3312,1984,666,1096,1660,8497
5568,2017-4-24,Atlanta Hawks,82,19880,3123,6918,0.451,729,2137,0.341,2394,4781,0.501,1484,2039,0.728,842,2793,3635,1938,672,1249,1491,8459
5569,2017-4-24,Miami Heat,82,19780,3202,7037,0.455,808,2213,0.365,2394,4824,0.496,1248,1768,0.706,872,2705,3577,1742,588,1033,1680,8460
5570,2017-4-24,Chicago Bulls,82,19780,3169,7141,0.444,623,1831,0.34,2546,5310,0.479,1474,1848,0.798,999,2797,3796,1851,643,1065,1455,8435
5571,2017-4-24,Sacramento Kings,82,19880,3105,6734,0.461,737,1960,0.376,2368,4774,0.496,1483,1913,0.775,715,2652,3367,1844,627,1157,1667,8430
5572,2017-4-24,Philadelphia 76ers,82,19830,3088,6992,0.442,831,2443,0.34,2257,4549,0.496,1393,1806,0.771,807,2706,3513,1949,692,1310,1793,8400
5573,2017-4-24,Detroit Pistons,82,19805,3269,7282,0.449,631,1915,0.33,2638,5367,0.492,1140,1586,0.719,908,2838,3746,1732,574,932,1467,8309
5574,2017-4-24,Orlando Magic,82,19805,3139,7133,0.44,701,2139,0.328,2438,4994,0.488,1309,1753,0.747,807,2734,3541,1820,580,1053,1584,8288
5575,2017-4-24,Utah Jazz,82,19755,3033,6515,0.466,791,2128,0.372,2242,4387,0.511,1401,1875,0.747,771,2774,3545,1651,550,1060,1545,8258
5576,2017-4-24,Memphis Grizzlies,82,19905,2984,6854,0.435,767,2169,0.354,2217,4685,0.473,1504,1918,0.784,886,2621,3507,1744,653,1019,1840,8239
5577,2017-4-24,Dallas Mavericks,82,19780,2968,6750,0.44,878,2473,0.355,2090,4277,0.489,1215,1516,0.801,647,2516,3163,1705,614,921,1567,8029
5578,2017-4-25,Golden State Warriors,82,19780,3532,7140,0.495,982,2562,0.383,2550,4578,0.557,1457,1850,0.788,770,2873,3643,2491,785,1182,1585,9503
5579,2017-4-25,Houston Rockets,82,19780,3305,7152,0.462,1181,3306,0.357,2124,3846,0.552,1667,2177,0.766,892,2746,3638,2070,670,1188,1634,9458
5580,2017-4-25,Denver Nuggets,82,19755,3377,7194,0.469,870,2365,0.368,2507,4829,0.519,1537,1986,0.774,966,2837,3803,2077,568,1186,1567,9161
5581,2017-4-25,Cleveland Cavaliers,82,19880,3275,6963,0.47,1067,2779,0.384,2208,4184,0.528,1431,1913,0.748,766,2821,3587,1858,539,1081,1486,9048
5582,2017-4-25,Washington Wizards,82,19855,3388,7137,0.475,756,2030,0.372,2632,5107,0.515,1421,1812,0.784,843,2671,3514,1956,693,1103,1745,8953
5583,2017-4-25,Los Angeles Clippers,82,19755,3242,6820,0.475,841,2245,0.375,2401,4575,0.525,1586,2128,0.745,738,2790,3528,1848,612,1022,1626,8911
5584,2017-4-25,Boston Celtics,82,19755,3168,6978,0.454,985,2742,0.359,2183,4236,0.515,1536,1903,0.807,744,2698,3442,2069,617,1037,1686,8857
5585,2017-4-25,Portland Trail Blazers,82,19930,3243,7059,0.459,852,2272,0.375,2391,4787,0.499,1513,1940,0.78,830,2750,3580,1733,574,1077,1736,8851
5586,2017-4-25,Phoenix Suns,82,19830,3270,7260,0.45,615,1854,0.332,2655,5406,0.491,1676,2159,0.776,976,2712,3688,1604,673,1223,2030,8831
5587,2017-4-25,Toronto Raptors,82,19780,3211,6918,0.464,725,1996,0.363,2486,4922,0.505,1615,2028,0.796,871,2676,3547,1517,677,969,1708,8762
5588,2017-4-25,Oklahoma City Thunder,82,19805,3237,7169,0.452,692,2116,0.327,2545,5053,0.504,1575,2113,0.745,1002,2821,3823,1721,648,1199,1715,8741
5589,2017-4-25,Brooklyn Nets,82,19755,3102,6987,0.444,877,2591,0.338,2225,4396,0.506,1592,2020,0.788,721,2879,3600,1756,593,1307,1726,8673
5590,2017-4-25,Minnesota Timberwolves,82,19805,3235,6922,0.467,601,1723,0.349,2634,5199,0.507,1586,1986,0.799,938,2540,3478,1940,654,1099,1646,8657
5591,2017-4-25,San Antonio Spurs,82,19805,3222,6864,0.469,753,1927,0.391,2469,4937,0.5,1440,1806,0.797,821,2777,3598,1954,655,1057,1498,8637
5592,2017-4-25,Indiana Pacers,82,19855,3221,6931,0.465,709,1885,0.376,2512,5046,0.498,1467,1811,0.81,742,2702,3444,1844,669,1087,1597,8618
5593,2017-4-25,Charlotte Hornets,82,19830,3093,7000,0.442,824,2347,0.351,2269,4653,0.488,1591,1953,0.815,721,2853,3574,1891,571,899,1360,8601
5594,2017-4-25,Los Angeles Lakers,82,19705,3224,7164,0.45,730,2110,0.346,2494,5054,0.493,1397,1853,0.754,933,2636,3569,1716,674,1193,1698,8575
5595,2017-4-25,New Orleans Pelicans,82,19905,3210,7130,0.45,768,2196,0.35,2442,4934,0.495,1368,1825,0.75,703,2879,3582,1869,638,1012,1490,8556
5596,2017-4-25,New York Knicks,82,19855,3244,7256,0.447,704,2022,0.348,2540,5234,0.485,1364,1731,0.788,983,2723,3706,1786,581,1081,1668,8556
5597,2017-4-25,Milwaukee Bucks,82,19780,3182,6715,0.474,720,1946,0.37,2462,4769,0.516,1413,1839,0.768,723,2589,3312,1984,666,1096,1660,8497
5598,2017-4-25,Atlanta Hawks,82,19880,3123,6918,0.451,729,2137,0.341,2394,4781,0.501,1484,2039,0.728,842,2793,3635,1938,672,1249,1491,8459
5599,2017-4-25,Miami Heat,82,19780,3202,7037,0.455,808,2213,0.365,2394,4824,0.496,1248,1768,0.706,872,2705,3577,1742,588,1033,1680,8460
5600,2017-4-25,Chicago Bulls,82,19780,3169,7141,0.444,623,1831,0.34,2546,5310,0.479,1474,1848,0.798,999,2797,3796,1851,643,1065,1455,8435
5601,2017-4-25,Sacramento Kings,82,19880,3105,6734,0.461,737,1960,0.376,2368,4774,0.496,1483,1913,0.775,715,2652,3367,1844,627,1157,1667,8430
5602,2017-4-25,Philadelphia 76ers,82,19830,3088,6992,0.442,831,2443,0.34,2257,4549,0.496,1393,1806,0.771,807,2706,3513,1949,692,1310,1793,8400
5603,2017-4-25,Detroit Pistons,82,19805,3269,7282,0.449,631,1915,0.33,2638,5367,0.492,1140,1586,0.719,908,2838,3746,1732,574,932,1467,8309
5604,2017-4-25,Orlando Magic,82,19805,3139,7133,0.44,701,2139,0.328,2438,4994,0.488,1309,1753,0.747,807,2734,3541,1820,580,1053,1584,8288
5605,2017-4-25,Utah Jazz,82,19755,3033,6515,0.466,791,2128,0.372,2242,4387,0.511,1401,1875,0.747,771,2774,3545,1651,550,1060,1545,8258
5606,2017-4-25,Memphis Grizzlies,82,19905,2984,6854,0.435,767,2169,0.354,2217,4685,0.473,1504,1918,0.784,886,2621,3507,1744,653,1019,1840,8239
5607,2017-4-25,Dallas Mavericks,82,19780,2968,6750,0.44,878,2473,0.355,2090,4277,0.489,1215,1516,0.801,647,2516,3163,1705,614,921,1567,8029
5608,2017-4-26,Golden State Warriors,82,19780,3532,7140,0.495,982,2562,0.383,2550,4578,0.557,1457,1850,0.788,770,2873,3643,2491,785,1182,1585,9503
5609,2017-4-26,Houston Rockets,82,19780,3305,7152,0.462,1181,3306,0.357,2124,3846,0.552,1667,2177,0.766,892,2746,3638,2070,670,1188,1634,9458
5610,2017-4-26,Denver Nuggets,82,19755,3377,7194,0.469,870,2365,0.368,2507,4829,0.519,1537,1986,0.774,966,2837,3803,2077,568,1186,1567,9161
5611,2017-4-26,Cleveland Cavaliers,82,19880,3275,6963,0.47,1067,2779,0.384,2208,4184,0.528,1431,1913,0.748,766,2821,3587,1858,539,1081,1486,9048
5612,2017-4-26,Washington Wizards,82,19855,3388,7137,0.475,756,2030,0.372,2632,5107,0.515,1421,1812,0.784,843,2671,3514,1956,693,1103,1745,8953
5613,2017-4-26,Los Angeles Clippers,82,19755,3242,6820,0.475,841,2245,0.375,2401,4575,0.525,1586,2128,0.745,738,2790,3528,1848,612,1022,1626,8911
5614,2017-4-26,Boston Celtics,82,19755,3168,6978,0.454,985,2742,0.359,2183,4236,0.515,1536,1903,0.807,744,2698,3442,2069,617,1037,1686,8857
5615,2017-4-26,Portland Trail Blazers,82,19930,3243,7059,0.459,852,2272,0.375,2391,4787,0.499,1513,1940,0.78,830,2750,3580,1733,574,1077,1736,8851
5616,2017-4-26,Phoenix Suns,82,19830,3270,7260,0.45,615,1854,0.332,2655,5406,0.491,1676,2159,0.776,976,2712,3688,1604,673,1223,2030,8831
5617,2017-4-26,Toronto Raptors,82,19780,3211,6918,0.464,725,1996,0.363,2486,4922,0.505,1615,2028,0.796,871,2676,3547,1517,677,969,1708,8762
5618,2017-4-26,Oklahoma City Thunder,82,19805,3237,7169,0.452,692,2116,0.327,2545,5053,0.504,1575,2113,0.745,1002,2821,3823,1721,648,1199,1715,8741
5619,2017-4-26,Brooklyn Nets,82,19755,3102,6987,0.444,877,2591,0.338,2225,4396,0.506,1592,2020,0.788,721,2879,3600,1756,593,1307,1726,8673
5620,2017-4-26,Minnesota Timberwolves,82,19805,3235,6922,0.467,601,1723,0.349,2634,5199,0.507,1586,1986,0.799,938,2540,3478,1940,654,1099,1646,8657
5621,2017-4-26,San Antonio Spurs,82,19805,3222,6864,0.469,753,1927,0.391,2469,4937,0.5,1440,1806,0.797,821,2777,3598,1954,655,1057,1498,8637
5622,2017-4-26,Indiana Pacers,82,19855,3221,6931,0.465,709,1885,0.376,2512,5046,0.498,1467,1811,0.81,742,2702,3444,1844,669,1087,1597,8618
5623,2017-4-26,Charlotte Hornets,82,19830,3093,7000,0.442,824,2347,0.351,2269,4653,0.488,1591,1953,0.815,721,2853,3574,1891,571,899,1360,8601
5624,2017-4-26,Los Angeles Lakers,82,19705,3224,7164,0.45,730,2110,0.346,2494,5054,0.493,1397,1853,0.754,933,2636,3569,1716,674,1193,1698,8575
5625,2017-4-26,New Orleans Pelicans,82,19905,3210,7130,0.45,768,2196,0.35,2442,4934,0.495,1368,1825,0.75,703,2879,3582,1869,638,1012,1490,8556
5626,2017-4-26,New York Knicks,82,19855,3244,7256,0.447,704,2022,0.348,2540,5234,0.485,1364,1731,0.788,983,2723,3706,1786,581,1081,1668,8556
5627,2017-4-26,Milwaukee Bucks,82,19780,3182,6715,0.474,720,1946,0.37,2462,4769,0.516,1413,1839,0.768,723,2589,3312,1984,666,1096,1660,8497
5628,2017-4-26,Atlanta Hawks,82,19880,3123,6918,0.451,729,2137,0.341,2394,4781,0.501,1484,2039,0.728,842,2793,3635,1938,672,1249,1491,8459
5629,2017-4-26,Miami Heat,82,19780,3202,7037,0.455,808,2213,0.365,2394,4824,0.496,1248,1768,0.706,872,2705,3577,1742,588,1033,1680,8460
5630,2017-4-26,Chicago Bulls,82,19780,3169,7141,0.444,623,1831,0.34,2546,5310,0.479,1474,1848,0.798,999,2797,3796,1851,643,1065,1455,8435
5631,2017-4-26,Sacramento Kings,82,19880,3105,6734,0.461,737,1960,0.376,2368,4774,0.496,1483,1913,0.775,715,2652,3367,1844,627,1157,1667,8430
5632,2017-4-26,Philadelphia 76ers,82,19830,3088,6992,0.442,831,2443,0.34,2257,4549,0.496,1393,1806,0.771,807,2706,3513,1949,692,1310,1793,8400
5633,2017-4-26,Detroit Pistons,82,19805,3269,7282,0.449,631,1915,0.33,2638,5367,0.492,1140,1586,0.719,908,2838,3746,1732,574,932,1467,8309
5634,2017-4-26,Orlando Magic,82,19805,3139,7133,0.44,701,2139,0.328,2438,4994,0.488,1309,1753,0.747,807,2734,3541,1820,580,1053,1584,8288
5635,2017-4-26,Utah Jazz,82,19755,3033,6515,0.466,791,2128,0.372,2242,4387,0.511,1401,1875,0.747,771,2774,3545,1651,550,1060,1545,8258
5636,2017-4-26,Memphis Grizzlies,82,19905,2984,6854,0.435,767,2169,0.354,2217,4685,0.473,1504,1918,0.784,886,2621,3507,1744,653,1019,1840,8239
5637,2017-4-26,Dallas Mavericks,82,19780,2968,6750,0.44,878,2473,0.355,2090,4277,0.489,1215,1516,0.801,647,2516,3163,1705,614,921,1567,8029
5638,2017-4-27,Golden State Warriors,82,19780,3532,7140,0.495,982,2562,0.383,2550,4578,0.557,1457,1850,0.788,770,2873,3643,2491,785,1182,1585,9503
5639,2017-4-27,Houston Rockets,82,19780,3305,7152,0.462,1181,3306,0.357,2124,3846,0.552,1667,2177,0.766,892,2746,3638,2070,670,1188,1634,9458
5640,2017-4-27,Denver Nuggets,82,19755,3377,7194,0.469,870,2365,0.368,2507,4829,0.519,1537,1986,0.774,966,2837,3803,2077,568,1186,1567,9161
5641,2017-4-27,Cleveland Cavaliers,82,19880,3275,6963,0.47,1067,2779,0.384,2208,4184,0.528,1431,1913,0.748,766,2821,3587,1858,539,1081,1486,9048
5642,2017-4-27,Washington Wizards,82,19855,3388,7137,0.475,756,2030,0.372,2632,5107,0.515,1421,1812,0.784,843,2671,3514,1956,693,1103,1745,8953
5643,2017-4-27,Los Angeles Clippers,82,19755,3242,6820,0.475,841,2245,0.375,2401,4575,0.525,1586,2128,0.745,738,2790,3528,1848,612,1022,1626,8911
5644,2017-4-27,Boston Celtics,82,19755,3168,6978,0.454,985,2742,0.359,2183,4236,0.515,1536,1903,0.807,744,2698,3442,2069,617,1037,1686,8857
5645,2017-4-27,Portland Trail Blazers,82,19930,3243,7059,0.459,852,2272,0.375,2391,4787,0.499,1513,1940,0.78,830,2750,3580,1733,574,1077,1736,8851
5646,2017-4-27,Phoenix Suns,82,19830,3270,7260,0.45,615,1854,0.332,2655,5406,0.491,1676,2159,0.776,976,2712,3688,1604,673,1223,2030,8831
5647,2017-4-27,Toronto Raptors,82,19780,3211,6918,0.464,725,1996,0.363,2486,4922,0.505,1615,2028,0.796,871,2676,3547,1517,677,969,1708,8762
5648,2017-4-27,Oklahoma City Thunder,82,19805,3237,7169,0.452,692,2116,0.327,2545,5053,0.504,1575,2113,0.745,1002,2821,3823,1721,648,1199,1715,8741
5649,2017-4-27,Brooklyn Nets,82,19755,3102,6987,0.444,877,2591,0.338,2225,4396,0.506,1592,2020,0.788,721,2879,3600,1756,593,1307,1726,8673
5650,2017-4-27,Minnesota Timberwolves,82,19805,3235,6922,0.467,601,1723,0.349,2634,5199,0.507,1586,1986,0.799,938,2540,3478,1940,654,1099,1646,8657
5651,2017-4-27,San Antonio Spurs,82,19805,3222,6864,0.469,753,1927,0.391,2469,4937,0.5,1440,1806,0.797,821,2777,3598,1954,655,1057,1498,8637
5652,2017-4-27,Indiana Pacers,82,19855,3221,6931,0.465,709,1885,0.376,2512,5046,0.498,1467,1811,0.81,742,2702,3444,1844,669,1087,1597,8618
5653,2017-4-27,Charlotte Hornets,82,19830,3093,7000,0.442,824,2347,0.351,2269,4653,0.488,1591,1953,0.815,721,2853,3574,1891,571,899,1360,8601
5654,2017-4-27,Los Angeles Lakers,82,19705,3224,7164,0.45,730,2110,0.346,2494,5054,0.493,1397,1853,0.754,933,2636,3569,1716,674,1193,1698,8575
5655,2017-4-27,New Orleans Pelicans,82,19905,3210,7130,0.45,768,2196,0.35,2442,4934,0.495,1368,1825,0.75,703,2879,3582,1869,638,1012,1490,8556
5656,2017-4-27,New York Knicks,82,19855,3244,7256,0.447,704,2022,0.348,2540,5234,0.485,1364,1731,0.788,983,2723,3706,1786,581,1081,1668,8556
5657,2017-4-27,Milwaukee Bucks,82,19780,3182,6715,0.474,720,1946,0.37,2462,4769,0.516,1413,1839,0.768,723,2589,3312,1984,666,1096,1660,8497
5658,2017-4-27,Atlanta Hawks,82,19880,3123,6918,0.451,729,2137,0.341,2394,4781,0.501,1484,2039,0.728,842,2793,3635,1938,672,1249,1491,8459
5659,2017-4-27,Miami Heat,82,19780,3202,7037,0.455,808,2213,0.365,2394,4824,0.496,1248,1768,0.706,872,2705,3577,1742,588,1033,1680,8460
5660,2017-4-27,Chicago Bulls,82,19780,3169,7141,0.444,623,1831,0.34,2546,5310,0.479,1474,1848,0.798,999,2797,3796,1851,643,1065,1455,8435
5661,2017-4-27,Sacramento Kings,82,19880,3105,6734,0.461,737,1960,0.376,2368,4774,0.496,1483,1913,0.775,715,2652,3367,1844,627,1157,1667,8430
5662,2017-4-27,Philadelphia 76ers,82,19830,3088,6992,0.442,831,2443,0.34,2257,4549,0.496,1393,1806,0.771,807,2706,3513,1949,692,1310,1793,8400
5663,2017-4-27,Detroit Pistons,82,19805,3269,7282,0.449,631,1915,0.33,2638,5367,0.492,1140,1586,0.719,908,2838,3746,1732,574,932,1467,8309
5664,2017-4-27,Orlando Magic,82,19805,3139,7133,0.44,701,2139,0.328,2438,4994,0.488,1309,1753,0.747,807,2734,3541,1820,580,1053,1584,8288
5665,2017-4-27,Utah Jazz,82,19755,3033,6515,0.466,791,2128,0.372,2242,4387,0.511,1401,1875,0.747,771,2774,3545,1651,550,1060,1545,8258
5666,2017-4-27,Memphis Grizzlies,82,19905,2984,6854,0.435,767,2169,0.354,2217,4685,0.473,1504,1918,0.784,886,2621,3507,1744,653,1019,1840,8239
5667,2017-4-27,Dallas Mavericks,82,19780,2968,6750,0.44,878,2473,0.355,2090,4277,0.489,1215,1516,0.801,647,2516,3163,1705,614,921,1567,8029
5668,2017-4-28,Golden State Warriors,82,19780,3532,7140,0.495,982,2562,0.383,2550,4578,0.557,1457,1850,0.788,770,2873,3643,2491,785,1182,1585,9503
5669,2017-4-28,Houston Rockets,82,19780,3305,7152,0.462,1181,3306,0.357,2124,3846,0.552,1667,2177,0.766,892,2746,3638,2070,670,1188,1634,9458
5670,2017-4-28,Denver Nuggets,82,19755,3377,7194,0.469,870,2365,0.368,2507,4829,0.519,1537,1986,0.774,966,2837,3803,2077,568,1186,1567,9161
5671,2017-4-28,Cleveland Cavaliers,82,19880,3275,6963,0.47,1067,2779,0.384,2208,4184,0.528,1431,1913,0.748,766,2821,3587,1858,539,1081,1486,9048
5672,2017-4-28,Washington Wizards,82,19855,3388,7137,0.475,756,2030,0.372,2632,5107,0.515,1421,1812,0.784,843,2671,3514,1956,693,1103,1745,8953
5673,2017-4-28,Los Angeles Clippers,82,19755,3242,6820,0.475,841,2245,0.375,2401,4575,0.525,1586,2128,0.745,738,2790,3528,1848,612,1022,1626,8911
5674,2017-4-28,Boston Celtics,82,19755,3168,6978,0.454,985,2742,0.359,2183,4236,0.515,1536,1903,0.807,744,2698,3442,2069,617,1037,1686,8857
5675,2017-4-28,Portland Trail Blazers,82,19930,3243,7059,0.459,852,2272,0.375,2391,4787,0.499,1513,1940,0.78,830,2750,3580,1733,574,1077,1736,8851
5676,2017-4-28,Phoenix Suns,82,19830,3270,7260,0.45,615,1854,0.332,2655,5406,0.491,1676,2159,0.776,976,2712,3688,1604,673,1223,2030,8831
5677,2017-4-28,Toronto Raptors,82,19780,3211,6918,0.464,725,1996,0.363,2486,4922,0.505,1615,2028,0.796,871,2676,3547,1517,677,969,1708,8762
5678,2017-4-28,Oklahoma City Thunder,82,19805,3237,7169,0.452,692,2116,0.327,2545,5053,0.504,1575,2113,0.745,1002,2821,3823,1721,648,1199,1715,8741
5679,2017-4-28,Brooklyn Nets,82,19755,3102,6987,0.444,877,2591,0.338,2225,4396,0.506,1592,2020,0.788,721,2879,3600,1756,593,1307,1726,8673
5680,2017-4-28,Minnesota Timberwolves,82,19805,3235,6922,0.467,601,1723,0.349,2634,5199,0.507,1586,1986,0.799,938,2540,3478,1940,654,1099,1646,8657
5681,2017-4-28,San Antonio Spurs,82,19805,3222,6864,0.469,753,1927,0.391,2469,4937,0.5,1440,1806,0.797,821,2777,3598,1954,655,1057,1498,8637
5682,2017-4-28,Indiana Pacers,82,19855,3221,6931,0.465,709,1885,0.376,2512,5046,0.498,1467,1811,0.81,742,2702,3444,1844,669,1087,1597,8618
5683,2017-4-28,Charlotte Hornets,82,19830,3093,7000,0.442,824,2347,0.351,2269,4653,0.488,1591,1953,0.815,721,2853,3574,1891,571,899,1360,8601
5684,2017-4-28,Los Angeles Lakers,82,19705,3224,7164,0.45,730,2110,0.346,2494,5054,0.493,1397,1853,0.754,933,2636,3569,1716,674,1193,1698,8575
5685,2017-4-28,New Orleans Pelicans,82,19905,3210,7130,0.45,768,2196,0.35,2442,4934,0.495,1368,1825,0.75,703,2879,3582,1869,638,1012,1490,8556
5686,2017-4-28,New York Knicks,82,19855,3244,7256,0.447,704,2022,0.348,2540,5234,0.485,1364,1731,0.788,983,2723,3706,1786,581,1081,1668,8556
5687,2017-4-28,Milwaukee Bucks,82,19780,3182,6715,0.474,720,1946,0.37,2462,4769,0.516,1413,1839,0.768,723,2589,3312,1984,666,1096,1660,8497
5688,2017-4-28,Atlanta Hawks,82,19880,3123,6918,0.451,729,2137,0.341,2394,4781,0.501,1484,2039,0.728,842,2793,3635,1938,672,1249,1491,8459
5689,2017-4-28,Miami Heat,82,19780,3202,7037,0.455,808,2213,0.365,2394,4824,0.496,1248,1768,0.706,872,2705,3577,1742,588,1033,1680,8460
5690,2017-4-28,Chicago Bulls,82,19780,3169,7141,0.444,623,1831,0.34,2546,5310,0.479,1474,1848,0.798,999,2797,3796,1851,643,1065,1455,8435
5691,2017-4-28,Sacramento Kings,82,19880,3105,6734,0.461,737,1960,0.376,2368,4774,0.496,1483,1913,0.775,715,2652,3367,1844,627,1157,1667,8430
5692,2017-4-28,Philadelphia 76ers,82,19830,3088,6992,0.442,831,2443,0.34,2257,4549,0.496,1393,1806,0.771,807,2706,3513,1949,692,1310,1793,8400
5693,2017-4-28,Detroit Pistons,82,19805,3269,7282,0.449,631,1915,0.33,2638,5367,0.492,1140,1586,0.719,908,2838,3746,1732,574,932,1467,8309
5694,2017-4-28,Orlando Magic,82,19805,3139,7133,0.44,701,2139,0.328,2438,4994,0.488,1309,1753,0.747,807,2734,3541,1820,580,1053,1584,8288
5695,2017-4-28,Utah Jazz,82,19755,3033,6515,0.466,791,2128,0.372,2242,4387,0.511,1401,1875,0.747,771,2774,3545,1651,550,1060,1545,8258
5696,2017-4-28,Memphis Grizzlies,82,19905,2984,6854,0.435,767,2169,0.354,2217,4685,0.473,1504,1918,0.784,886,2621,3507,1744,653,1019,1840,8239
5697,2017-4-28,Dallas Mavericks,82,19780,2968,6750,0.44,878,2473,0.355,2090,4277,0.489,1215,1516,0.801,647,2516,3163,1705,614,921,1567,8029
5698,2017-4-29,Golden State Warriors,82,19780,3532,7140,0.495,982,2562,0.383,2550,4578,0.557,1457,1850,0.788,770,2873,3643,2491,785,1182,1585,9503
5699,2017-4-29,Houston Rockets,82,19780,3305,7152,0.462,1181,3306,0.357,2124,3846,0.552,1667,2177,0.766,892,2746,3638,2070,670,1188,1634,9458
5700,2017-4-29,Denver Nuggets,82,19755,3377,7194,0.469,870,2365,0.368,2507,4829,0.519,1537,1986,0.774,966,2837,3803,2077,568,1186,1567,9161
5701,2017-4-29,Cleveland Cavaliers,82,19880,3275,6963,0.47,1067,2779,0.384,2208,4184,0.528,1431,1913,0.748,766,2821,3587,1858,539,1081,1486,9048
5702,2017-4-29,Washington Wizards,82,19855,3388,7137,0.475,756,2030,0.372,2632,5107,0.515,1421,1812,0.784,843,2671,3514,1956,693,1103,1745,8953
5703,2017-4-29,Los Angeles Clippers,82,19755,3242,6820,0.475,841,2245,0.375,2401,4575,0.525,1586,2128,0.745,738,2790,3528,1848,612,1022,1626,8911
5704,2017-4-29,Boston Celtics,82,19755,3168,6978,0.454,985,2742,0.359,2183,4236,0.515,1536,1903,0.807,744,2698,3442,2069,617,1037,1686,8857
5705,2017-4-29,Portland Trail Blazers,82,19930,3243,7059,0.459,852,2272,0.375,2391,4787,0.499,1513,1940,0.78,830,2750,3580,1733,574,1077,1736,8851
5706,2017-4-29,Phoenix Suns,82,19830,3270,7260,0.45,615,1854,0.332,2655,5406,0.491,1676,2159,0.776,976,2712,3688,1604,673,1223,2030,8831
5707,2017-4-29,Toronto Raptors,82,19780,3211,6918,0.464,725,1996,0.363,2486,4922,0.505,1615,2028,0.796,871,2676,3547,1517,677,969,1708,8762
5708,2017-4-29,Oklahoma City Thunder,82,19805,3237,7169,0.452,692,2116,0.327,2545,5053,0.504,1575,2113,0.745,1002,2821,3823,1721,648,1199,1715,8741
5709,2017-4-29,Brooklyn Nets,82,19755,3102,6987,0.444,877,2591,0.338,2225,4396,0.506,1592,2020,0.788,721,2879,3600,1756,593,1307,1726,8673
5710,2017-4-29,Minnesota Timberwolves,82,19805,3235,6922,0.467,601,1723,0.349,2634,5199,0.507,1586,1986,0.799,938,2540,3478,1940,654,1099,1646,8657
5711,2017-4-29,San Antonio Spurs,82,19805,3222,6864,0.469,753,1927,0.391,2469,4937,0.5,1440,1806,0.797,821,2777,3598,1954,655,1057,1498,8637
5712,2017-4-29,Indiana Pacers,82,19855,3221,6931,0.465,709,1885,0.376,2512,5046,0.498,1467,1811,0.81,742,2702,3444,1844,669,1087,1597,8618
5713,2017-4-29,Charlotte Hornets,82,19830,3093,7000,0.442,824,2347,0.351,2269,4653,0.488,1591,1953,0.815,721,2853,3574,1891,571,899,1360,8601
5714,2017-4-29,Los Angeles Lakers,82,19705,3224,7164,0.45,730,2110,0.346,2494,5054,0.493,1397,1853,0.754,933,2636,3569,1716,674,1193,1698,8575
5715,2017-4-29,New Orleans Pelicans,82,19905,3210,7130,0.45,768,2196,0.35,2442,4934,0.495,1368,1825,0.75,703,2879,3582,1869,638,1012,1490,8556
5716,2017-4-29,New York Knicks,82,19855,3244,7256,0.447,704,2022,0.348,2540,5234,0.485,1364,1731,0.788,983,2723,3706,1786,581,1081,1668,8556
5717,2017-4-29,Milwaukee Bucks,82,19780,3182,6715,0.474,720,1946,0.37,2462,4769,0.516,1413,1839,0.768,723,2589,3312,1984,666,1096,1660,8497
5718,2017-4-29,Atlanta Hawks,82,19880,3123,6918,0.451,729,2137,0.341,2394,4781,0.501,1484,2039,0.728,842,2793,3635,1938,672,1249,1491,8459
5719,2017-4-29,Miami Heat,82,19780,3202,7037,0.455,808,2213,0.365,2394,4824,0.496,1248,1768,0.706,872,2705,3577,1742,588,1033,1680,8460
5720,2017-4-29,Chicago Bulls,82,19780,3169,7141,0.444,623,1831,0.34,2546,5310,0.479,1474,1848,0.798,999,2797,3796,1851,643,1065,1455,8435
5721,2017-4-29,Sacramento Kings,82,19880,3105,6734,0.461,737,1960,0.376,2368,4774,0.496,1483,1913,0.775,715,2652,3367,1844,627,1157,1667,8430
5722,2017-4-29,Philadelphia 76ers,82,19830,3088,6992,0.442,831,2443,0.34,2257,4549,0.496,1393,1806,0.771,807,2706,3513,1949,692,1310,1793,8400
5723,2017-4-29,Detroit Pistons,82,19805,3269,7282,0.449,631,1915,0.33,2638,5367,0.492,1140,1586,0.719,908,2838,3746,1732,574,932,1467,8309
5724,2017-4-29,Orlando Magic,82,19805,3139,7133,0.44,701,2139,0.328,2438,4994,0.488,1309,1753,0.747,807,2734,3541,1820,580,1053,1584,8288
5725,2017-4-29,Utah Jazz,82,19755,3033,6515,0.466,791,2128,0.372,2242,4387,0.511,1401,1875,0.747,771,2774,3545,1651,550,1060,1545,8258
5726,2017-4-29,Memphis Grizzlies,82,19905,2984,6854,0.435,767,2169,0.354,2217,4685,0.473,1504,1918,0.784,886,2621,3507,1744,653,1019,1840,8239
5727,2017-4-29,Dallas Mavericks,82,19780,2968,6750,0.44,878,2473,0.355,2090,4277,0.489,1215,1516,0.801,647,2516,3163,1705,614,921,1567,8029
5728,2017-4-30,Golden State Warriors,82,19780,3532,7140,0.495,982,2562,0.383,2550,4578,0.557,1457,1850,0.788,770,2873,3643,2491,785,1182,1585,9503
5729,2017-4-30,Houston Rockets,82,19780,3305,7152,0.462,1181,3306,0.357,2124,3846,0.552,1667,2177,0.766,892,2746,3638,2070,670,1188,1634,9458
5730,2017-4-30,Denver Nuggets,82,19755,3377,7194,0.469,870,2365,0.368,2507,4829,0.519,1537,1986,0.774,966,2837,3803,2077,568,1186,1567,9161
5731,2017-4-30,Cleveland Cavaliers,82,19880,3275,6963,0.47,1067,2779,0.384,2208,4184,0.528,1431,1913,0.748,766,2821,3587,1858,539,1081,1486,9048
5732,2017-4-30,Washington Wizards,82,19855,3388,7137,0.475,756,2030,0.372,2632,5107,0.515,1421,1812,0.784,843,2671,3514,1956,693,1103,1745,8953
5733,2017-4-30,Los Angeles Clippers,82,19755,3242,6820,0.475,841,2245,0.375,2401,4575,0.525,1586,2128,0.745,738,2790,3528,1848,612,1022,1626,8911
5734,2017-4-30,Boston Celtics,82,19755,3168,6978,0.454,985,2742,0.359,2183,4236,0.515,1536,1903,0.807,744,2698,3442,2069,617,1037,1686,8857
5735,2017-4-30,Portland Trail Blazers,82,19930,3243,7059,0.459,852,2272,0.375,2391,4787,0.499,1513,1940,0.78,830,2750,3580,1733,574,1077,1736,8851
5736,2017-4-30,Phoenix Suns,82,19830,3270,7260,0.45,615,1854,0.332,2655,5406,0.491,1676,2159,0.776,976,2712,3688,1604,673,1223,2030,8831
5737,2017-4-30,Toronto Raptors,82,19780,3211,6918,0.464,725,1996,0.363,2486,4922,0.505,1615,2028,0.796,871,2676,3547,1517,677,969,1708,8762
5738,2017-4-30,Oklahoma City Thunder,82,19805,3237,7169,0.452,692,2116,0.327,2545,5053,0.504,1575,2113,0.745,1002,2821,3823,1721,648,1199,1715,8741
5739,2017-4-30,Brooklyn Nets,82,19755,3102,6987,0.444,877,2591,0.338,2225,4396,0.506,1592,2020,0.788,721,2879,3600,1756,593,1307,1726,8673
5740,2017-4-30,Minnesota Timberwolves,82,19805,3235,6922,0.467,601,1723,0.349,2634,5199,0.507,1586,1986,0.799,938,2540,3478,1940,654,1099,1646,8657
5741,2017-4-30,San Antonio Spurs,82,19805,3222,6864,0.469,753,1927,0.391,2469,4937,0.5,1440,1806,0.797,821,2777,3598,1954,655,1057,1498,8637
5742,2017-4-30,Indiana Pacers,82,19855,3221,6931,0.465,709,1885,0.376,2512,5046,0.498,1467,1811,0.81,742,2702,3444,1844,669,1087,1597,8618
5743,2017-4-30,Charlotte Hornets,82,19830,3093,7000,0.442,824,2347,0.351,2269,4653,0.488,1591,1953,0.815,721,2853,3574,1891,571,899,1360,8601
5744,2017-4-30,Los Angeles Lakers,82,19705,3224,7164,0.45,730,2110,0.346,2494,5054,0.493,1397,1853,0.754,933,2636,3569,1716,674,1193,1698,8575
5745,2017-4-30,New Orleans Pelicans,82,19905,3210,7130,0.45,768,2196,0.35,2442,4934,0.495,1368,1825,0.75,703,2879,3582,1869,638,1012,1490,8556
5746,2017-4-30,New York Knicks,82,19855,3244,7256,0.447,704,2022,0.348,2540,5234,0.485,1364,1731,0.788,983,2723,3706,1786,581,1081,1668,8556
5747,2017-4-30,Milwaukee Bucks,82,19780,3182,6715,0.474,720,1946,0.37,2462,4769,0.516,1413,1839,0.768,723,2589,3312,1984,666,1096,1660,8497
5748,2017-4-30,Atlanta Hawks,82,19880,3123,6918,0.451,729,2137,0.341,2394,4781,0.501,1484,2039,0.728,842,2793,3635,1938,672,1249,1491,8459
5749,2017-4-30,Miami Heat,82,19780,3202,7037,0.455,808,2213,0.365,2394,4824,0.496,1248,1768,0.706,872,2705,3577,1742,588,1033,1680,8460
5750,2017-4-30,Chicago Bulls,82,19780,3169,7141,0.444,623,1831,0.34,2546,5310,0.479,1474,1848,0.798,999,2797,3796,1851,643,1065,1455,8435
5751,2017-4-30,Sacramento Kings,82,19880,3105,6734,0.461,737,1960,0.376,2368,4774,0.496,1483,1913,0.775,715,2652,3367,1844,627,1157,1667,8430
5752,2017-4-30,Philadelphia 76ers,82,19830,3088,6992,0.442,831,2443,0.34,2257,4549,0.496,1393,1806,0.771,807,2706,3513,1949,692,1310,1793,8400
5753,2017-4-30,Detroit Pistons,82,19805,3269,7282,0.449,631,1915,0.33,2638,5367,0.492,1140,1586,0.719,908,2838,3746,1732,574,932,1467,8309
5754,2017-4-30,Orlando Magic,82,19805,3139,7133,0.44,701,2139,0.328,2438,4994,0.488,1309,1753,0.747,807,2734,3541,1820,580,1053,1584,8288
5755,2017-4-30,Utah Jazz,82,19755,3033,6515,0.466,791,2128,0.372,2242,4387,0.511,1401,1875,0.747,771,2774,3545,1651,550,1060,1545,8258
5756,2017-4-30,Memphis Grizzlies,82,19905,2984,6854,0.435,767,2169,0.354,2217,4685,0.473,1504,1918,0.784,886,2621,3507,1744,653,1019,1840,8239
5757,2017-4-30,Dallas Mavericks,82,19780,2968,6750,0.44,878,2473,0.355,2090,4277,0.489,1215,1516,0.801,647,2516,3163,1705,614,921,1567,8029
5758,2017-5-1,Golden State Warriors,82,19780,3532,7140,0.495,982,2562,0.383,2550,4578,0.557,1457,1850,0.788,770,2873,3643,2491,785,1182,1585,9503
5759,2017-5-1,Houston Rockets,82,19780,3305,7152,0.462,1181,3306,0.357,2124,3846,0.552,1667,2177,0.766,892,2746,3638,2070,670,1188,1634,9458
5760,2017-5-1,Denver Nuggets,82,19755,3377,7194,0.469,870,2365,0.368,2507,4829,0.519,1537,1986,0.774,966,2837,3803,2077,568,1186,1567,9161
5761,2017-5-1,Cleveland Cavaliers,82,19880,3275,6963,0.47,1067,2779,0.384,2208,4184,0.528,1431,1913,0.748,766,2821,3587,1858,539,1081,1486,9048
5762,2017-5-1,Washington Wizards,82,19855,3388,7137,0.475,756,2030,0.372,2632,5107,0.515,1421,1812,0.784,843,2671,3514,1956,693,1103,1745,8953
5763,2017-5-1,Los Angeles Clippers,82,19755,3242,6820,0.475,841,2245,0.375,2401,4575,0.525,1586,2128,0.745,738,2790,3528,1848,612,1022,1626,8911
5764,2017-5-1,Boston Celtics,82,19755,3168,6978,0.454,985,2742,0.359,2183,4236,0.515,1536,1903,0.807,744,2698,3442,2069,617,1037,1686,8857
5765,2017-5-1,Portland Trail Blazers,82,19930,3243,7059,0.459,852,2272,0.375,2391,4787,0.499,1513,1940,0.78,830,2750,3580,1733,574,1077,1736,8851
5766,2017-5-1,Phoenix Suns,82,19830,3270,7260,0.45,615,1854,0.332,2655,5406,0.491,1676,2159,0.776,976,2712,3688,1604,673,1223,2030,8831
5767,2017-5-1,Toronto Raptors,82,19780,3211,6918,0.464,725,1996,0.363,2486,4922,0.505,1615,2028,0.796,871,2676,3547,1517,677,969,1708,8762
5768,2017-5-1,Oklahoma City Thunder,82,19805,3237,7169,0.452,692,2116,0.327,2545,5053,0.504,1575,2113,0.745,1002,2821,3823,1721,648,1199,1715,8741
5769,2017-5-1,Brooklyn Nets,82,19755,3102,6987,0.444,877,2591,0.338,2225,4396,0.506,1592,2020,0.788,721,2879,3600,1756,593,1307,1726,8673
5770,2017-5-1,Minnesota Timberwolves,82,19805,3235,6922,0.467,601,1723,0.349,2634,5199,0.507,1586,1986,0.799,938,2540,3478,1940,654,1099,1646,8657
5771,2017-5-1,San Antonio Spurs,82,19805,3222,6864,0.469,753,1927,0.391,2469,4937,0.5,1440,1806,0.797,821,2777,3598,1954,655,1057,1498,8637
5772,2017-5-1,Indiana Pacers,82,19855,3221,6931,0.465,709,1885,0.376,2512,5046,0.498,1467,1811,0.81,742,2702,3444,1844,669,1087,1597,8618
5773,2017-5-1,Charlotte Hornets,82,19830,3093,7000,0.442,824,2347,0.351,2269,4653,0.488,1591,1953,0.815,721,2853,3574,1891,571,899,1360,8601
5774,2017-5-1,Los Angeles Lakers,82,19705,3224,7164,0.45,730,2110,0.346,2494,5054,0.493,1397,1853,0.754,933,2636,3569,1716,674,1193,1698,8575
5775,2017-5-1,New Orleans Pelicans,82,19905,3210,7130,0.45,768,2196,0.35,2442,4934,0.495,1368,1825,0.75,703,2879,3582,1869,638,1012,1490,8556
5776,2017-5-1,New York Knicks,82,19855,3244,7256,0.447,704,2022,0.348,2540,5234,0.485,1364,1731,0.788,983,2723,3706,1786,581,1081,1668,8556
5777,2017-5-1,Milwaukee Bucks,82,19780,3182,6715,0.474,720,1946,0.37,2462,4769,0.516,1413,1839,0.768,723,2589,3312,1984,666,1096,1660,8497
5778,2017-5-1,Atlanta Hawks,82,19880,3123,6918,0.451,729,2137,0.341,2394,4781,0.501,1484,2039,0.728,842,2793,3635,1938,672,1249,1491,8459
5779,2017-5-1,Miami Heat,82,19780,3202,7037,0.455,808,2213,0.365,2394,4824,0.496,1248,1768,0.706,872,2705,3577,1742,588,1033,1680,8460
5780,2017-5-1,Chicago Bulls,82,19780,3169,7141,0.444,623,1831,0.34,2546,5310,0.479,1474,1848,0.798,999,2797,3796,1851,643,1065,1455,8435
5781,2017-5-1,Sacramento Kings,82,19880,3105,6734,0.461,737,1960,0.376,2368,4774,0.496,1483,1913,0.775,715,2652,3367,1844,627,1157,1667,8430
5782,2017-5-1,Philadelphia 76ers,82,19830,3088,6992,0.442,831,2443,0.34,2257,4549,0.496,1393,1806,0.771,807,2706,3513,1949,692,1310,1793,8400
5783,2017-5-1,Detroit Pistons,82,19805,3269,7282,0.449,631,1915,0.33,2638,5367,0.492,1140,1586,0.719,908,2838,3746,1732,574,932,1467,8309
5784,2017-5-1,Orlando Magic,82,19805,3139,7133,0.44,701,2139,0.328,2438,4994,0.488,1309,1753,0.747,807,2734,3541,1820,580,1053,1584,8288
5785,2017-5-1,Utah Jazz,82,19755,3033,6515,0.466,791,2128,0.372,2242,4387,0.511,1401,1875,0.747,771,2774,3545,1651,550,1060,1545,8258
5786,2017-5-1,Memphis Grizzlies,82,19905,2984,6854,0.435,767,2169,0.354,2217,4685,0.473,1504,1918,0.784,886,2621,3507,1744,653,1019,1840,8239
5787,2017-5-1,Dallas Mavericks,82,19780,2968,6750,0.44,878,2473,0.355,2090,4277,0.489,1215,1516,0.801,647,2516,3163,1705,614,921,1567,8029
5788,2017-5-2,Golden State Warriors,82,19780,3532,7140,0.495,982,2562,0.383,2550,4578,0.557,1457,1850,0.788,770,2873,3643,2491,785,1182,1585,9503
5789,2017-5-2,Houston Rockets,82,19780,3305,7152,0.462,1181,3306,0.357,2124,3846,0.552,1667,2177,0.766,892,2746,3638,2070,670,1188,1634,9458
5790,2017-5-2,Denver Nuggets,82,19755,3377,7194,0.469,870,2365,0.368,2507,4829,0.519,1537,1986,0.774,966,2837,3803,2077,568,1186,1567,9161
5791,2017-5-2,Cleveland Cavaliers,82,19880,3275,6963,0.47,1067,2779,0.384,2208,4184,0.528,1431,1913,0.748,766,2821,3587,1858,539,1081,1486,9048
5792,2017-5-2,Washington Wizards,82,19855,3388,7137,0.475,756,2030,0.372,2632,5107,0.515,1421,1812,0.784,843,2671,3514,1956,693,1103,1745,8953
5793,2017-5-2,Los Angeles Clippers,82,19755,3242,6820,0.475,841,2245,0.375,2401,4575,0.525,1586,2128,0.745,738,2790,3528,1848,612,1022,1626,8911
5794,2017-5-2,Boston Celtics,82,19755,3168,6978,0.454,985,2742,0.359,2183,4236,0.515,1536,1903,0.807,744,2698,3442,2069,617,1037,1686,8857
5795,2017-5-2,Portland Trail Blazers,82,19930,3243,7059,0.459,852,2272,0.375,2391,4787,0.499,1513,1940,0.78,830,2750,3580,1733,574,1077,1736,8851
5796,2017-5-2,Phoenix Suns,82,19830,3270,7260,0.45,615,1854,0.332,2655,5406,0.491,1676,2159,0.776,976,2712,3688,1604,673,1223,2030,8831
5797,2017-5-2,Toronto Raptors,82,19780,3211,6918,0.464,725,1996,0.363,2486,4922,0.505,1615,2028,0.796,871,2676,3547,1517,677,969,1708,8762
5798,2017-5-2,Oklahoma City Thunder,82,19805,3237,7169,0.452,692,2116,0.327,2545,5053,0.504,1575,2113,0.745,1002,2821,3823,1721,648,1199,1715,8741
5799,2017-5-2,Brooklyn Nets,82,19755,3102,6987,0.444,877,2591,0.338,2225,4396,0.506,1592,2020,0.788,721,2879,3600,1756,593,1307,1726,8673
5800,2017-5-2,Minnesota Timberwolves,82,19805,3235,6922,0.467,601,1723,0.349,2634,5199,0.507,1586,1986,0.799,938,2540,3478,1940,654,1099,1646,8657
5801,2017-5-2,San Antonio Spurs,82,19805,3222,6864,0.469,753,1927,0.391,2469,4937,0.5,1440,1806,0.797,821,2777,3598,1954,655,1057,1498,8637
5802,2017-5-2,Indiana Pacers,82,19855,3221,6931,0.465,709,1885,0.376,2512,5046,0.498,1467,1811,0.81,742,2702,3444,1844,669,1087,1597,8618
5803,2017-5-2,Charlotte Hornets,82,19830,3093,7000,0.442,824,2347,0.351,2269,4653,0.488,1591,1953,0.815,721,2853,3574,1891,571,899,1360,8601
5804,2017-5-2,Los Angeles Lakers,82,19705,3224,7164,0.45,730,2110,0.346,2494,5054,0.493,1397,1853,0.754,933,2636,3569,1716,674,1193,1698,8575
5805,2017-5-2,New Orleans Pelicans,82,19905,3210,7130,0.45,768,2196,0.35,2442,4934,0.495,1368,1825,0.75,703,2879,3582,1869,638,1012,1490,8556
5806,2017-5-2,New York Knicks,82,19855,3244,7256,0.447,704,2022,0.348,2540,5234,0.485,1364,1731,0.788,983,2723,3706,1786,581,1081,1668,8556
5807,2017-5-2,Milwaukee Bucks,82,19780,3182,6715,0.474,720,1946,0.37,2462,4769,0.516,1413,1839,0.768,723,2589,3312,1984,666,1096,1660,8497
5808,2017-5-2,Atlanta Hawks,82,19880,3123,6918,0.451,729,2137,0.341,2394,4781,0.501,1484,2039,0.728,842,2793,3635,1938,672,1249,1491,8459
5809,2017-5-2,Miami Heat,82,19780,3202,7037,0.455,808,2213,0.365,2394,4824,0.496,1248,1768,0.706,872,2705,3577,1742,588,1033,1680,8460
5810,2017-5-2,Chicago Bulls,82,19780,3169,7141,0.444,623,1831,0.34,2546,5310,0.479,1474,1848,0.798,999,2797,3796,1851,643,1065,1455,8435
5811,2017-5-2,Sacramento Kings,82,19880,3105,6734,0.461,737,1960,0.376,2368,4774,0.496,1483,1913,0.775,715,2652,3367,1844,627,1157,1667,8430
5812,2017-5-2,Philadelphia 76ers,82,19830,3088,6992,0.442,831,2443,0.34,2257,4549,0.496,1393,1806,0.771,807,2706,3513,1949,692,1310,1793,8400
5813,2017-5-2,Detroit Pistons,82,19805,3269,7282,0.449,631,1915,0.33,2638,5367,0.492,1140,1586,0.719,908,2838,3746,1732,574,932,1467,8309
5814,2017-5-2,Orlando Magic,82,19805,3139,7133,0.44,701,2139,0.328,2438,4994,0.488,1309,1753,0.747,807,2734,3541,1820,580,1053,1584,8288
5815,2017-5-2,Utah Jazz,82,19755,3033,6515,0.466,791,2128,0.372,2242,4387,0.511,1401,1875,0.747,771,2774,3545,1651,550,1060,1545,8258
5816,2017-5-2,Memphis Grizzlies,82,19905,2984,6854,0.435,767,2169,0.354,2217,4685,0.473,1504,1918,0.784,886,2621,3507,1744,653,1019,1840,8239
5817,2017-5-2,Dallas Mavericks,82,19780,2968,6750,0.44,878,2473,0.355,2090,4277,0.489,1215,1516,0.801,647,2516,3163,1705,614,921,1567,8029
5818,2017-5-3,Golden State Warriors,82,19780,3532,7140,0.495,982,2562,0.383,2550,4578,0.557,1457,1850,0.788,770,2873,3643,2491,785,1182,1585,9503
5819,2017-5-3,Houston Rockets,82,19780,3305,7152,0.462,1181,3306,0.357,2124,3846,0.552,1667,2177,0.766,892,2746,3638,2070,670,1188,1634,9458
5820,2017-5-3,Denver Nuggets,82,19755,3377,7194,0.469,870,2365,0.368,2507,4829,0.519,1537,1986,0.774,966,2837,3803,2077,568,1186,1567,9161
5821,2017-5-3,Cleveland Cavaliers,82,19880,3275,6963,0.47,1067,2779,0.384,2208,4184,0.528,1431,1913,0.748,766,2821,3587,1858,539,1081,1486,9048
5822,2017-5-3,Washington Wizards,82,19855,3388,7137,0.475,756,2030,0.372,2632,5107,0.515,1421,1812,0.784,843,2671,3514,1956,693,1103,1745,8953
5823,2017-5-3,Los Angeles Clippers,82,19755,3242,6820,0.475,841,2245,0.375,2401,4575,0.525,1586,2128,0.745,738,2790,3528,1848,612,1022,1626,8911
5824,2017-5-3,Boston Celtics,82,19755,3168,6978,0.454,985,2742,0.359,2183,4236,0.515,1536,1903,0.807,744,2698,3442,2069,617,1037,1686,8857
5825,2017-5-3,Portland Trail Blazers,82,19930,3243,7059,0.459,852,2272,0.375,2391,4787,0.499,1513,1940,0.78,830,2750,3580,1733,574,1077,1736,8851
5826,2017-5-3,Phoenix Suns,82,19830,3270,7260,0.45,615,1854,0.332,2655,5406,0.491,1676,2159,0.776,976,2712,3688,1604,673,1223,2030,8831
5827,2017-5-3,Toronto Raptors,82,19780,3211,6918,0.464,725,1996,0.363,2486,4922,0.505,1615,2028,0.796,871,2676,3547,1517,677,969,1708,8762
5828,2017-5-3,Oklahoma City Thunder,82,19805,3237,7169,0.452,692,2116,0.327,2545,5053,0.504,1575,2113,0.745,1002,2821,3823,1721,648,1199,1715,8741
5829,2017-5-3,Brooklyn Nets,82,19755,3102,6987,0.444,877,2591,0.338,2225,4396,0.506,1592,2020,0.788,721,2879,3600,1756,593,1307,1726,8673
5830,2017-5-3,Minnesota Timberwolves,82,19805,3235,6922,0.467,601,1723,0.349,2634,5199,0.507,1586,1986,0.799,938,2540,3478,1940,654,1099,1646,8657
5831,2017-5-3,San Antonio Spurs,82,19805,3222,6864,0.469,753,1927,0.391,2469,4937,0.5,1440,1806,0.797,821,2777,3598,1954,655,1057,1498,8637
5832,2017-5-3,Indiana Pacers,82,19855,3221,6931,0.465,709,1885,0.376,2512,5046,0.498,1467,1811,0.81,742,2702,3444,1844,669,1087,1597,8618
5833,2017-5-3,Charlotte Hornets,82,19830,3093,7000,0.442,824,2347,0.351,2269,4653,0.488,1591,1953,0.815,721,2853,3574,1891,571,899,1360,8601
5834,2017-5-3,Los Angeles Lakers,82,19705,3224,7164,0.45,730,2110,0.346,2494,5054,0.493,1397,1853,0.754,933,2636,3569,1716,674,1193,1698,8575
5835,2017-5-3,New Orleans Pelicans,82,19905,3210,7130,0.45,768,2196,0.35,2442,4934,0.495,1368,1825,0.75,703,2879,3582,1869,638,1012,1490,8556
5836,2017-5-3,New York Knicks,82,19855,3244,7256,0.447,704,2022,0.348,2540,5234,0.485,1364,1731,0.788,983,2723,3706,1786,581,1081,1668,8556
5837,2017-5-3,Milwaukee Bucks,82,19780,3182,6715,0.474,720,1946,0.37,2462,4769,0.516,1413,1839,0.768,723,2589,3312,1984,666,1096,1660,8497
5838,2017-5-3,Atlanta Hawks,82,19880,3123,6918,0.451,729,2137,0.341,2394,4781,0.501,1484,2039,0.728,842,2793,3635,1938,672,1249,1491,8459
5839,2017-5-3,Miami Heat,82,19780,3202,7037,0.455,808,2213,0.365,2394,4824,0.496,1248,1768,0.706,872,2705,3577,1742,588,1033,1680,8460
5840,2017-5-3,Chicago Bulls,82,19780,3169,7141,0.444,623,1831,0.34,2546,5310,0.479,1474,1848,0.798,999,2797,3796,1851,643,1065,1455,8435
5841,2017-5-3,Sacramento Kings,82,19880,3105,6734,0.461,737,1960,0.376,2368,4774,0.496,1483,1913,0.775,715,2652,3367,1844,627,1157,1667,8430
5842,2017-5-3,Philadelphia 76ers,82,19830,3088,6992,0.442,831,2443,0.34,2257,4549,0.496,1393,1806,0.771,807,2706,3513,1949,692,1310,1793,8400
5843,2017-5-3,Detroit Pistons,82,19805,3269,7282,0.449,631,1915,0.33,2638,5367,0.492,1140,1586,0.719,908,2838,3746,1732,574,932,1467,8309
5844,2017-5-3,Orlando Magic,82,19805,3139,7133,0.44,701,2139,0.328,2438,4994,0.488,1309,1753,0.747,807,2734,3541,1820,580,1053,1584,8288
5845,2017-5-3,Utah Jazz,82,19755,3033,6515,0.466,791,2128,0.372,2242,4387,0.511,1401,1875,0.747,771,2774,3545,1651,550,1060,1545,8258
5846,2017-5-3,Memphis Grizzlies,82,19905,2984,6854,0.435,767,2169,0.354,2217,4685,0.473,1504,1918,0.784,886,2621,3507,1744,653,1019,1840,8239
5847,2017-5-3,Dallas Mavericks,82,19780,2968,6750,0.44,878,2473,0.355,2090,4277,0.489,1215,1516,0.801,647,2516,3163,1705,614,921,1567,8029
5848,2017-5-4,Golden State Warriors,82,19780,3532,7140,0.495,982,2562,0.383,2550,4578,0.557,1457,1850,0.788,770,2873,3643,2491,785,1182,1585,9503
5849,2017-5-4,Houston Rockets,82,19780,3305,7152,0.462,1181,3306,0.357,2124,3846,0.552,1667,2177,0.766,892,2746,3638,2070,670,1188,1634,9458
5850,2017-5-4,Denver Nuggets,82,19755,3377,7194,0.469,870,2365,0.368,2507,4829,0.519,1537,1986,0.774,966,2837,3803,2077,568,1186,1567,9161
5851,2017-5-4,Cleveland Cavaliers,82,19880,3275,6963,0.47,1067,2779,0.384,2208,4184,0.528,1431,1913,0.748,766,2821,3587,1858,539,1081,1486,9048
5852,2017-5-4,Washington Wizards,82,19855,3388,7137,0.475,756,2030,0.372,2632,5107,0.515,1421,1812,0.784,843,2671,3514,1956,693,1103,1745,8953
5853,2017-5-4,Los Angeles Clippers,82,19755,3242,6820,0.475,841,2245,0.375,2401,4575,0.525,1586,2128,0.745,738,2790,3528,1848,612,1022,1626,8911
5854,2017-5-4,Boston Celtics,82,19755,3168,6978,0.454,985,2742,0.359,2183,4236,0.515,1536,1903,0.807,744,2698,3442,2069,617,1037,1686,8857
5855,2017-5-4,Portland Trail Blazers,82,19930,3243,7059,0.459,852,2272,0.375,2391,4787,0.499,1513,1940,0.78,830,2750,3580,1733,574,1077,1736,8851
5856,2017-5-4,Phoenix Suns,82,19830,3270,7260,0.45,615,1854,0.332,2655,5406,0.491,1676,2159,0.776,976,2712,3688,1604,673,1223,2030,8831
5857,2017-5-4,Toronto Raptors,82,19780,3211,6918,0.464,725,1996,0.363,2486,4922,0.505,1615,2028,0.796,871,2676,3547,1517,677,969,1708,8762
5858,2017-5-4,Oklahoma City Thunder,82,19805,3237,7169,0.452,692,2116,0.327,2545,5053,0.504,1575,2113,0.745,1002,2821,3823,1721,648,1199,1715,8741
5859,2017-5-4,Brooklyn Nets,82,19755,3102,6987,0.444,877,2591,0.338,2225,4396,0.506,1592,2020,0.788,721,2879,3600,1756,593,1307,1726,8673
5860,2017-5-4,Minnesota Timberwolves,82,19805,3235,6922,0.467,601,1723,0.349,2634,5199,0.507,1586,1986,0.799,938,2540,3478,1940,654,1099,1646,8657
5861,2017-5-4,San Antonio Spurs,82,19805,3222,6864,0.469,753,1927,0.391,2469,4937,0.5,1440,1806,0.797,821,2777,3598,1954,655,1057,1498,8637
5862,2017-5-4,Indiana Pacers,82,19855,3221,6931,0.465,709,1885,0.376,2512,5046,0.498,1467,1811,0.81,742,2702,3444,1844,669,1087,1597,8618
5863,2017-5-4,Charlotte Hornets,82,19830,3093,7000,0.442,824,2347,0.351,2269,4653,0.488,1591,1953,0.815,721,2853,3574,1891,571,899,1360,8601
5864,2017-5-4,Los Angeles Lakers,82,19705,3224,7164,0.45,730,2110,0.346,2494,5054,0.493,1397,1853,0.754,933,2636,3569,1716,674,1193,1698,8575
5865,2017-5-4,New Orleans Pelicans,82,19905,3210,7130,0.45,768,2196,0.35,2442,4934,0.495,1368,1825,0.75,703,2879,3582,1869,638,1012,1490,8556
5866,2017-5-4,New York Knicks,82,19855,3244,7256,0.447,704,2022,0.348,2540,5234,0.485,1364,1731,0.788,983,2723,3706,1786,581,1081,1668,8556
5867,2017-5-4,Milwaukee Bucks,82,19780,3182,6715,0.474,720,1946,0.37,2462,4769,0.516,1413,1839,0.768,723,2589,3312,1984,666,1096,1660,8497
5868,2017-5-4,Atlanta Hawks,82,19880,3123,6918,0.451,729,2137,0.341,2394,4781,0.501,1484,2039,0.728,842,2793,3635,1938,672,1249,1491,8459
5869,2017-5-4,Miami Heat,82,19780,3202,7037,0.455,808,2213,0.365,2394,4824,0.496,1248,1768,0.706,872,2705,3577,1742,588,1033,1680,8460
5870,2017-5-4,Chicago Bulls,82,19780,3169,7141,0.444,623,1831,0.34,2546,5310,0.479,1474,1848,0.798,999,2797,3796,1851,643,1065,1455,8435
5871,2017-5-4,Sacramento Kings,82,19880,3105,6734,0.461,737,1960,0.376,2368,4774,0.496,1483,1913,0.775,715,2652,3367,1844,627,1157,1667,8430
5872,2017-5-4,Philadelphia 76ers,82,19830,3088,6992,0.442,831,2443,0.34,2257,4549,0.496,1393,1806,0.771,807,2706,3513,1949,692,1310,1793,8400
5873,2017-5-4,Detroit Pistons,82,19805,3269,7282,0.449,631,1915,0.33,2638,5367,0.492,1140,1586,0.719,908,2838,3746,1732,574,932,1467,8309
5874,2017-5-4,Orlando Magic,82,19805,3139,7133,0.44,701,2139,0.328,2438,4994,0.488,1309,1753,0.747,807,2734,3541,1820,580,1053,1584,8288
5875,2017-5-4,Utah Jazz,82,19755,3033,6515,0.466,791,2128,0.372,2242,4387,0.511,1401,1875,0.747,771,2774,3545,1651,550,1060,1545,8258
5876,2017-5-4,Memphis Grizzlies,82,19905,2984,6854,0.435,767,2169,0.354,2217,4685,0.473,1504,1918,0.784,886,2621,3507,1744,653,1019,1840,8239
5877,2017-5-4,Dallas Mavericks,82,19780,2968,6750,0.44,878,2473,0.355,2090,4277,0.489,1215,1516,0.801,647,2516,3163,1705,614,921,1567,8029
5878,2017-5-5,Golden State Warriors,82,19780,3532,7140,0.495,982,2562,0.383,2550,4578,0.557,1457,1850,0.788,770,2873,3643,2491,785,1182,1585,9503
5879,2017-5-5,Houston Rockets,82,19780,3305,7152,0.462,1181,3306,0.357,2124,3846,0.552,1667,2177,0.766,892,2746,3638,2070,670,1188,1634,9458
5880,2017-5-5,Denver Nuggets,82,19755,3377,7194,0.469,870,2365,0.368,2507,4829,0.519,1537,1986,0.774,966,2837,3803,2077,568,1186,1567,9161
5881,2017-5-5,Cleveland Cavaliers,82,19880,3275,6963,0.47,1067,2779,0.384,2208,4184,0.528,1431,1913,0.748,766,2821,3587,1858,539,1081,1486,9048
5882,2017-5-5,Washington Wizards,82,19855,3388,7137,0.475,756,2030,0.372,2632,5107,0.515,1421,1812,0.784,843,2671,3514,1956,693,1103,1745,8953
5883,2017-5-5,Los Angeles Clippers,82,19755,3242,6820,0.475,841,2245,0.375,2401,4575,0.525,1586,2128,0.745,738,2790,3528,1848,612,1022,1626,8911
5884,2017-5-5,Boston Celtics,82,19755,3168,6978,0.454,985,2742,0.359,2183,4236,0.515,1536,1903,0.807,744,2698,3442,2069,617,1037,1686,8857
5885,2017-5-5,Portland Trail Blazers,82,19930,3243,7059,0.459,852,2272,0.375,2391,4787,0.499,1513,1940,0.78,830,2750,3580,1733,574,1077,1736,8851
5886,2017-5-5,Phoenix Suns,82,19830,3270,7260,0.45,615,1854,0.332,2655,5406,0.491,1676,2159,0.776,976,2712,3688,1604,673,1223,2030,8831
5887,2017-5-5,Toronto Raptors,82,19780,3211,6918,0.464,725,1996,0.363,2486,4922,0.505,1615,2028,0.796,871,2676,3547,1517,677,969,1708,8762
5888,2017-5-5,Oklahoma City Thunder,82,19805,3237,7169,0.452,692,2116,0.327,2545,5053,0.504,1575,2113,0.745,1002,2821,3823,1721,648,1199,1715,8741
5889,2017-5-5,Brooklyn Nets,82,19755,3102,6987,0.444,877,2591,0.338,2225,4396,0.506,1592,2020,0.788,721,2879,3600,1756,593,1307,1726,8673
5890,2017-5-5,Minnesota Timberwolves,82,19805,3235,6922,0.467,601,1723,0.349,2634,5199,0.507,1586,1986,0.799,938,2540,3478,1940,654,1099,1646,8657
5891,2017-5-5,San Antonio Spurs,82,19805,3222,6864,0.469,753,1927,0.391,2469,4937,0.5,1440,1806,0.797,821,2777,3598,1954,655,1057,1498,8637
5892,2017-5-5,Indiana Pacers,82,19855,3221,6931,0.465,709,1885,0.376,2512,5046,0.498,1467,1811,0.81,742,2702,3444,1844,669,1087,1597,8618
5893,2017-5-5,Charlotte Hornets,82,19830,3093,7000,0.442,824,2347,0.351,2269,4653,0.488,1591,1953,0.815,721,2853,3574,1891,571,899,1360,8601
5894,2017-5-5,Los Angeles Lakers,82,19705,3224,7164,0.45,730,2110,0.346,2494,5054,0.493,1397,1853,0.754,933,2636,3569,1716,674,1193,1698,8575
5895,2017-5-5,New Orleans Pelicans,82,19905,3210,7130,0.45,768,2196,0.35,2442,4934,0.495,1368,1825,0.75,703,2879,3582,1869,638,1012,1490,8556
5896,2017-5-5,New York Knicks,82,19855,3244,7256,0.447,704,2022,0.348,2540,5234,0.485,1364,1731,0.788,983,2723,3706,1786,581,1081,1668,8556
5897,2017-5-5,Milwaukee Bucks,82,19780,3182,6715,0.474,720,1946,0.37,2462,4769,0.516,1413,1839,0.768,723,2589,3312,1984,666,1096,1660,8497
5898,2017-5-5,Atlanta Hawks,82,19880,3123,6918,0.451,729,2137,0.341,2394,4781,0.501,1484,2039,0.728,842,2793,3635,1938,672,1249,1491,8459
5899,2017-5-5,Miami Heat,82,19780,3202,7037,0.455,808,2213,0.365,2394,4824,0.496,1248,1768,0.706,872,2705,3577,1742,588,1033,1680,8460
5900,2017-5-5,Chicago Bulls,82,19780,3169,7141,0.444,623,1831,0.34,2546,5310,0.479,1474,1848,0.798,999,2797,3796,1851,643,1065,1455,8435
5901,2017-5-5,Sacramento Kings,82,19880,3105,6734,0.461,737,1960,0.376,2368,4774,0.496,1483,1913,0.775,715,2652,3367,1844,627,1157,1667,8430
5902,2017-5-5,Philadelphia 76ers,82,19830,3088,6992,0.442,831,2443,0.34,2257,4549,0.496,1393,1806,0.771,807,2706,3513,1949,692,1310,1793,8400
5903,2017-5-5,Detroit Pistons,82,19805,3269,7282,0.449,631,1915,0.33,2638,5367,0.492,1140,1586,0.719,908,2838,3746,1732,574,932,1467,8309
5904,2017-5-5,Orlando Magic,82,19805,3139,7133,0.44,701,2139,0.328,2438,4994,0.488,1309,1753,0.747,807,2734,3541,1820,580,1053,1584,8288
5905,2017-5-5,Utah Jazz,82,19755,3033,6515,0.466,791,2128,0.372,2242,4387,0.511,1401,1875,0.747,771,2774,3545,1651,550,1060,1545,8258
5906,2017-5-5,Memphis Grizzlies,82,19905,2984,6854,0.435,767,2169,0.354,2217,4685,0.473,1504,1918,0.784,886,2621,3507,1744,653,1019,1840,8239
5907,2017-5-5,Dallas Mavericks,82,19780,2968,6750,0.44,878,2473,0.355,2090,4277,0.489,1215,1516,0.801,647,2516,3163,1705,614,921,1567,8029
5908,2017-5-6,Golden State Warriors,82,19780,3532,7140,0.495,982,2562,0.383,2550,4578,0.557,1457,1850,0.788,770,2873,3643,2491,785,1182,1585,9503
5909,2017-5-6,Houston Rockets,82,19780,3305,7152,0.462,1181,3306,0.357,2124,3846,0.552,1667,2177,0.766,892,2746,3638,2070,670,1188,1634,9458
5910,2017-5-6,Denver Nuggets,82,19755,3377,7194,0.469,870,2365,0.368,2507,4829,0.519,1537,1986,0.774,966,2837,3803,2077,568,1186,1567,9161
5911,2017-5-6,Cleveland Cavaliers,82,19880,3275,6963,0.47,1067,2779,0.384,2208,4184,0.528,1431,1913,0.748,766,2821,3587,1858,539,1081,1486,9048
5912,2017-5-6,Washington Wizards,82,19855,3388,7137,0.475,756,2030,0.372,2632,5107,0.515,1421,1812,0.784,843,2671,3514,1956,693,1103,1745,8953
5913,2017-5-6,Los Angeles Clippers,82,19755,3242,6820,0.475,841,2245,0.375,2401,4575,0.525,1586,2128,0.745,738,2790,3528,1848,612,1022,1626,8911
5914,2017-5-6,Boston Celtics,82,19755,3168,6978,0.454,985,2742,0.359,2183,4236,0.515,1536,1903,0.807,744,2698,3442,2069,617,1037,1686,8857
5915,2017-5-6,Portland Trail Blazers,82,19930,3243,7059,0.459,852,2272,0.375,2391,4787,0.499,1513,1940,0.78,830,2750,3580,1733,574,1077,1736,8851
5916,2017-5-6,Phoenix Suns,82,19830,3270,7260,0.45,615,1854,0.332,2655,5406,0.491,1676,2159,0.776,976,2712,3688,1604,673,1223,2030,8831
5917,2017-5-6,Toronto Raptors,82,19780,3211,6918,0.464,725,1996,0.363,2486,4922,0.505,1615,2028,0.796,871,2676,3547,1517,677,969,1708,8762
5918,2017-5-6,Oklahoma City Thunder,82,19805,3237,7169,0.452,692,2116,0.327,2545,5053,0.504,1575,2113,0.745,1002,2821,3823,1721,648,1199,1715,8741
5919,2017-5-6,Brooklyn Nets,82,19755,3102,6987,0.444,877,2591,0.338,2225,4396,0.506,1592,2020,0.788,721,2879,3600,1756,593,1307,1726,8673
5920,2017-5-6,Minnesota Timberwolves,82,19805,3235,6922,0.467,601,1723,0.349,2634,5199,0.507,1586,1986,0.799,938,2540,3478,1940,654,1099,1646,8657
5921,2017-5-6,San Antonio Spurs,82,19805,3222,6864,0.469,753,1927,0.391,2469,4937,0.5,1440,1806,0.797,821,2777,3598,1954,655,1057,1498,8637
5922,2017-5-6,Indiana Pacers,82,19855,3221,6931,0.465,709,1885,0.376,2512,5046,0.498,1467,1811,0.81,742,2702,3444,1844,669,1087,1597,8618
5923,2017-5-6,Charlotte Hornets,82,19830,3093,7000,0.442,824,2347,0.351,2269,4653,0.488,1591,1953,0.815,721,2853,3574,1891,571,899,1360,8601
5924,2017-5-6,Los Angeles Lakers,82,19705,3224,7164,0.45,730,2110,0.346,2494,5054,0.493,1397,1853,0.754,933,2636,3569,1716,674,1193,1698,8575
5925,2017-5-6,New Orleans Pelicans,82,19905,3210,7130,0.45,768,2196,0.35,2442,4934,0.495,1368,1825,0.75,703,2879,3582,1869,638,1012,1490,8556
5926,2017-5-6,New York Knicks,82,19855,3244,7256,0.447,704,2022,0.348,2540,5234,0.485,1364,1731,0.788,983,2723,3706,1786,581,1081,1668,8556
5927,2017-5-6,Milwaukee Bucks,82,19780,3182,6715,0.474,720,1946,0.37,2462,4769,0.516,1413,1839,0.768,723,2589,3312,1984,666,1096,1660,8497
5928,2017-5-6,Atlanta Hawks,82,19880,3123,6918,0.451,729,2137,0.341,2394,4781,0.501,1484,2039,0.728,842,2793,3635,1938,672,1249,1491,8459
5929,2017-5-6,Miami Heat,82,19780,3202,7037,0.455,808,2213,0.365,2394,4824,0.496,1248,1768,0.706,872,2705,3577,1742,588,1033,1680,8460
5930,2017-5-6,Chicago Bulls,82,19780,3169,7141,0.444,623,1831,0.34,2546,5310,0.479,1474,1848,0.798,999,2797,3796,1851,643,1065,1455,8435
5931,2017-5-6,Sacramento Kings,82,19880,3105,6734,0.461,737,1960,0.376,2368,4774,0.496,1483,1913,0.775,715,2652,3367,1844,627,1157,1667,8430
5932,2017-5-6,Philadelphia 76ers,82,19830,3088,6992,0.442,831,2443,0.34,2257,4549,0.496,1393,1806,0.771,807,2706,3513,1949,692,1310,1793,8400
5933,2017-5-6,Detroit Pistons,82,19805,3269,7282,0.449,631,1915,0.33,2638,5367,0.492,1140,1586,0.719,908,2838,3746,1732,574,932,1467,8309
5934,2017-5-6,Orlando Magic,82,19805,3139,7133,0.44,701,2139,0.328,2438,4994,0.488,1309,1753,0.747,807,2734,3541,1820,580,1053,1584,8288
5935,2017-5-6,Utah Jazz,82,19755,3033,6515,0.466,791,2128,0.372,2242,4387,0.511,1401,1875,0.747,771,2774,3545,1651,550,1060,1545,8258
5936,2017-5-6,Memphis Grizzlies,82,19905,2984,6854,0.435,767,2169,0.354,2217,4685,0.473,1504,1918,0.784,886,2621,3507,1744,653,1019,1840,8239
5937,2017-5-6,Dallas Mavericks,82,19780,2968,6750,0.44,878,2473,0.355,2090,4277,0.489,1215,1516,0.801,647,2516,3163,1705,614,921,1567,8029
5938,2017-5-7,Golden State Warriors,82,19780,3532,7140,0.495,982,2562,0.383,2550,4578,0.557,1457,1850,0.788,770,2873,3643,2491,785,1182,1585,9503
5939,2017-5-7,Houston Rockets,82,19780,3305,7152,0.462,1181,3306,0.357,2124,3846,0.552,1667,2177,0.766,892,2746,3638,2070,670,1188,1634,9458
5940,2017-5-7,Denver Nuggets,82,19755,3377,7194,0.469,870,2365,0.368,2507,4829,0.519,1537,1986,0.774,966,2837,3803,2077,568,1186,1567,9161
5941,2017-5-7,Cleveland Cavaliers,82,19880,3275,6963,0.47,1067,2779,0.384,2208,4184,0.528,1431,1913,0.748,766,2821,3587,1858,539,1081,1486,9048
5942,2017-5-7,Washington Wizards,82,19855,3388,7137,0.475,756,2030,0.372,2632,5107,0.515,1421,1812,0.784,843,2671,3514,1956,693,1103,1745,8953
5943,2017-5-7,Los Angeles Clippers,82,19755,3242,6820,0.475,841,2245,0.375,2401,4575,0.525,1586,2128,0.745,738,2790,3528,1848,612,1022,1626,8911
5944,2017-5-7,Boston Celtics,82,19755,3168,6978,0.454,985,2742,0.359,2183,4236,0.515,1536,1903,0.807,744,2698,3442,2069,617,1037,1686,8857
5945,2017-5-7,Portland Trail Blazers,82,19930,3243,7059,0.459,852,2272,0.375,2391,4787,0.499,1513,1940,0.78,830,2750,3580,1733,574,1077,1736,8851
5946,2017-5-7,Phoenix Suns,82,19830,3270,7260,0.45,615,1854,0.332,2655,5406,0.491,1676,2159,0.776,976,2712,3688,1604,673,1223,2030,8831
5947,2017-5-7,Toronto Raptors,82,19780,3211,6918,0.464,725,1996,0.363,2486,4922,0.505,1615,2028,0.796,871,2676,3547,1517,677,969,1708,8762
5948,2017-5-7,Oklahoma City Thunder,82,19805,3237,7169,0.452,692,2116,0.327,2545,5053,0.504,1575,2113,0.745,1002,2821,3823,1721,648,1199,1715,8741
5949,2017-5-7,Brooklyn Nets,82,19755,3102,6987,0.444,877,2591,0.338,2225,4396,0.506,1592,2020,0.788,721,2879,3600,1756,593,1307,1726,8673
5950,2017-5-7,Minnesota Timberwolves,82,19805,3235,6922,0.467,601,1723,0.349,2634,5199,0.507,1586,1986,0.799,938,2540,3478,1940,654,1099,1646,8657
5951,2017-5-7,San Antonio Spurs,82,19805,3222,6864,0.469,753,1927,0.391,2469,4937,0.5,1440,1806,0.797,821,2777,3598,1954,655,1057,1498,8637
5952,2017-5-7,Indiana Pacers,82,19855,3221,6931,0.465,709,1885,0.376,2512,5046,0.498,1467,1811,0.81,742,2702,3444,1844,669,1087,1597,8618
5953,2017-5-7,Charlotte Hornets,82,19830,3093,7000,0.442,824,2347,0.351,2269,4653,0.488,1591,1953,0.815,721,2853,3574,1891,571,899,1360,8601
5954,2017-5-7,Los Angeles Lakers,82,19705,3224,7164,0.45,730,2110,0.346,2494,5054,0.493,1397,1853,0.754,933,2636,3569,1716,674,1193,1698,8575
5955,2017-5-7,New Orleans Pelicans,82,19905,3210,7130,0.45,768,2196,0.35,2442,4934,0.495,1368,1825,0.75,703,2879,3582,1869,638,1012,1490,8556
5956,2017-5-7,New York Knicks,82,19855,3244,7256,0.447,704,2022,0.348,2540,5234,0.485,1364,1731,0.788,983,2723,3706,1786,581,1081,1668,8556
5957,2017-5-7,Milwaukee Bucks,82,19780,3182,6715,0.474,720,1946,0.37,2462,4769,0.516,1413,1839,0.768,723,2589,3312,1984,666,1096,1660,8497
5958,2017-5-7,Atlanta Hawks,82,19880,3123,6918,0.451,729,2137,0.341,2394,4781,0.501,1484,2039,0.728,842,2793,3635,1938,672,1249,1491,8459
5959,2017-5-7,Miami Heat,82,19780,3202,7037,0.455,808,2213,0.365,2394,4824,0.496,1248,1768,0.706,872,2705,3577,1742,588,1033,1680,8460
5960,2017-5-7,Chicago Bulls,82,19780,3169,7141,0.444,623,1831,0.34,2546,5310,0.479,1474,1848,0.798,999,2797,3796,1851,643,1065,1455,8435
5961,2017-5-7,Sacramento Kings,82,19880,3105,6734,0.461,737,1960,0.376,2368,4774,0.496,1483,1913,0.775,715,2652,3367,1844,627,1157,1667,8430
5962,2017-5-7,Philadelphia 76ers,82,19830,3088,6992,0.442,831,2443,0.34,2257,4549,0.496,1393,1806,0.771,807,2706,3513,1949,692,1310,1793,8400
5963,2017-5-7,Detroit Pistons,82,19805,3269,7282,0.449,631,1915,0.33,2638,5367,0.492,1140,1586,0.719,908,2838,3746,1732,574,932,1467,8309
5964,2017-5-7,Orlando Magic,82,19805,3139,7133,0.44,701,2139,0.328,2438,4994,0.488,1309,1753,0.747,807,2734,3541,1820,580,1053,1584,8288
5965,2017-5-7,Utah Jazz,82,19755,3033,6515,0.466,791,2128,0.372,2242,4387,0.511,1401,1875,0.747,771,2774,3545,1651,550,1060,1545,8258
5966,2017-5-7,Memphis Grizzlies,82,19905,2984,6854,0.435,767,2169,0.354,2217,4685,0.473,1504,1918,0.784,886,2621,3507,1744,653,1019,1840,8239
5967,2017-5-7,Dallas Mavericks,82,19780,2968,6750,0.44,878,2473,0.355,2090,4277,0.489,1215,1516,0.801,647,2516,3163,1705,614,921,1567,8029
5968,2017-5-8,Golden State Warriors,82,19780,3532,7140,0.495,982,2562,0.383,2550,4578,0.557,1457,1850,0.788,770,2873,3643,2491,785,1182,1585,9503
5969,2017-5-8,Houston Rockets,82,19780,3305,7152,0.462,1181,3306,0.357,2124,3846,0.552,1667,2177,0.766,892,2746,3638,2070,670,1188,1634,9458
5970,2017-5-8,Denver Nuggets,82,19755,3377,7194,0.469,870,2365,0.368,2507,4829,0.519,1537,1986,0.774,966,2837,3803,2077,568,1186,1567,9161
5971,2017-5-8,Cleveland Cavaliers,82,19880,3275,6963,0.47,1067,2779,0.384,2208,4184,0.528,1431,1913,0.748,766,2821,3587,1858,539,1081,1486,9048
5972,2017-5-8,Washington Wizards,82,19855,3388,7137,0.475,756,2030,0.372,2632,5107,0.515,1421,1812,0.784,843,2671,3514,1956,693,1103,1745,8953
5973,2017-5-8,Los Angeles Clippers,82,19755,3242,6820,0.475,841,2245,0.375,2401,4575,0.525,1586,2128,0.745,738,2790,3528,1848,612,1022,1626,8911
5974,2017-5-8,Boston Celtics,82,19755,3168,6978,0.454,985,2742,0.359,2183,4236,0.515,1536,1903,0.807,744,2698,3442,2069,617,1037,1686,8857
5975,2017-5-8,Portland Trail Blazers,82,19930,3243,7059,0.459,852,2272,0.375,2391,4787,0.499,1513,1940,0.78,830,2750,3580,1733,574,1077,1736,8851
5976,2017-5-8,Phoenix Suns,82,19830,3270,7260,0.45,615,1854,0.332,2655,5406,0.491,1676,2159,0.776,976,2712,3688,1604,673,1223,2030,8831
5977,2017-5-8,Toronto Raptors,82,19780,3211,6918,0.464,725,1996,0.363,2486,4922,0.505,1615,2028,0.796,871,2676,3547,1517,677,969,1708,8762
5978,2017-5-8,Oklahoma City Thunder,82,19805,3237,7169,0.452,692,2116,0.327,2545,5053,0.504,1575,2113,0.745,1002,2821,3823,1721,648,1199,1715,8741
5979,2017-5-8,Brooklyn Nets,82,19755,3102,6987,0.444,877,2591,0.338,2225,4396,0.506,1592,2020,0.788,721,2879,3600,1756,593,1307,1726,8673
5980,2017-5-8,Minnesota Timberwolves,82,19805,3235,6922,0.467,601,1723,0.349,2634,5199,0.507,1586,1986,0.799,938,2540,3478,1940,654,1099,1646,8657
5981,2017-5-8,San Antonio Spurs,82,19805,3222,6864,0.469,753,1927,0.391,2469,4937,0.5,1440,1806,0.797,821,2777,3598,1954,655,1057,1498,8637
5982,2017-5-8,Indiana Pacers,82,19855,3221,6931,0.465,709,1885,0.376,2512,5046,0.498,1467,1811,0.81,742,2702,3444,1844,669,1087,1597,8618
5983,2017-5-8,Charlotte Hornets,82,19830,3093,7000,0.442,824,2347,0.351,2269,4653,0.488,1591,1953,0.815,721,2853,3574,1891,571,899,1360,8601
5984,2017-5-8,Los Angeles Lakers,82,19705,3224,7164,0.45,730,2110,0.346,2494,5054,0.493,1397,1853,0.754,933,2636,3569,1716,674,1193,1698,8575
5985,2017-5-8,New Orleans Pelicans,82,19905,3210,7130,0.45,768,2196,0.35,2442,4934,0.495,1368,1825,0.75,703,2879,3582,1869,638,1012,1490,8556
5986,2017-5-8,New York Knicks,82,19855,3244,7256,0.447,704,2022,0.348,2540,5234,0.485,1364,1731,0.788,983,2723,3706,1786,581,1081,1668,8556
5987,2017-5-8,Milwaukee Bucks,82,19780,3182,6715,0.474,720,1946,0.37,2462,4769,0.516,1413,1839,0.768,723,2589,3312,1984,666,1096,1660,8497
5988,2017-5-8,Atlanta Hawks,82,19880,3123,6918,0.451,729,2137,0.341,2394,4781,0.501,1484,2039,0.728,842,2793,3635,1938,672,1249,1491,8459
5989,2017-5-8,Miami Heat,82,19780,3202,7037,0.455,808,2213,0.365,2394,4824,0.496,1248,1768,0.706,872,2705,3577,1742,588,1033,1680,8460
5990,2017-5-8,Chicago Bulls,82,19780,3169,7141,0.444,623,1831,0.34,2546,5310,0.479,1474,1848,0.798,999,2797,3796,1851,643,1065,1455,8435
5991,2017-5-8,Sacramento Kings,82,19880,3105,6734,0.461,737,1960,0.376,2368,4774,0.496,1483,1913,0.775,715,2652,3367,1844,627,1157,1667,8430
5992,2017-5-8,Philadelphia 76ers,82,19830,3088,6992,0.442,831,2443,0.34,2257,4549,0.496,1393,1806,0.771,807,2706,3513,1949,692,1310,1793,8400
5993,2017-5-8,Detroit Pistons,82,19805,3269,7282,0.449,631,1915,0.33,2638,5367,0.492,1140,1586,0.719,908,2838,3746,1732,574,932,1467,8309
5994,2017-5-8,Orlando Magic,82,19805,3139,7133,0.44,701,2139,0.328,2438,4994,0.488,1309,1753,0.747,807,2734,3541,1820,580,1053,1584,8288
5995,2017-5-8,Utah Jazz,82,19755,3033,6515,0.466,791,2128,0.372,2242,4387,0.511,1401,1875,0.747,771,2774,3545,1651,550,1060,1545,8258
5996,2017-5-8,Memphis Grizzlies,82,19905,2984,6854,0.435,767,2169,0.354,2217,4685,0.473,1504,1918,0.784,886,2621,3507,1744,653,1019,1840,8239
5997,2017-5-8,Dallas Mavericks,82,19780,2968,6750,0.44,878,2473,0.355,2090,4277,0.489,1215,1516,0.801,647,2516,3163,1705,614,921,1567,8029
5998,2017-5-9,Golden State Warriors,82,19780,3532,7140,0.495,982,2562,0.383,2550,4578,0.557,1457,1850,0.788,770,2873,3643,2491,785,1182,1585,9503
5999,2017-5-9,Houston Rockets,82,19780,3305,7152,0.462,1181,3306,0.357,2124,3846,0.552,1667,2177,0.766,892,2746,3638,2070,670,1188,1634,9458
6000,2017-5-9,Denver Nuggets,82,19755,3377,7194,0.469,870,2365,0.368,2507,4829,0.519,1537,1986,0.774,966,2837,3803,2077,568,1186,1567,9161
6001,2017-5-9,Cleveland Cavaliers,82,19880,3275,6963,0.47,1067,2779,0.384,2208,4184,0.528,1431,1913,0.748,766,2821,3587,1858,539,1081,1486,9048
6002,2017-5-9,Washington Wizards,82,19855,3388,7137,0.475,756,2030,0.372,2632,5107,0.515,1421,1812,0.784,843,2671,3514,1956,693,1103,1745,8953
6003,2017-5-9,Los Angeles Clippers,82,19755,3242,6820,0.475,841,2245,0.375,2401,4575,0.525,1586,2128,0.745,738,2790,3528,1848,612,1022,1626,8911
6004,2017-5-9,Boston Celtics,82,19755,3168,6978,0.454,985,2742,0.359,2183,4236,0.515,1536,1903,0.807,744,2698,3442,2069,617,1037,1686,8857
6005,2017-5-9,Portland Trail Blazers,82,19930,3243,7059,0.459,852,2272,0.375,2391,4787,0.499,1513,1940,0.78,830,2750,3580,1733,574,1077,1736,8851
6006,2017-5-9,Phoenix Suns,82,19830,3270,7260,0.45,615,1854,0.332,2655,5406,0.491,1676,2159,0.776,976,2712,3688,1604,673,1223,2030,8831
6007,2017-5-9,Toronto Raptors,82,19780,3211,6918,0.464,725,1996,0.363,2486,4922,0.505,1615,2028,0.796,871,2676,3547,1517,677,969,1708,8762
6008,2017-5-9,Oklahoma City Thunder,82,19805,3237,7169,0.452,692,2116,0.327,2545,5053,0.504,1575,2113,0.745,1002,2821,3823,1721,648,1199,1715,8741
6009,2017-5-9,Brooklyn Nets,82,19755,3102,6987,0.444,877,2591,0.338,2225,4396,0.506,1592,2020,0.788,721,2879,3600,1756,593,1307,1726,8673
6010,2017-5-9,Minnesota Timberwolves,82,19805,3235,6922,0.467,601,1723,0.349,2634,5199,0.507,1586,1986,0.799,938,2540,3478,1940,654,1099,1646,8657
6011,2017-5-9,San Antonio Spurs,82,19805,3222,6864,0.469,753,1927,0.391,2469,4937,0.5,1440,1806,0.797,821,2777,3598,1954,655,1057,1498,8637
6012,2017-5-9,Indiana Pacers,82,19855,3221,6931,0.465,709,1885,0.376,2512,5046,0.498,1467,1811,0.81,742,2702,3444,1844,669,1087,1597,8618
6013,2017-5-9,Charlotte Hornets,82,19830,3093,7000,0.442,824,2347,0.351,2269,4653,0.488,1591,1953,0.815,721,2853,3574,1891,571,899,1360,8601
6014,2017-5-9,Los Angeles Lakers,82,19705,3224,7164,0.45,730,2110,0.346,2494,5054,0.493,1397,1853,0.754,933,2636,3569,1716,674,1193,1698,8575
6015,2017-5-9,New Orleans Pelicans,82,19905,3210,7130,0.45,768,2196,0.35,2442,4934,0.495,1368,1825,0.75,703,2879,3582,1869,638,1012,1490,8556
6016,2017-5-9,New York Knicks,82,19855,3244,7256,0.447,704,2022,0.348,2540,5234,0.485,1364,1731,0.788,983,2723,3706,1786,581,1081,1668,8556
6017,2017-5-9,Milwaukee Bucks,82,19780,3182,6715,0.474,720,1946,0.37,2462,4769,0.516,1413,1839,0.768,723,2589,3312,1984,666,1096,1660,8497
6018,2017-5-9,Atlanta Hawks,82,19880,3123,6918,0.451,729,2137,0.341,2394,4781,0.501,1484,2039,0.728,842,2793,3635,1938,672,1249,1491,8459
6019,2017-5-9,Miami Heat,82,19780,3202,7037,0.455,808,2213,0.365,2394,4824,0.496,1248,1768,0.706,872,2705,3577,1742,588,1033,1680,8460
6020,2017-5-9,Chicago Bulls,82,19780,3169,7141,0.444,623,1831,0.34,2546,5310,0.479,1474,1848,0.798,999,2797,3796,1851,643,1065,1455,8435
6021,2017-5-9,Sacramento Kings,82,19880,3105,6734,0.461,737,1960,0.376,2368,4774,0.496,1483,1913,0.775,715,2652,3367,1844,627,1157,1667,8430
6022,2017-5-9,Philadelphia 76ers,82,19830,3088,6992,0.442,831,2443,0.34,2257,4549,0.496,1393,1806,0.771,807,2706,3513,1949,692,1310,1793,8400
6023,2017-5-9,Detroit Pistons,82,19805,3269,7282,0.449,631,1915,0.33,2638,5367,0.492,1140,1586,0.719,908,2838,3746,1732,574,932,1467,8309
6024,2017-5-9,Orlando Magic,82,19805,3139,7133,0.44,701,2139,0.328,2438,4994,0.488,1309,1753,0.747,807,2734,3541,1820,580,1053,1584,8288
6025,2017-5-9,Utah Jazz,82,19755,3033,6515,0.466,791,2128,0.372,2242,4387,0.511,1401,1875,0.747,771,2774,3545,1651,550,1060,1545,8258
6026,2017-5-9,Memphis Grizzlies,82,19905,2984,6854,0.435,767,2169,0.354,2217,4685,0.473,1504,1918,0.784,886,2621,3507,1744,653,1019,1840,8239
6027,2017-5-9,Dallas Mavericks,82,19780,2968,6750,0.44,878,2473,0.355,2090,4277,0.489,1215,1516,0.801,647,2516,3163,1705,614,921,1567,8029
6028,2017-5-10,Golden State Warriors,82,19780,3532,7140,0.495,982,2562,0.383,2550,4578,0.557,1457,1850,0.788,770,2873,3643,2491,785,1182,1585,9503
6029,2017-5-10,Houston Rockets,82,19780,3305,7152,0.462,1181,3306,0.357,2124,3846,0.552,1667,2177,0.766,892,2746,3638,2070,670,1188,1634,9458
6030,2017-5-10,Denver Nuggets,82,19755,3377,7194,0.469,870,2365,0.368,2507,4829,0.519,1537,1986,0.774,966,2837,3803,2077,568,1186,1567,9161
6031,2017-5-10,Cleveland Cavaliers,82,19880,3275,6963,0.47,1067,2779,0.384,2208,4184,0.528,1431,1913,0.748,766,2821,3587,1858,539,1081,1486,9048
6032,2017-5-10,Washington Wizards,82,19855,3388,7137,0.475,756,2030,0.372,2632,5107,0.515,1421,1812,0.784,843,2671,3514,1956,693,1103,1745,8953
6033,2017-5-10,Los Angeles Clippers,82,19755,3242,6820,0.475,841,2245,0.375,2401,4575,0.525,1586,2128,0.745,738,2790,3528,1848,612,1022,1626,8911
6034,2017-5-10,Boston Celtics,82,19755,3168,6978,0.454,985,2742,0.359,2183,4236,0.515,1536,1903,0.807,744,2698,3442,2069,617,1037,1686,8857
6035,2017-5-10,Portland Trail Blazers,82,19930,3243,7059,0.459,852,2272,0.375,2391,4787,0.499,1513,1940,0.78,830,2750,3580,1733,574,1077,1736,8851
6036,2017-5-10,Phoenix Suns,82,19830,3270,7260,0.45,615,1854,0.332,2655,5406,0.491,1676,2159,0.776,976,2712,3688,1604,673,1223,2030,8831
6037,2017-5-10,Toronto Raptors,82,19780,3211,6918,0.464,725,1996,0.363,2486,4922,0.505,1615,2028,0.796,871,2676,3547,1517,677,969,1708,8762
6038,2017-5-10,Oklahoma City Thunder,82,19805,3237,7169,0.452,692,2116,0.327,2545,5053,0.504,1575,2113,0.745,1002,2821,3823,1721,648,1199,1715,8741
6039,2017-5-10,Brooklyn Nets,82,19755,3102,6987,0.444,877,2591,0.338,2225,4396,0.506,1592,2020,0.788,721,2879,3600,1756,593,1307,1726,8673
6040,2017-5-10,Minnesota Timberwolves,82,19805,3235,6922,0.467,601,1723,0.349,2634,5199,0.507,1586,1986,0.799,938,2540,3478,1940,654,1099,1646,8657
6041,2017-5-10,San Antonio Spurs,82,19805,3222,6864,0.469,753,1927,0.391,2469,4937,0.5,1440,1806,0.797,821,2777,3598,1954,655,1057,1498,8637
6042,2017-5-10,Indiana Pacers,82,19855,3221,6931,0.465,709,1885,0.376,2512,5046,0.498,1467,1811,0.81,742,2702,3444,1844,669,1087,1597,8618
6043,2017-5-10,Charlotte Hornets,82,19830,3093,7000,0.442,824,2347,0.351,2269,4653,0.488,1591,1953,0.815,721,2853,3574,1891,571,899,1360,8601
6044,2017-5-10,Los Angeles Lakers,82,19705,3224,7164,0.45,730,2110,0.346,2494,5054,0.493,1397,1853,0.754,933,2636,3569,1716,674,1193,1698,8575
6045,2017-5-10,New Orleans Pelicans,82,19905,3210,7130,0.45,768,2196,0.35,2442,4934,0.495,1368,1825,0.75,703,2879,3582,1869,638,1012,1490,8556
6046,2017-5-10,New York Knicks,82,19855,3244,7256,0.447,704,2022,0.348,2540,5234,0.485,1364,1731,0.788,983,2723,3706,1786,581,1081,1668,8556
6047,2017-5-10,Milwaukee Bucks,82,19780,3182,6715,0.474,720,1946,0.37,2462,4769,0.516,1413,1839,0.768,723,2589,3312,1984,666,1096,1660,8497
6048,2017-5-10,Atlanta Hawks,82,19880,3123,6918,0.451,729,2137,0.341,2394,4781,0.501,1484,2039,0.728,842,2793,3635,1938,672,1249,1491,8459
6049,2017-5-10,Miami Heat,82,19780,3202,7037,0.455,808,2213,0.365,2394,4824,0.496,1248,1768,0.706,872,2705,3577,1742,588,1033,1680,8460
6050,2017-5-10,Chicago Bulls,82,19780,3169,7141,0.444,623,1831,0.34,2546,5310,0.479,1474,1848,0.798,999,2797,3796,1851,643,1065,1455,8435
6051,2017-5-10,Sacramento Kings,82,19880,3105,6734,0.461,737,1960,0.376,2368,4774,0.496,1483,1913,0.775,715,2652,3367,1844,627,1157,1667,8430
6052,2017-5-10,Philadelphia 76ers,82,19830,3088,6992,0.442,831,2443,0.34,2257,4549,0.496,1393,1806,0.771,807,2706,3513,1949,692,1310,1793,8400
6053,2017-5-10,Detroit Pistons,82,19805,3269,7282,0.449,631,1915,0.33,2638,5367,0.492,1140,1586,0.719,908,2838,3746,1732,574,932,1467,8309
6054,2017-5-10,Orlando Magic,82,19805,3139,7133,0.44,701,2139,0.328,2438,4994,0.488,1309,1753,0.747,807,2734,3541,1820,580,1053,1584,8288
6055,2017-5-10,Utah Jazz,82,19755,3033,6515,0.466,791,2128,0.372,2242,4387,0.511,1401,1875,0.747,771,2774,3545,1651,550,1060,1545,8258
6056,2017-5-10,Memphis Grizzlies,82,19905,2984,6854,0.435,767,2169,0.354,2217,4685,0.473,1504,1918,0.784,886,2621,3507,1744,653,1019,1840,8239
6057,2017-5-10,Dallas Mavericks,82,19780,2968,6750,0.44,878,2473,0.355,2090,4277,0.489,1215,1516,0.801,647,2516,3163,1705,614,921,1567,8029
6058,2017-5-11,Golden State Warriors,82,19780,3532,7140,0.495,982,2562,0.383,2550,4578,0.557,1457,1850,0.788,770,2873,3643,2491,785,1182,1585,9503
6059,2017-5-11,Houston Rockets,82,19780,3305,7152,0.462,1181,3306,0.357,2124,3846,0.552,1667,2177,0.766,892,2746,3638,2070,670,1188,1634,9458
6060,2017-5-11,Denver Nuggets,82,19755,3377,7194,0.469,870,2365,0.368,2507,4829,0.519,1537,1986,0.774,966,2837,3803,2077,568,1186,1567,9161
6061,2017-5-11,Cleveland Cavaliers,82,19880,3275,6963,0.47,1067,2779,0.384,2208,4184,0.528,1431,1913,0.748,766,2821,3587,1858,539,1081,1486,9048
6062,2017-5-11,Washington Wizards,82,19855,3388,7137,0.475,756,2030,0.372,2632,5107,0.515,1421,1812,0.784,843,2671,3514,1956,693,1103,1745,8953
6063,2017-5-11,Los Angeles Clippers,82,19755,3242,6820,0.475,841,2245,0.375,2401,4575,0.525,1586,2128,0.745,738,2790,3528,1848,612,1022,1626,8911
6064,2017-5-11,Boston Celtics,82,19755,3168,6978,0.454,985,2742,0.359,2183,4236,0.515,1536,1903,0.807,744,2698,3442,2069,617,1037,1686,8857
6065,2017-5-11,Portland Trail Blazers,82,19930,3243,7059,0.459,852,2272,0.375,2391,4787,0.499,1513,1940,0.78,830,2750,3580,1733,574,1077,1736,8851
6066,2017-5-11,Phoenix Suns,82,19830,3270,7260,0.45,615,1854,0.332,2655,5406,0.491,1676,2159,0.776,976,2712,3688,1604,673,1223,2030,8831
6067,2017-5-11,Toronto Raptors,82,19780,3211,6918,0.464,725,1996,0.363,2486,4922,0.505,1615,2028,0.796,871,2676,3547,1517,677,969,1708,8762
6068,2017-5-11,Oklahoma City Thunder,82,19805,3237,7169,0.452,692,2116,0.327,2545,5053,0.504,1575,2113,0.745,1002,2821,3823,1721,648,1199,1715,8741
6069,2017-5-11,Brooklyn Nets,82,19755,3102,6987,0.444,877,2591,0.338,2225,4396,0.506,1592,2020,0.788,721,2879,3600,1756,593,1307,1726,8673
6070,2017-5-11,Minnesota Timberwolves,82,19805,3235,6922,0.467,601,1723,0.349,2634,5199,0.507,1586,1986,0.799,938,2540,3478,1940,654,1099,1646,8657
6071,2017-5-11,San Antonio Spurs,82,19805,3222,6864,0.469,753,1927,0.391,2469,4937,0.5,1440,1806,0.797,821,2777,3598,1954,655,1057,1498,8637
6072,2017-5-11,Indiana Pacers,82,19855,3221,6931,0.465,709,1885,0.376,2512,5046,0.498,1467,1811,0.81,742,2702,3444,1844,669,1087,1597,8618
6073,2017-5-11,Charlotte Hornets,82,19830,3093,7000,0.442,824,2347,0.351,2269,4653,0.488,1591,1953,0.815,721,2853,3574,1891,571,899,1360,8601
6074,2017-5-11,Los Angeles Lakers,82,19705,3224,7164,0.45,730,2110,0.346,2494,5054,0.493,1397,1853,0.754,933,2636,3569,1716,674,1193,1698,8575
6075,2017-5-11,New Orleans Pelicans,82,19905,3210,7130,0.45,768,2196,0.35,2442,4934,0.495,1368,1825,0.75,703,2879,3582,1869,638,1012,1490,8556
6076,2017-5-11,New York Knicks,82,19855,3244,7256,0.447,704,2022,0.348,2540,5234,0.485,1364,1731,0.788,983,2723,3706,1786,581,1081,1668,8556
6077,2017-5-11,Milwaukee Bucks,82,19780,3182,6715,0.474,720,1946,0.37,2462,4769,0.516,1413,1839,0.768,723,2589,3312,1984,666,1096,1660,8497
6078,2017-5-11,Atlanta Hawks,82,19880,3123,6918,0.451,729,2137,0.341,2394,4781,0.501,1484,2039,0.728,842,2793,3635,1938,672,1249,1491,8459
6079,2017-5-11,Miami Heat,82,19780,3202,7037,0.455,808,2213,0.365,2394,4824,0.496,1248,1768,0.706,872,2705,3577,1742,588,1033,1680,8460
6080,2017-5-11,Chicago Bulls,82,19780,3169,7141,0.444,623,1831,0.34,2546,5310,0.479,1474,1848,0.798,999,2797,3796,1851,643,1065,1455,8435
6081,2017-5-11,Sacramento Kings,82,19880,3105,6734,0.461,737,1960,0.376,2368,4774,0.496,1483,1913,0.775,715,2652,3367,1844,627,1157,1667,8430
6082,2017-5-11,Philadelphia 76ers,82,19830,3088,6992,0.442,831,2443,0.34,2257,4549,0.496,1393,1806,0.771,807,2706,3513,1949,692,1310,1793,8400
6083,2017-5-11,Detroit Pistons,82,19805,3269,7282,0.449,631,1915,0.33,2638,5367,0.492,1140,1586,0.719,908,2838,3746,1732,574,932,1467,8309
6084,2017-5-11,Orlando Magic,82,19805,3139,7133,0.44,701,2139,0.328,2438,4994,0.488,1309,1753,0.747,807,2734,3541,1820,580,1053,1584,8288
6085,2017-5-11,Utah Jazz,82,19755,3033,6515,0.466,791,2128,0.372,2242,4387,0.511,1401,1875,0.747,771,2774,3545,1651,550,1060,1545,8258
6086,2017-5-11,Memphis Grizzlies,82,19905,2984,6854,0.435,767,2169,0.354,2217,4685,0.473,1504,1918,0.784,886,2621,3507,1744,653,1019,1840,8239
6087,2017-5-11,Dallas Mavericks,82,19780,2968,6750,0.44,878,2473,0.355,2090,4277,0.489,1215,1516,0.801,647,2516,3163,1705,614,921,1567,8029
6088,2017-5-12,Golden State Warriors,82,19780,3532,7140,0.495,982,2562,0.383,2550,4578,0.557,1457,1850,0.788,770,2873,3643,2491,785,1182,1585,9503
6089,2017-5-12,Houston Rockets,82,19780,3305,7152,0.462,1181,3306,0.357,2124,3846,0.552,1667,2177,0.766,892,2746,3638,2070,670,1188,1634,9458
6090,2017-5-12,Denver Nuggets,82,19755,3377,7194,0.469,870,2365,0.368,2507,4829,0.519,1537,1986,0.774,966,2837,3803,2077,568,1186,1567,9161
6091,2017-5-12,Cleveland Cavaliers,82,19880,3275,6963,0.47,1067,2779,0.384,2208,4184,0.528,1431,1913,0.748,766,2821,3587,1858,539,1081,1486,9048
6092,2017-5-12,Washington Wizards,82,19855,3388,7137,0.475,756,2030,0.372,2632,5107,0.515,1421,1812,0.784,843,2671,3514,1956,693,1103,1745,8953
6093,2017-5-12,Los Angeles Clippers,82,19755,3242,6820,0.475,841,2245,0.375,2401,4575,0.525,1586,2128,0.745,738,2790,3528,1848,612,1022,1626,8911
6094,2017-5-12,Boston Celtics,82,19755,3168,6978,0.454,985,2742,0.359,2183,4236,0.515,1536,1903,0.807,744,2698,3442,2069,617,1037,1686,8857
6095,2017-5-12,Portland Trail Blazers,82,19930,3243,7059,0.459,852,2272,0.375,2391,4787,0.499,1513,1940,0.78,830,2750,3580,1733,574,1077,1736,8851
6096,2017-5-12,Phoenix Suns,82,19830,3270,7260,0.45,615,1854,0.332,2655,5406,0.491,1676,2159,0.776,976,2712,3688,1604,673,1223,2030,8831
6097,2017-5-12,Toronto Raptors,82,19780,3211,6918,0.464,725,1996,0.363,2486,4922,0.505,1615,2028,0.796,871,2676,3547,1517,677,969,1708,8762
6098,2017-5-12,Oklahoma City Thunder,82,19805,3237,7169,0.452,692,2116,0.327,2545,5053,0.504,1575,2113,0.745,1002,2821,3823,1721,648,1199,1715,8741
6099,2017-5-12,Brooklyn Nets,82,19755,3102,6987,0.444,877,2591,0.338,2225,4396,0.506,1592,2020,0.788,721,2879,3600,1756,593,1307,1726,8673
6100,2017-5-12,Minnesota Timberwolves,82,19805,3235,6922,0.467,601,1723,0.349,2634,5199,0.507,1586,1986,0.799,938,2540,3478,1940,654,1099,1646,8657
6101,2017-5-12,San Antonio Spurs,82,19805,3222,6864,0.469,753,1927,0.391,2469,4937,0.5,1440,1806,0.797,821,2777,3598,1954,655,1057,1498,8637
6102,2017-5-12,Indiana Pacers,82,19855,3221,6931,0.465,709,1885,0.376,2512,5046,0.498,1467,1811,0.81,742,2702,3444,1844,669,1087,1597,8618
6103,2017-5-12,Charlotte Hornets,82,19830,3093,7000,0.442,824,2347,0.351,2269,4653,0.488,1591,1953,0.815,721,2853,3574,1891,571,899,1360,8601
6104,2017-5-12,Los Angeles Lakers,82,19705,3224,7164,0.45,730,2110,0.346,2494,5054,0.493,1397,1853,0.754,933,2636,3569,1716,674,1193,1698,8575
6105,2017-5-12,New Orleans Pelicans,82,19905,3210,7130,0.45,768,2196,0.35,2442,4934,0.495,1368,1825,0.75,703,2879,3582,1869,638,1012,1490,8556
6106,2017-5-12,New York Knicks,82,19855,3244,7256,0.447,704,2022,0.348,2540,5234,0.485,1364,1731,0.788,983,2723,3706,1786,581,1081,1668,8556
6107,2017-5-12,Milwaukee Bucks,82,19780,3182,6715,0.474,720,1946,0.37,2462,4769,0.516,1413,1839,0.768,723,2589,3312,1984,666,1096,1660,8497
6108,2017-5-12,Atlanta Hawks,82,19880,3123,6918,0.451,729,2137,0.341,2394,4781,0.501,1484,2039,0.728,842,2793,3635,1938,672,1249,1491,8459
6109,2017-5-12,Miami Heat,82,19780,3202,7037,0.455,808,2213,0.365,2394,4824,0.496,1248,1768,0.706,872,2705,3577,1742,588,1033,1680,8460
6110,2017-5-12,Chicago Bulls,82,19780,3169,7141,0.444,623,1831,0.34,2546,5310,0.479,1474,1848,0.798,999,2797,3796,1851,643,1065,1455,8435
6111,2017-5-12,Sacramento Kings,82,19880,3105,6734,0.461,737,1960,0.376,2368,4774,0.496,1483,1913,0.775,715,2652,3367,1844,627,1157,1667,8430
6112,2017-5-12,Philadelphia 76ers,82,19830,3088,6992,0.442,831,2443,0.34,2257,4549,0.496,1393,1806,0.771,807,2706,3513,1949,692,1310,1793,8400
6113,2017-5-12,Detroit Pistons,82,19805,3269,7282,0.449,631,1915,0.33,2638,5367,0.492,1140,1586,0.719,908,2838,3746,1732,574,932,1467,8309
6114,2017-5-12,Orlando Magic,82,19805,3139,7133,0.44,701,2139,0.328,2438,4994,0.488,1309,1753,0.747,807,2734,3541,1820,580,1053,1584,8288
6115,2017-5-12,Utah Jazz,82,19755,3033,6515,0.466,791,2128,0.372,2242,4387,0.511,1401,1875,0.747,771,2774,3545,1651,550,1060,1545,8258
6116,2017-5-12,Memphis Grizzlies,82,19905,2984,6854,0.435,767,2169,0.354,2217,4685,0.473,1504,1918,0.784,886,2621,3507,1744,653,1019,1840,8239
6117,2017-5-12,Dallas Mavericks,82,19780,2968,6750,0.44,878,2473,0.355,2090,4277,0.489,1215,1516,0.801,647,2516,3163,1705,614,921,1567,8029
6118,2017-5-13,Golden State Warriors,82,19780,3532,7140,0.495,982,2562,0.383,2550,4578,0.557,1457,1850,0.788,770,2873,3643,2491,785,1182,1585,9503
6119,2017-5-13,Houston Rockets,82,19780,3305,7152,0.462,1181,3306,0.357,2124,3846,0.552,1667,2177,0.766,892,2746,3638,2070,670,1188,1634,9458
6120,2017-5-13,Denver Nuggets,82,19755,3377,7194,0.469,870,2365,0.368,2507,4829,0.519,1537,1986,0.774,966,2837,3803,2077,568,1186,1567,9161
6121,2017-5-13,Cleveland Cavaliers,82,19880,3275,6963,0.47,1067,2779,0.384,2208,4184,0.528,1431,1913,0.748,766,2821,3587,1858,539,1081,1486,9048
6122,2017-5-13,Washington Wizards,82,19855,3388,7137,0.475,756,2030,0.372,2632,5107,0.515,1421,1812,0.784,843,2671,3514,1956,693,1103,1745,8953
6123,2017-5-13,Los Angeles Clippers,82,19755,3242,6820,0.475,841,2245,0.375,2401,4575,0.525,1586,2128,0.745,738,2790,3528,1848,612,1022,1626,8911
6124,2017-5-13,Boston Celtics,82,19755,3168,6978,0.454,985,2742,0.359,2183,4236,0.515,1536,1903,0.807,744,2698,3442,2069,617,1037,1686,8857
6125,2017-5-13,Portland Trail Blazers,82,19930,3243,7059,0.459,852,2272,0.375,2391,4787,0.499,1513,1940,0.78,830,2750,3580,1733,574,1077,1736,8851
6126,2017-5-13,Phoenix Suns,82,19830,3270,7260,0.45,615,1854,0.332,2655,5406,0.491,1676,2159,0.776,976,2712,3688,1604,673,1223,2030,8831
6127,2017-5-13,Toronto Raptors,82,19780,3211,6918,0.464,725,1996,0.363,2486,4922,0.505,1615,2028,0.796,871,2676,3547,1517,677,969,1708,8762
6128,2017-5-13,Oklahoma City Thunder,82,19805,3237,7169,0.452,692,2116,0.327,2545,5053,0.504,1575,2113,0.745,1002,2821,3823,1721,648,1199,1715,8741
6129,2017-5-13,Brooklyn Nets,82,19755,3102,6987,0.444,877,2591,0.338,2225,4396,0.506,1592,2020,0.788,721,2879,3600,1756,593,1307,1726,8673
6130,2017-5-13,Minnesota Timberwolves,82,19805,3235,6922,0.467,601,1723,0.349,2634,5199,0.507,1586,1986,0.799,938,2540,3478,1940,654,1099,1646,8657
6131,2017-5-13,San Antonio Spurs,82,19805,3222,6864,0.469,753,1927,0.391,2469,4937,0.5,1440,1806,0.797,821,2777,3598,1954,655,1057,1498,8637
6132,2017-5-13,Indiana Pacers,82,19855,3221,6931,0.465,709,1885,0.376,2512,5046,0.498,1467,1811,0.81,742,2702,3444,1844,669,1087,1597,8618
6133,2017-5-13,Charlotte Hornets,82,19830,3093,7000,0.442,824,2347,0.351,2269,4653,0.488,1591,1953,0.815,721,2853,3574,1891,571,899,1360,8601
6134,2017-5-13,Los Angeles Lakers,82,19705,3224,7164,0.45,730,2110,0.346,2494,5054,0.493,1397,1853,0.754,933,2636,3569,1716,674,1193,1698,8575
6135,2017-5-13,New Orleans Pelicans,82,19905,3210,7130,0.45,768,2196,0.35,2442,4934,0.495,1368,1825,0.75,703,2879,3582,1869,638,1012,1490,8556
6136,2017-5-13,New York Knicks,82,19855,3244,7256,0.447,704,2022,0.348,2540,5234,0.485,1364,1731,0.788,983,2723,3706,1786,581,1081,1668,8556
6137,2017-5-13,Milwaukee Bucks,82,19780,3182,6715,0.474,720,1946,0.37,2462,4769,0.516,1413,1839,0.768,723,2589,3312,1984,666,1096,1660,8497
6138,2017-5-13,Atlanta Hawks,82,19880,3123,6918,0.451,729,2137,0.341,2394,4781,0.501,1484,2039,0.728,842,2793,3635,1938,672,1249,1491,8459
6139,2017-5-13,Miami Heat,82,19780,3202,7037,0.455,808,2213,0.365,2394,4824,0.496,1248,1768,0.706,872,2705,3577,1742,588,1033,1680,8460
6140,2017-5-13,Chicago Bulls,82,19780,3169,7141,0.444,623,1831,0.34,2546,5310,0.479,1474,1848,0.798,999,2797,3796,1851,643,1065,1455,8435
6141,2017-5-13,Sacramento Kings,82,19880,3105,6734,0.461,737,1960,0.376,2368,4774,0.496,1483,1913,0.775,715,2652,3367,1844,627,1157,1667,8430
6142,2017-5-13,Philadelphia 76ers,82,19830,3088,6992,0.442,831,2443,0.34,2257,4549,0.496,1393,1806,0.771,807,2706,3513,1949,692,1310,1793,8400
6143,2017-5-13,Detroit Pistons,82,19805,3269,7282,0.449,631,1915,0.33,2638,5367,0.492,1140,1586,0.719,908,2838,3746,1732,574,932,1467,8309
6144,2017-5-13,Orlando Magic,82,19805,3139,7133,0.44,701,2139,0.328,2438,4994,0.488,1309,1753,0.747,807,2734,3541,1820,580,1053,1584,8288
6145,2017-5-13,Utah Jazz,82,19755,3033,6515,0.466,791,2128,0.372,2242,4387,0.511,1401,1875,0.747,771,2774,3545,1651,550,1060,1545,8258
6146,2017-5-13,Memphis Grizzlies,82,19905,2984,6854,0.435,767,2169,0.354,2217,4685,0.473,1504,1918,0.784,886,2621,3507,1744,653,1019,1840,8239
6147,2017-5-13,Dallas Mavericks,82,19780,2968,6750,0.44,878,2473,0.355,2090,4277,0.489,1215,1516,0.801,647,2516,3163,1705,614,921,1567,8029
6148,2017-5-14,Golden State Warriors,82,19780,3532,7140,0.495,982,2562,0.383,2550,4578,0.557,1457,1850,0.788,770,2873,3643,2491,785,1182,1585,9503
6149,2017-5-14,Houston Rockets,82,19780,3305,7152,0.462,1181,3306,0.357,2124,3846,0.552,1667,2177,0.766,892,2746,3638,2070,670,1188,1634,9458
6150,2017-5-14,Denver Nuggets,82,19755,3377,7194,0.469,870,2365,0.368,2507,4829,0.519,1537,1986,0.774,966,2837,3803,2077,568,1186,1567,9161
6151,2017-5-14,Cleveland Cavaliers,82,19880,3275,6963,0.47,1067,2779,0.384,2208,4184,0.528,1431,1913,0.748,766,2821,3587,1858,539,1081,1486,9048
6152,2017-5-14,Washington Wizards,82,19855,3388,7137,0.475,756,2030,0.372,2632,5107,0.515,1421,1812,0.784,843,2671,3514,1956,693,1103,1745,8953
6153,2017-5-14,Los Angeles Clippers,82,19755,3242,6820,0.475,841,2245,0.375,2401,4575,0.525,1586,2128,0.745,738,2790,3528,1848,612,1022,1626,8911
6154,2017-5-14,Boston Celtics,82,19755,3168,6978,0.454,985,2742,0.359,2183,4236,0.515,1536,1903,0.807,744,2698,3442,2069,617,1037,1686,8857
6155,2017-5-14,Portland Trail Blazers,82,19930,3243,7059,0.459,852,2272,0.375,2391,4787,0.499,1513,1940,0.78,830,2750,3580,1733,574,1077,1736,8851
6156,2017-5-14,Phoenix Suns,82,19830,3270,7260,0.45,615,1854,0.332,2655,5406,0.491,1676,2159,0.776,976,2712,3688,1604,673,1223,2030,8831
6157,2017-5-14,Toronto Raptors,82,19780,3211,6918,0.464,725,1996,0.363,2486,4922,0.505,1615,2028,0.796,871,2676,3547,1517,677,969,1708,8762
6158,2017-5-14,Oklahoma City Thunder,82,19805,3237,7169,0.452,692,2116,0.327,2545,5053,0.504,1575,2113,0.745,1002,2821,3823,1721,648,1199,1715,8741
6159,2017-5-14,Brooklyn Nets,82,19755,3102,6987,0.444,877,2591,0.338,2225,4396,0.506,1592,2020,0.788,721,2879,3600,1756,593,1307,1726,8673
6160,2017-5-14,Minnesota Timberwolves,82,19805,3235,6922,0.467,601,1723,0.349,2634,5199,0.507,1586,1986,0.799,938,2540,3478,1940,654,1099,1646,8657
6161,2017-5-14,San Antonio Spurs,82,19805,3222,6864,0.469,753,1927,0.391,2469,4937,0.5,1440,1806,0.797,821,2777,3598,1954,655,1057,1498,8637
6162,2017-5-14,Indiana Pacers,82,19855,3221,6931,0.465,709,1885,0.376,2512,5046,0.498,1467,1811,0.81,742,2702,3444,1844,669,1087,1597,8618
6163,2017-5-14,Charlotte Hornets,82,19830,3093,7000,0.442,824,2347,0.351,2269,4653,0.488,1591,1953,0.815,721,2853,3574,1891,571,899,1360,8601
6164,2017-5-14,Los Angeles Lakers,82,19705,3224,7164,0.45,730,2110,0.346,2494,5054,0.493,1397,1853,0.754,933,2636,3569,1716,674,1193,1698,8575
6165,2017-5-14,New Orleans Pelicans,82,19905,3210,7130,0.45,768,2196,0.35,2442,4934,0.495,1368,1825,0.75,703,2879,3582,1869,638,1012,1490,8556
6166,2017-5-14,New York Knicks,82,19855,3244,7256,0.447,704,2022,0.348,2540,5234,0.485,1364,1731,0.788,983,2723,3706,1786,581,1081,1668,8556
6167,2017-5-14,Milwaukee Bucks,82,19780,3182,6715,0.474,720,1946,0.37,2462,4769,0.516,1413,1839,0.768,723,2589,3312,1984,666,1096,1660,8497
6168,2017-5-14,Atlanta Hawks,82,19880,3123,6918,0.451,729,2137,0.341,2394,4781,0.501,1484,2039,0.728,842,2793,3635,1938,672,1249,1491,8459
6169,2017-5-14,Miami Heat,82,19780,3202,7037,0.455,808,2213,0.365,2394,4824,0.496,1248,1768,0.706,872,2705,3577,1742,588,1033,1680,8460
6170,2017-5-14,Chicago Bulls,82,19780,3169,7141,0.444,623,1831,0.34,2546,5310,0.479,1474,1848,0.798,999,2797,3796,1851,643,1065,1455,8435
6171,2017-5-14,Sacramento Kings,82,19880,3105,6734,0.461,737,1960,0.376,2368,4774,0.496,1483,1913,0.775,715,2652,3367,1844,627,1157,1667,8430
6172,2017-5-14,Philadelphia 76ers,82,19830,3088,6992,0.442,831,2443,0.34,2257,4549,0.496,1393,1806,0.771,807,2706,3513,1949,692,1310,1793,8400
6173,2017-5-14,Detroit Pistons,82,19805,3269,7282,0.449,631,1915,0.33,2638,5367,0.492,1140,1586,0.719,908,2838,3746,1732,574,932,1467,8309
6174,2017-5-14,Orlando Magic,82,19805,3139,7133,0.44,701,2139,0.328,2438,4994,0.488,1309,1753,0.747,807,2734,3541,1820,580,1053,1584,8288
6175,2017-5-14,Utah Jazz,82,19755,3033,6515,0.466,791,2128,0.372,2242,4387,0.511,1401,1875,0.747,771,2774,3545,1651,550,1060,1545,8258
6176,2017-5-14,Memphis Grizzlies,82,19905,2984,6854,0.435,767,2169,0.354,2217,4685,0.473,1504,1918,0.784,886,2621,3507,1744,653,1019,1840,8239
6177,2017-5-14,Dallas Mavericks,82,19780,2968,6750,0.44,878,2473,0.355,2090,4277,0.489,1215,1516,0.801,647,2516,3163,1705,614,921,1567,8029
6178,2017-5-15,Golden State Warriors,82,19780,3532,7140,0.495,982,2562,0.383,2550,4578,0.557,1457,1850,0.788,770,2873,3643,2491,785,1182,1585,9503
6179,2017-5-15,Houston Rockets,82,19780,3305,7152,0.462,1181,3306,0.357,2124,3846,0.552,1667,2177,0.766,892,2746,3638,2070,670,1188,1634,9458
6180,2017-5-15,Denver Nuggets,82,19755,3377,7194,0.469,870,2365,0.368,2507,4829,0.519,1537,1986,0.774,966,2837,3803,2077,568,1186,1567,9161
6181,2017-5-15,Cleveland Cavaliers,82,19880,3275,6963,0.47,1067,2779,0.384,2208,4184,0.528,1431,1913,0.748,766,2821,3587,1858,539,1081,1486,9048
6182,2017-5-15,Washington Wizards,82,19855,3388,7137,0.475,756,2030,0.372,2632,5107,0.515,1421,1812,0.784,843,2671,3514,1956,693,1103,1745,8953
6183,2017-5-15,Los Angeles Clippers,82,19755,3242,6820,0.475,841,2245,0.375,2401,4575,0.525,1586,2128,0.745,738,2790,3528,1848,612,1022,1626,8911
6184,2017-5-15,Boston Celtics,82,19755,3168,6978,0.454,985,2742,0.359,2183,4236,0.515,1536,1903,0.807,744,2698,3442,2069,617,1037,1686,8857
6185,2017-5-15,Portland Trail Blazers,82,19930,3243,7059,0.459,852,2272,0.375,2391,4787,0.499,1513,1940,0.78,830,2750,3580,1733,574,1077,1736,8851
6186,2017-5-15,Phoenix Suns,82,19830,3270,7260,0.45,615,1854,0.332,2655,5406,0.491,1676,2159,0.776,976,2712,3688,1604,673,1223,2030,8831
6187,2017-5-15,Toronto Raptors,82,19780,3211,6918,0.464,725,1996,0.363,2486,4922,0.505,1615,2028,0.796,871,2676,3547,1517,677,969,1708,8762
6188,2017-5-15,Oklahoma City Thunder,82,19805,3237,7169,0.452,692,2116,0.327,2545,5053,0.504,1575,2113,0.745,1002,2821,3823,1721,648,1199,1715,8741
6189,2017-5-15,Brooklyn Nets,82,19755,3102,6987,0.444,877,2591,0.338,2225,4396,0.506,1592,2020,0.788,721,2879,3600,1756,593,1307,1726,8673
6190,2017-5-15,Minnesota Timberwolves,82,19805,3235,6922,0.467,601,1723,0.349,2634,5199,0.507,1586,1986,0.799,938,2540,3478,1940,654,1099,1646,8657
6191,2017-5-15,San Antonio Spurs,82,19805,3222,6864,0.469,753,1927,0.391,2469,4937,0.5,1440,1806,0.797,821,2777,3598,1954,655,1057,1498,8637
6192,2017-5-15,Indiana Pacers,82,19855,3221,6931,0.465,709,1885,0.376,2512,5046,0.498,1467,1811,0.81,742,2702,3444,1844,669,1087,1597,8618
6193,2017-5-15,Charlotte Hornets,82,19830,3093,7000,0.442,824,2347,0.351,2269,4653,0.488,1591,1953,0.815,721,2853,3574,1891,571,899,1360,8601
6194,2017-5-15,Los Angeles Lakers,82,19705,3224,7164,0.45,730,2110,0.346,2494,5054,0.493,1397,1853,0.754,933,2636,3569,1716,674,1193,1698,8575
6195,2017-5-15,New Orleans Pelicans,82,19905,3210,7130,0.45,768,2196,0.35,2442,4934,0.495,1368,1825,0.75,703,2879,3582,1869,638,1012,1490,8556
6196,2017-5-15,New York Knicks,82,19855,3244,7256,0.447,704,2022,0.348,2540,5234,0.485,1364,1731,0.788,983,2723,3706,1786,581,1081,1668,8556
6197,2017-5-15,Milwaukee Bucks,82,19780,3182,6715,0.474,720,1946,0.37,2462,4769,0.516,1413,1839,0.768,723,2589,3312,1984,666,1096,1660,8497
6198,2017-5-15,Atlanta Hawks,82,19880,3123,6918,0.451,729,2137,0.341,2394,4781,0.501,1484,2039,0.728,842,2793,3635,1938,672,1249,1491,8459
6199,2017-5-15,Miami Heat,82,19780,3202,7037,0.455,808,2213,0.365,2394,4824,0.496,1248,1768,0.706,872,2705,3577,1742,588,1033,1680,8460
6200,2017-5-15,Chicago Bulls,82,19780,3169,7141,0.444,623,1831,0.34,2546,5310,0.479,1474,1848,0.798,999,2797,3796,1851,643,1065,1455,8435
6201,2017-5-15,Sacramento Kings,82,19880,3105,6734,0.461,737,1960,0.376,2368,4774,0.496,1483,1913,0.775,715,2652,3367,1844,627,1157,1667,8430
6202,2017-5-15,Philadelphia 76ers,82,19830,3088,6992,0.442,831,2443,0.34,2257,4549,0.496,1393,1806,0.771,807,2706,3513,1949,692,1310,1793,8400
6203,2017-5-15,Detroit Pistons,82,19805,3269,7282,0.449,631,1915,0.33,2638,5367,0.492,1140,1586,0.719,908,2838,3746,1732,574,932,1467,8309
6204,2017-5-15,Orlando Magic,82,19805,3139,7133,0.44,701,2139,0.328,2438,4994,0.488,1309,1753,0.747,807,2734,3541,1820,580,1053,1584,8288
6205,2017-5-15,Utah Jazz,82,19755,3033,6515,0.466,791,2128,0.372,2242,4387,0.511,1401,1875,0.747,771,2774,3545,1651,550,1060,1545,8258
6206,2017-5-15,Memphis Grizzlies,82,19905,2984,6854,0.435,767,2169,0.354,2217,4685,0.473,1504,1918,0.784,886,2621,3507,1744,653,1019,1840,8239
6207,2017-5-15,Dallas Mavericks,82,19780,2968,6750,0.44,878,2473,0.355,2090,4277,0.489,1215,1516,0.801,647,2516,3163,1705,614,921,1567,8029
6208,2017-5-16,Golden State Warriors,82,19780,3532,7140,0.495,982,2562,0.383,2550,4578,0.557,1457,1850,0.788,770,2873,3643,2491,785,1182,1585,9503
6209,2017-5-16,Houston Rockets,82,19780,3305,7152,0.462,1181,3306,0.357,2124,3846,0.552,1667,2177,0.766,892,2746,3638,2070,670,1188,1634,9458
6210,2017-5-16,Denver Nuggets,82,19755,3377,7194,0.469,870,2365,0.368,2507,4829,0.519,1537,1986,0.774,966,2837,3803,2077,568,1186,1567,9161
6211,2017-5-16,Cleveland Cavaliers,82,19880,3275,6963,0.47,1067,2779,0.384,2208,4184,0.528,1431,1913,0.748,766,2821,3587,1858,539,1081,1486,9048
6212,2017-5-16,Washington Wizards,82,19855,3388,7137,0.475,756,2030,0.372,2632,5107,0.515,1421,1812,0.784,843,2671,3514,1956,693,1103,1745,8953
6213,2017-5-16,Los Angeles Clippers,82,19755,3242,6820,0.475,841,2245,0.375,2401,4575,0.525,1586,2128,0.745,738,2790,3528,1848,612,1022,1626,8911
6214,2017-5-16,Boston Celtics,82,19755,3168,6978,0.454,985,2742,0.359,2183,4236,0.515,1536,1903,0.807,744,2698,3442,2069,617,1037,1686,8857
6215,2017-5-16,Portland Trail Blazers,82,19930,3243,7059,0.459,852,2272,0.375,2391,4787,0.499,1513,1940,0.78,830,2750,3580,1733,574,1077,1736,8851
6216,2017-5-16,Phoenix Suns,82,19830,3270,7260,0.45,615,1854,0.332,2655,5406,0.491,1676,2159,0.776,976,2712,3688,1604,673,1223,2030,8831
6217,2017-5-16,Toronto Raptors,82,19780,3211,6918,0.464,725,1996,0.363,2486,4922,0.505,1615,2028,0.796,871,2676,3547,1517,677,969,1708,8762
6218,2017-5-16,Oklahoma City Thunder,82,19805,3237,7169,0.452,692,2116,0.327,2545,5053,0.504,1575,2113,0.745,1002,2821,3823,1721,648,1199,1715,8741
6219,2017-5-16,Brooklyn Nets,82,19755,3102,6987,0.444,877,2591,0.338,2225,4396,0.506,1592,2020,0.788,721,2879,3600,1756,593,1307,1726,8673
6220,2017-5-16,Minnesota Timberwolves,82,19805,3235,6922,0.467,601,1723,0.349,2634,5199,0.507,1586,1986,0.799,938,2540,3478,1940,654,1099,1646,8657
6221,2017-5-16,San Antonio Spurs,82,19805,3222,6864,0.469,753,1927,0.391,2469,4937,0.5,1440,1806,0.797,821,2777,3598,1954,655,1057,1498,8637
6222,2017-5-16,Indiana Pacers,82,19855,3221,6931,0.465,709,1885,0.376,2512,5046,0.498,1467,1811,0.81,742,2702,3444,1844,669,1087,1597,8618
6223,2017-5-16,Charlotte Hornets,82,19830,3093,7000,0.442,824,2347,0.351,2269,4653,0.488,1591,1953,0.815,721,2853,3574,1891,571,899,1360,8601
6224,2017-5-16,Los Angeles Lakers,82,19705,3224,7164,0.45,730,2110,0.346,2494,5054,0.493,1397,1853,0.754,933,2636,3569,1716,674,1193,1698,8575
6225,2017-5-16,New Orleans Pelicans,82,19905,3210,7130,0.45,768,2196,0.35,2442,4934,0.495,1368,1825,0.75,703,2879,3582,1869,638,1012,1490,8556
6226,2017-5-16,New York Knicks,82,19855,3244,7256,0.447,704,2022,0.348,2540,5234,0.485,1364,1731,0.788,983,2723,3706,1786,581,1081,1668,8556
6227,2017-5-16,Milwaukee Bucks,82,19780,3182,6715,0.474,720,1946,0.37,2462,4769,0.516,1413,1839,0.768,723,2589,3312,1984,666,1096,1660,8497
6228,2017-5-16,Atlanta Hawks,82,19880,3123,6918,0.451,729,2137,0.341,2394,4781,0.501,1484,2039,0.728,842,2793,3635,1938,672,1249,1491,8459
6229,2017-5-16,Miami Heat,82,19780,3202,7037,0.455,808,2213,0.365,2394,4824,0.496,1248,1768,0.706,872,2705,3577,1742,588,1033,1680,8460
6230,2017-5-16,Chicago Bulls,82,19780,3169,7141,0.444,623,1831,0.34,2546,5310,0.479,1474,1848,0.798,999,2797,3796,1851,643,1065,1455,8435
6231,2017-5-16,Sacramento Kings,82,19880,3105,6734,0.461,737,1960,0.376,2368,4774,0.496,1483,1913,0.775,715,2652,3367,1844,627,1157,1667,8430
6232,2017-5-16,Philadelphia 76ers,82,19830,3088,6992,0.442,831,2443,0.34,2257,4549,0.496,1393,1806,0.771,807,2706,3513,1949,692,1310,1793,8400
6233,2017-5-16,Detroit Pistons,82,19805,3269,7282,0.449,631,1915,0.33,2638,5367,0.492,1140,1586,0.719,908,2838,3746,1732,574,932,1467,8309
6234,2017-5-16,Orlando Magic,82,19805,3139,7133,0.44,701,2139,0.328,2438,4994,0.488,1309,1753,0.747,807,2734,3541,1820,580,1053,1584,8288
6235,2017-5-16,Utah Jazz,82,19755,3033,6515,0.466,791,2128,0.372,2242,4387,0.511,1401,1875,0.747,771,2774,3545,1651,550,1060,1545,8258
6236,2017-5-16,Memphis Grizzlies,82,19905,2984,6854,0.435,767,2169,0.354,2217,4685,0.473,1504,1918,0.784,886,2621,3507,1744,653,1019,1840,8239
6237,2017-5-16,Dallas Mavericks,82,19780,2968,6750,0.44,878,2473,0.355,2090,4277,0.489,1215,1516,0.801,647,2516,3163,1705,614,921,1567,8029
6238,2017-5-17,Golden State Warriors,82,19780,3532,7140,0.495,982,2562,0.383,2550,4578,0.557,1457,1850,0.788,770,2873,3643,2491,785,1182,1585,9503
6239,2017-5-17,Houston Rockets,82,19780,3305,7152,0.462,1181,3306,0.357,2124,3846,0.552,1667,2177,0.766,892,2746,3638,2070,670,1188,1634,9458
6240,2017-5-17,Denver Nuggets,82,19755,3377,7194,0.469,870,2365,0.368,2507,4829,0.519,1537,1986,0.774,966,2837,3803,2077,568,1186,1567,9161
6241,2017-5-17,Cleveland Cavaliers,82,19880,3275,6963,0.47,1067,2779,0.384,2208,4184,0.528,1431,1913,0.748,766,2821,3587,1858,539,1081,1486,9048
6242,2017-5-17,Washington Wizards,82,19855,3388,7137,0.475,756,2030,0.372,2632,5107,0.515,1421,1812,0.784,843,2671,3514,1956,693,1103,1745,8953
6243,2017-5-17,Los Angeles Clippers,82,19755,3242,6820,0.475,841,2245,0.375,2401,4575,0.525,1586,2128,0.745,738,2790,3528,1848,612,1022,1626,8911
6244,2017-5-17,Boston Celtics,82,19755,3168,6978,0.454,985,2742,0.359,2183,4236,0.515,1536,1903,0.807,744,2698,3442,2069,617,1037,1686,8857
6245,2017-5-17,Portland Trail Blazers,82,19930,3243,7059,0.459,852,2272,0.375,2391,4787,0.499,1513,1940,0.78,830,2750,3580,1733,574,1077,1736,8851
6246,2017-5-17,Phoenix Suns,82,19830,3270,7260,0.45,615,1854,0.332,2655,5406,0.491,1676,2159,0.776,976,2712,3688,1604,673,1223,2030,8831
6247,2017-5-17,Toronto Raptors,82,19780,3211,6918,0.464,725,1996,0.363,2486,4922,0.505,1615,2028,0.796,871,2676,3547,1517,677,969,1708,8762
6248,2017-5-17,Oklahoma City Thunder,82,19805,3237,7169,0.452,692,2116,0.327,2545,5053,0.504,1575,2113,0.745,1002,2821,3823,1721,648,1199,1715,8741
6249,2017-5-17,Brooklyn Nets,82,19755,3102,6987,0.444,877,2591,0.338,2225,4396,0.506,1592,2020,0.788,721,2879,3600,1756,593,1307,1726,8673
6250,2017-5-17,Minnesota Timberwolves,82,19805,3235,6922,0.467,601,1723,0.349,2634,5199,0.507,1586,1986,0.799,938,2540,3478,1940,654,1099,1646,8657
6251,2017-5-17,San Antonio Spurs,82,19805,3222,6864,0.469,753,1927,0.391,2469,4937,0.5,1440,1806,0.797,821,2777,3598,1954,655,1057,1498,8637
6252,2017-5-17,Indiana Pacers,82,19855,3221,6931,0.465,709,1885,0.376,2512,5046,0.498,1467,1811,0.81,742,2702,3444,1844,669,1087,1597,8618
6253,2017-5-17,Charlotte Hornets,82,19830,3093,7000,0.442,824,2347,0.351,2269,4653,0.488,1591,1953,0.815,721,2853,3574,1891,571,899,1360,8601
6254,2017-5-17,Los Angeles Lakers,82,19705,3224,7164,0.45,730,2110,0.346,2494,5054,0.493,1397,1853,0.754,933,2636,3569,1716,674,1193,1698,8575
6255,2017-5-17,New Orleans Pelicans,82,19905,3210,7130,0.45,768,2196,0.35,2442,4934,0.495,1368,1825,0.75,703,2879,3582,1869,638,1012,1490,8556
6256,2017-5-17,New York Knicks,82,19855,3244,7256,0.447,704,2022,0.348,2540,5234,0.485,1364,1731,0.788,983,2723,3706,1786,581,1081,1668,8556
6257,2017-5-17,Milwaukee Bucks,82,19780,3182,6715,0.474,720,1946,0.37,2462,4769,0.516,1413,1839,0.768,723,2589,3312,1984,666,1096,1660,8497
6258,2017-5-17,Atlanta Hawks,82,19880,3123,6918,0.451,729,2137,0.341,2394,4781,0.501,1484,2039,0.728,842,2793,3635,1938,672,1249,1491,8459
6259,2017-5-17,Miami Heat,82,19780,3202,7037,0.455,808,2213,0.365,2394,4824,0.496,1248,1768,0.706,872,2705,3577,1742,588,1033,1680,8460
6260,2017-5-17,Chicago Bulls,82,19780,3169,7141,0.444,623,1831,0.34,2546,5310,0.479,1474,1848,0.798,999,2797,3796,1851,643,1065,1455,8435
6261,2017-5-17,Sacramento Kings,82,19880,3105,6734,0.461,737,1960,0.376,2368,4774,0.496,1483,1913,0.775,715,2652,3367,1844,627,1157,1667,8430
6262,2017-5-17,Philadelphia 76ers,82,19830,3088,6992,0.442,831,2443,0.34,2257,4549,0.496,1393,1806,0.771,807,2706,3513,1949,692,1310,1793,8400
6263,2017-5-17,Detroit Pistons,82,19805,3269,7282,0.449,631,1915,0.33,2638,5367,0.492,1140,1586,0.719,908,2838,3746,1732,574,932,1467,8309
6264,2017-5-17,Orlando Magic,82,19805,3139,7133,0.44,701,2139,0.328,2438,4994,0.488,1309,1753,0.747,807,2734,3541,1820,580,1053,1584,8288
6265,2017-5-17,Utah Jazz,82,19755,3033,6515,0.466,791,2128,0.372,2242,4387,0.511,1401,1875,0.747,771,2774,3545,1651,550,1060,1545,8258
6266,2017-5-17,Memphis Grizzlies,82,19905,2984,6854,0.435,767,2169,0.354,2217,4685,0.473,1504,1918,0.784,886,2621,3507,1744,653,1019,1840,8239
6267,2017-5-17,Dallas Mavericks,82,19780,2968,6750,0.44,878,2473,0.355,2090,4277,0.489,1215,1516,0.801,647,2516,3163,1705,614,921,1567,8029
6268,2017-5-18,Golden State Warriors,82,19780,3532,7140,0.495,982,2562,0.383,2550,4578,0.557,1457,1850,0.788,770,2873,3643,2491,785,1182,1585,9503
6269,2017-5-18,Houston Rockets,82,19780,3305,7152,0.462,1181,3306,0.357,2124,3846,0.552,1667,2177,0.766,892,2746,3638,2070,670,1188,1634,9458
6270,2017-5-18,Denver Nuggets,82,19755,3377,7194,0.469,870,2365,0.368,2507,4829,0.519,1537,1986,0.774,966,2837,3803,2077,568,1186,1567,9161
6271,2017-5-18,Cleveland Cavaliers,82,19880,3275,6963,0.47,1067,2779,0.384,2208,4184,0.528,1431,1913,0.748,766,2821,3587,1858,539,1081,1486,9048
6272,2017-5-18,Washington Wizards,82,19855,3388,7137,0.475,756,2030,0.372,2632,5107,0.515,1421,1812,0.784,843,2671,3514,1956,693,1103,1745,8953
6273,2017-5-18,Los Angeles Clippers,82,19755,3242,6820,0.475,841,2245,0.375,2401,4575,0.525,1586,2128,0.745,738,2790,3528,1848,612,1022,1626,8911
6274,2017-5-18,Boston Celtics,82,19755,3168,6978,0.454,985,2742,0.359,2183,4236,0.515,1536,1903,0.807,744,2698,3442,2069,617,1037,1686,8857
6275,2017-5-18,Portland Trail Blazers,82,19930,3243,7059,0.459,852,2272,0.375,2391,4787,0.499,1513,1940,0.78,830,2750,3580,1733,574,1077,1736,8851
6276,2017-5-18,Phoenix Suns,82,19830,3270,7260,0.45,615,1854,0.332,2655,5406,0.491,1676,2159,0.776,976,2712,3688,1604,673,1223,2030,8831
6277,2017-5-18,Toronto Raptors,82,19780,3211,6918,0.464,725,1996,0.363,2486,4922,0.505,1615,2028,0.796,871,2676,3547,1517,677,969,1708,8762
6278,2017-5-18,Oklahoma City Thunder,82,19805,3237,7169,0.452,692,2116,0.327,2545,5053,0.504,1575,2113,0.745,1002,2821,3823,1721,648,1199,1715,8741
6279,2017-5-18,Brooklyn Nets,82,19755,3102,6987,0.444,877,2591,0.338,2225,4396,0.506,1592,2020,0.788,721,2879,3600,1756,593,1307,1726,8673
6280,2017-5-18,Minnesota Timberwolves,82,19805,3235,6922,0.467,601,1723,0.349,2634,5199,0.507,1586,1986,0.799,938,2540,3478,1940,654,1099,1646,8657
6281,2017-5-18,San Antonio Spurs,82,19805,3222,6864,0.469,753,1927,0.391,2469,4937,0.5,1440,1806,0.797,821,2777,3598,1954,655,1057,1498,8637
6282,2017-5-18,Indiana Pacers,82,19855,3221,6931,0.465,709,1885,0.376,2512,5046,0.498,1467,1811,0.81,742,2702,3444,1844,669,1087,1597,8618
6283,2017-5-18,Charlotte Hornets,82,19830,3093,7000,0.442,824,2347,0.351,2269,4653,0.488,1591,1953,0.815,721,2853,3574,1891,571,899,1360,8601
6284,2017-5-18,Los Angeles Lakers,82,19705,3224,7164,0.45,730,2110,0.346,2494,5054,0.493,1397,1853,0.754,933,2636,3569,1716,674,1193,1698,8575
6285,2017-5-18,New Orleans Pelicans,82,19905,3210,7130,0.45,768,2196,0.35,2442,4934,0.495,1368,1825,0.75,703,2879,3582,1869,638,1012,1490,8556
6286,2017-5-18,New York Knicks,82,19855,3244,7256,0.447,704,2022,0.348,2540,5234,0.485,1364,1731,0.788,983,2723,3706,1786,581,1081,1668,8556
6287,2017-5-18,Milwaukee Bucks,82,19780,3182,6715,0.474,720,1946,0.37,2462,4769,0.516,1413,1839,0.768,723,2589,3312,1984,666,1096,1660,8497
6288,2017-5-18,Atlanta Hawks,82,19880,3123,6918,0.451,729,2137,0.341,2394,4781,0.501,1484,2039,0.728,842,2793,3635,1938,672,1249,1491,8459
6289,2017-5-18,Miami Heat,82,19780,3202,7037,0.455,808,2213,0.365,2394,4824,0.496,1248,1768,0.706,872,2705,3577,1742,588,1033,1680,8460
6290,2017-5-18,Chicago Bulls,82,19780,3169,7141,0.444,623,1831,0.34,2546,5310,0.479,1474,1848,0.798,999,2797,3796,1851,643,1065,1455,8435
6291,2017-5-18,Sacramento Kings,82,19880,3105,6734,0.461,737,1960,0.376,2368,4774,0.496,1483,1913,0.775,715,2652,3367,1844,627,1157,1667,8430
6292,2017-5-18,Philadelphia 76ers,82,19830,3088,6992,0.442,831,2443,0.34,2257,4549,0.496,1393,1806,0.771,807,2706,3513,1949,692,1310,1793,8400
6293,2017-5-18,Detroit Pistons,82,19805,3269,7282,0.449,631,1915,0.33,2638,5367,0.492,1140,1586,0.719,908,2838,3746,1732,574,932,1467,8309
6294,2017-5-18,Orlando Magic,82,19805,3139,7133,0.44,701,2139,0.328,2438,4994,0.488,1309,1753,0.747,807,2734,3541,1820,580,1053,1584,8288
6295,2017-5-18,Utah Jazz,82,19755,3033,6515,0.466,791,2128,0.372,2242,4387,0.511,1401,1875,0.747,771,2774,3545,1651,550,1060,1545,8258
6296,2017-5-18,Memphis Grizzlies,82,19905,2984,6854,0.435,767,2169,0.354,2217,4685,0.473,1504,1918,0.784,886,2621,3507,1744,653,1019,1840,8239
6297,2017-5-18,Dallas Mavericks,82,19780,2968,6750,0.44,878,2473,0.355,2090,4277,0.489,1215,1516,0.801,647,2516,3163,1705,614,921,1567,8029
6298,2017-5-19,Golden State Warriors,82,19780,3532,7140,0.495,982,2562,0.383,2550,4578,0.557,1457,1850,0.788,770,2873,3643,2491,785,1182,1585,9503
6299,2017-5-19,Houston Rockets,82,19780,3305,7152,0.462,1181,3306,0.357,2124,3846,0.552,1667,2177,0.766,892,2746,3638,2070,670,1188,1634,9458
6300,2017-5-19,Denver Nuggets,82,19755,3377,7194,0.469,870,2365,0.368,2507,4829,0.519,1537,1986,0.774,966,2837,3803,2077,568,1186,1567,9161
6301,2017-5-19,Cleveland Cavaliers,82,19880,3275,6963,0.47,1067,2779,0.384,2208,4184,0.528,1431,1913,0.748,766,2821,3587,1858,539,1081,1486,9048
6302,2017-5-19,Washington Wizards,82,19855,3388,7137,0.475,756,2030,0.372,2632,5107,0.515,1421,1812,0.784,843,2671,3514,1956,693,1103,1745,8953
6303,2017-5-19,Los Angeles Clippers,82,19755,3242,6820,0.475,841,2245,0.375,2401,4575,0.525,1586,2128,0.745,738,2790,3528,1848,612,1022,1626,8911
6304,2017-5-19,Boston Celtics,82,19755,3168,6978,0.454,985,2742,0.359,2183,4236,0.515,1536,1903,0.807,744,2698,3442,2069,617,1037,1686,8857
6305,2017-5-19,Portland Trail Blazers,82,19930,3243,7059,0.459,852,2272,0.375,2391,4787,0.499,1513,1940,0.78,830,2750,3580,1733,574,1077,1736,8851
6306,2017-5-19,Phoenix Suns,82,19830,3270,7260,0.45,615,1854,0.332,2655,5406,0.491,1676,2159,0.776,976,2712,3688,1604,673,1223,2030,8831
6307,2017-5-19,Toronto Raptors,82,19780,3211,6918,0.464,725,1996,0.363,2486,4922,0.505,1615,2028,0.796,871,2676,3547,1517,677,969,1708,8762
6308,2017-5-19,Oklahoma City Thunder,82,19805,3237,7169,0.452,692,2116,0.327,2545,5053,0.504,1575,2113,0.745,1002,2821,3823,1721,648,1199,1715,8741
6309,2017-5-19,Brooklyn Nets,82,19755,3102,6987,0.444,877,2591,0.338,2225,4396,0.506,1592,2020,0.788,721,2879,3600,1756,593,1307,1726,8673
6310,2017-5-19,Minnesota Timberwolves,82,19805,3235,6922,0.467,601,1723,0.349,2634,5199,0.507,1586,1986,0.799,938,2540,3478,1940,654,1099,1646,8657
6311,2017-5-19,San Antonio Spurs,82,19805,3222,6864,0.469,753,1927,0.391,2469,4937,0.5,1440,1806,0.797,821,2777,3598,1954,655,1057,1498,8637
6312,2017-5-19,Indiana Pacers,82,19855,3221,6931,0.465,709,1885,0.376,2512,5046,0.498,1467,1811,0.81,742,2702,3444,1844,669,1087,1597,8618
6313,2017-5-19,Charlotte Hornets,82,19830,3093,7000,0.442,824,2347,0.351,2269,4653,0.488,1591,1953,0.815,721,2853,3574,1891,571,899,1360,8601
6314,2017-5-19,Los Angeles Lakers,82,19705,3224,7164,0.45,730,2110,0.346,2494,5054,0.493,1397,1853,0.754,933,2636,3569,1716,674,1193,1698,8575
6315,2017-5-19,New Orleans Pelicans,82,19905,3210,7130,0.45,768,2196,0.35,2442,4934,0.495,1368,1825,0.75,703,2879,3582,1869,638,1012,1490,8556
6316,2017-5-19,New York Knicks,82,19855,3244,7256,0.447,704,2022,0.348,2540,5234,0.485,1364,1731,0.788,983,2723,3706,1786,581,1081,1668,8556
6317,2017-5-19,Milwaukee Bucks,82,19780,3182,6715,0.474,720,1946,0.37,2462,4769,0.516,1413,1839,0.768,723,2589,3312,1984,666,1096,1660,8497
6318,2017-5-19,Atlanta Hawks,82,19880,3123,6918,0.451,729,2137,0.341,2394,4781,0.501,1484,2039,0.728,842,2793,3635,1938,672,1249,1491,8459
6319,2017-5-19,Miami Heat,82,19780,3202,7037,0.455,808,2213,0.365,2394,4824,0.496,1248,1768,0.706,872,2705,3577,1742,588,1033,1680,8460
6320,2017-5-19,Chicago Bulls,82,19780,3169,7141,0.444,623,1831,0.34,2546,5310,0.479,1474,1848,0.798,999,2797,3796,1851,643,1065,1455,8435
6321,2017-5-19,Sacramento Kings,82,19880,3105,6734,0.461,737,1960,0.376,2368,4774,0.496,1483,1913,0.775,715,2652,3367,1844,627,1157,1667,8430
6322,2017-5-19,Philadelphia 76ers,82,19830,3088,6992,0.442,831,2443,0.34,2257,4549,0.496,1393,1806,0.771,807,2706,3513,1949,692,1310,1793,8400
6323,2017-5-19,Detroit Pistons,82,19805,3269,7282,0.449,631,1915,0.33,2638,5367,0.492,1140,1586,0.719,908,2838,3746,1732,574,932,1467,8309
6324,2017-5-19,Orlando Magic,82,19805,3139,7133,0.44,701,2139,0.328,2438,4994,0.488,1309,1753,0.747,807,2734,3541,1820,580,1053,1584,8288
6325,2017-5-19,Utah Jazz,82,19755,3033,6515,0.466,791,2128,0.372,2242,4387,0.511,1401,1875,0.747,771,2774,3545,1651,550,1060,1545,8258
6326,2017-5-19,Memphis Grizzlies,82,19905,2984,6854,0.435,767,2169,0.354,2217,4685,0.473,1504,1918,0.784,886,2621,3507,1744,653,1019,1840,8239
6327,2017-5-19,Dallas Mavericks,82,19780,2968,6750,0.44,878,2473,0.355,2090,4277,0.489,1215,1516,0.801,647,2516,3163,1705,614,921,1567,8029
6328,2017-5-20,Golden State Warriors,82,19780,3532,7140,0.495,982,2562,0.383,2550,4578,0.557,1457,1850,0.788,770,2873,3643,2491,785,1182,1585,9503
6329,2017-5-20,Houston Rockets,82,19780,3305,7152,0.462,1181,3306,0.357,2124,3846,0.552,1667,2177,0.766,892,2746,3638,2070,670,1188,1634,9458
6330,2017-5-20,Denver Nuggets,82,19755,3377,7194,0.469,870,2365,0.368,2507,4829,0.519,1537,1986,0.774,966,2837,3803,2077,568,1186,1567,9161
6331,2017-5-20,Cleveland Cavaliers,82,19880,3275,6963,0.47,1067,2779,0.384,2208,4184,0.528,1431,1913,0.748,766,2821,3587,1858,539,1081,1486,9048
6332,2017-5-20,Washington Wizards,82,19855,3388,7137,0.475,756,2030,0.372,2632,5107,0.515,1421,1812,0.784,843,2671,3514,1956,693,1103,1745,8953
6333,2017-5-20,Los Angeles Clippers,82,19755,3242,6820,0.475,841,2245,0.375,2401,4575,0.525,1586,2128,0.745,738,2790,3528,1848,612,1022,1626,8911
6334,2017-5-20,Boston Celtics,82,19755,3168,6978,0.454,985,2742,0.359,2183,4236,0.515,1536,1903,0.807,744,2698,3442,2069,617,1037,1686,8857
6335,2017-5-20,Portland Trail Blazers,82,19930,3243,7059,0.459,852,2272,0.375,2391,4787,0.499,1513,1940,0.78,830,2750,3580,1733,574,1077,1736,8851
6336,2017-5-20,Phoenix Suns,82,19830,3270,7260,0.45,615,1854,0.332,2655,5406,0.491,1676,2159,0.776,976,2712,3688,1604,673,1223,2030,8831
6337,2017-5-20,Toronto Raptors,82,19780,3211,6918,0.464,725,1996,0.363,2486,4922,0.505,1615,2028,0.796,871,2676,3547,1517,677,969,1708,8762
6338,2017-5-20,Oklahoma City Thunder,82,19805,3237,7169,0.452,692,2116,0.327,2545,5053,0.504,1575,2113,0.745,1002,2821,3823,1721,648,1199,1715,8741
6339,2017-5-20,Brooklyn Nets,82,19755,3102,6987,0.444,877,2591,0.338,2225,4396,0.506,1592,2020,0.788,721,2879,3600,1756,593,1307,1726,8673
6340,2017-5-20,Minnesota Timberwolves,82,19805,3235,6922,0.467,601,1723,0.349,2634,5199,0.507,1586,1986,0.799,938,2540,3478,1940,654,1099,1646,8657
6341,2017-5-20,San Antonio Spurs,82,19805,3222,6864,0.469,753,1927,0.391,2469,4937,0.5,1440,1806,0.797,821,2777,3598,1954,655,1057,1498,8637
6342,2017-5-20,Indiana Pacers,82,19855,3221,6931,0.465,709,1885,0.376,2512,5046,0.498,1467,1811,0.81,742,2702,3444,1844,669,1087,1597,8618
6343,2017-5-20,Charlotte Hornets,82,19830,3093,7000,0.442,824,2347,0.351,2269,4653,0.488,1591,1953,0.815,721,2853,3574,1891,571,899,1360,8601
6344,2017-5-20,Los Angeles Lakers,82,19705,3224,7164,0.45,730,2110,0.346,2494,5054,0.493,1397,1853,0.754,933,2636,3569,1716,674,1193,1698,8575
6345,2017-5-20,New Orleans Pelicans,82,19905,3210,7130,0.45,768,2196,0.35,2442,4934,0.495,1368,1825,0.75,703,2879,3582,1869,638,1012,1490,8556
6346,2017-5-20,New York Knicks,82,19855,3244,7256,0.447,704,2022,0.348,2540,5234,0.485,1364,1731,0.788,983,2723,3706,1786,581,1081,1668,8556
6347,2017-5-20,Milwaukee Bucks,82,19780,3182,6715,0.474,720,1946,0.37,2462,4769,0.516,1413,1839,0.768,723,2589,3312,1984,666,1096,1660,8497
6348,2017-5-20,Atlanta Hawks,82,19880,3123,6918,0.451,729,2137,0.341,2394,4781,0.501,1484,2039,0.728,842,2793,3635,1938,672,1249,1491,8459
6349,2017-5-20,Miami Heat,82,19780,3202,7037,0.455,808,2213,0.365,2394,4824,0.496,1248,1768,0.706,872,2705,3577,1742,588,1033,1680,8460
6350,2017-5-20,Chicago Bulls,82,19780,3169,7141,0.444,623,1831,0.34,2546,5310,0.479,1474,1848,0.798,999,2797,3796,1851,643,1065,1455,8435
6351,2017-5-20,Sacramento Kings,82,19880,3105,6734,0.461,737,1960,0.376,2368,4774,0.496,1483,1913,0.775,715,2652,3367,1844,627,1157,1667,8430
6352,2017-5-20,Philadelphia 76ers,82,19830,3088,6992,0.442,831,2443,0.34,2257,4549,0.496,1393,1806,0.771,807,2706,3513,1949,692,1310,1793,8400
6353,2017-5-20,Detroit Pistons,82,19805,3269,7282,0.449,631,1915,0.33,2638,5367,0.492,1140,1586,0.719,908,2838,3746,1732,574,932,1467,8309
6354,2017-5-20,Orlando Magic,82,19805,3139,7133,0.44,701,2139,0.328,2438,4994,0.488,1309,1753,0.747,807,2734,3541,1820,580,1053,1584,8288
6355,2017-5-20,Utah Jazz,82,19755,3033,6515,0.466,791,2128,0.372,2242,4387,0.511,1401,1875,0.747,771,2774,3545,1651,550,1060,1545,8258
6356,2017-5-20,Memphis Grizzlies,82,19905,2984,6854,0.435,767,2169,0.354,2217,4685,0.473,1504,1918,0.784,886,2621,3507,1744,653,1019,1840,8239
6357,2017-5-20,Dallas Mavericks,82,19780,2968,6750,0.44,878,2473,0.355,2090,4277,0.489,1215,1516,0.801,647,2516,3163,1705,614,921,1567,8029
6358,2017-5-21,Golden State Warriors,82,19780,3532,7140,0.495,982,2562,0.383,2550,4578,0.557,1457,1850,0.788,770,2873,3643,2491,785,1182,1585,9503
6359,2017-5-21,Houston Rockets,82,19780,3305,7152,0.462,1181,3306,0.357,2124,3846,0.552,1667,2177,0.766,892,2746,3638,2070,670,1188,1634,9458
6360,2017-5-21,Denver Nuggets,82,19755,3377,7194,0.469,870,2365,0.368,2507,4829,0.519,1537,1986,0.774,966,2837,3803,2077,568,1186,1567,9161
6361,2017-5-21,Cleveland Cavaliers,82,19880,3275,6963,0.47,1067,2779,0.384,2208,4184,0.528,1431,1913,0.748,766,2821,3587,1858,539,1081,1486,9048
6362,2017-5-21,Washington Wizards,82,19855,3388,7137,0.475,756,2030,0.372,2632,5107,0.515,1421,1812,0.784,843,2671,3514,1956,693,1103,1745,8953
6363,2017-5-21,Los Angeles Clippers,82,19755,3242,6820,0.475,841,2245,0.375,2401,4575,0.525,1586,2128,0.745,738,2790,3528,1848,612,1022,1626,8911
6364,2017-5-21,Boston Celtics,82,19755,3168,6978,0.454,985,2742,0.359,2183,4236,0.515,1536,1903,0.807,744,2698,3442,2069,617,1037,1686,8857
6365,2017-5-21,Portland Trail Blazers,82,19930,3243,7059,0.459,852,2272,0.375,2391,4787,0.499,1513,1940,0.78,830,2750,3580,1733,574,1077,1736,8851
6366,2017-5-21,Phoenix Suns,82,19830,3270,7260,0.45,615,1854,0.332,2655,5406,0.491,1676,2159,0.776,976,2712,3688,1604,673,1223,2030,8831
6367,2017-5-21,Toronto Raptors,82,19780,3211,6918,0.464,725,1996,0.363,2486,4922,0.505,1615,2028,0.796,871,2676,3547,1517,677,969,1708,8762
6368,2017-5-21,Oklahoma City Thunder,82,19805,3237,7169,0.452,692,2116,0.327,2545,5053,0.504,1575,2113,0.745,1002,2821,3823,1721,648,1199,1715,8741
6369,2017-5-21,Brooklyn Nets,82,19755,3102,6987,0.444,877,2591,0.338,2225,4396,0.506,1592,2020,0.788,721,2879,3600,1756,593,1307,1726,8673
6370,2017-5-21,Minnesota Timberwolves,82,19805,3235,6922,0.467,601,1723,0.349,2634,5199,0.507,1586,1986,0.799,938,2540,3478,1940,654,1099,1646,8657
6371,2017-5-21,San Antonio Spurs,82,19805,3222,6864,0.469,753,1927,0.391,2469,4937,0.5,1440,1806,0.797,821,2777,3598,1954,655,1057,1498,8637
6372,2017-5-21,Indiana Pacers,82,19855,3221,6931,0.465,709,1885,0.376,2512,5046,0.498,1467,1811,0.81,742,2702,3444,1844,669,1087,1597,8618
6373,2017-5-21,Charlotte Hornets,82,19830,3093,7000,0.442,824,2347,0.351,2269,4653,0.488,1591,1953,0.815,721,2853,3574,1891,571,899,1360,8601
6374,2017-5-21,Los Angeles Lakers,82,19705,3224,7164,0.45,730,2110,0.346,2494,5054,0.493,1397,1853,0.754,933,2636,3569,1716,674,1193,1698,8575
6375,2017-5-21,New Orleans Pelicans,82,19905,3210,7130,0.45,768,2196,0.35,2442,4934,0.495,1368,1825,0.75,703,2879,3582,1869,638,1012,1490,8556
6376,2017-5-21,New York Knicks,82,19855,3244,7256,0.447,704,2022,0.348,2540,5234,0.485,1364,1731,0.788,983,2723,3706,1786,581,1081,1668,8556
6377,2017-5-21,Milwaukee Bucks,82,19780,3182,6715,0.474,720,1946,0.37,2462,4769,0.516,1413,1839,0.768,723,2589,3312,1984,666,1096,1660,8497
6378,2017-5-21,Atlanta Hawks,82,19880,3123,6918,0.451,729,2137,0.341,2394,4781,0.501,1484,2039,0.728,842,2793,3635,1938,672,1249,1491,8459
6379,2017-5-21,Miami Heat,82,19780,3202,7037,0.455,808,2213,0.365,2394,4824,0.496,1248,1768,0.706,872,2705,3577,1742,588,1033,1680,8460
6380,2017-5-21,Chicago Bulls,82,19780,3169,7141,0.444,623,1831,0.34,2546,5310,0.479,1474,1848,0.798,999,2797,3796,1851,643,1065,1455,8435
6381,2017-5-21,Sacramento Kings,82,19880,3105,6734,0.461,737,1960,0.376,2368,4774,0.496,1483,1913,0.775,715,2652,3367,1844,627,1157,1667,8430
6382,2017-5-21,Philadelphia 76ers,82,19830,3088,6992,0.442,831,2443,0.34,2257,4549,0.496,1393,1806,0.771,807,2706,3513,1949,692,1310,1793,8400
6383,2017-5-21,Detroit Pistons,82,19805,3269,7282,0.449,631,1915,0.33,2638,5367,0.492,1140,1586,0.719,908,2838,3746,1732,574,932,1467,8309
6384,2017-5-21,Orlando Magic,82,19805,3139,7133,0.44,701,2139,0.328,2438,4994,0.488,1309,1753,0.747,807,2734,3541,1820,580,1053,1584,8288
6385,2017-5-21,Utah Jazz,82,19755,3033,6515,0.466,791,2128,0.372,2242,4387,0.511,1401,1875,0.747,771,2774,3545,1651,550,1060,1545,8258
6386,2017-5-21,Memphis Grizzlies,82,19905,2984,6854,0.435,767,2169,0.354,2217,4685,0.473,1504,1918,0.784,886,2621,3507,1744,653,1019,1840,8239
6387,2017-5-21,Dallas Mavericks,82,19780,2968,6750,0.44,878,2473,0.355,2090,4277,0.489,1215,1516,0.801,647,2516,3163,1705,614,921,1567,8029
6388,2017-5-22,Golden State Warriors,82,19780,3532,7140,0.495,982,2562,0.383,2550,4578,0.557,1457,1850,0.788,770,2873,3643,2491,785,1182,1585,9503
6389,2017-5-22,Houston Rockets,82,19780,3305,7152,0.462,1181,3306,0.357,2124,3846,0.552,1667,2177,0.766,892,2746,3638,2070,670,1188,1634,9458
6390,2017-5-22,Denver Nuggets,82,19755,3377,7194,0.469,870,2365,0.368,2507,4829,0.519,1537,1986,0.774,966,2837,3803,2077,568,1186,1567,9161
6391,2017-5-22,Cleveland Cavaliers,82,19880,3275,6963,0.47,1067,2779,0.384,2208,4184,0.528,1431,1913,0.748,766,2821,3587,1858,539,1081,1486,9048
6392,2017-5-22,Washington Wizards,82,19855,3388,7137,0.475,756,2030,0.372,2632,5107,0.515,1421,1812,0.784,843,2671,3514,1956,693,1103,1745,8953
6393,2017-5-22,Los Angeles Clippers,82,19755,3242,6820,0.475,841,2245,0.375,2401,4575,0.525,1586,2128,0.745,738,2790,3528,1848,612,1022,1626,8911
6394,2017-5-22,Boston Celtics,82,19755,3168,6978,0.454,985,2742,0.359,2183,4236,0.515,1536,1903,0.807,744,2698,3442,2069,617,1037,1686,8857
6395,2017-5-22,Portland Trail Blazers,82,19930,3243,7059,0.459,852,2272,0.375,2391,4787,0.499,1513,1940,0.78,830,2750,3580,1733,574,1077,1736,8851
6396,2017-5-22,Phoenix Suns,82,19830,3270,7260,0.45,615,1854,0.332,2655,5406,0.491,1676,2159,0.776,976,2712,3688,1604,673,1223,2030,8831
6397,2017-5-22,Toronto Raptors,82,19780,3211,6918,0.464,725,1996,0.363,2486,4922,0.505,1615,2028,0.796,871,2676,3547,1517,677,969,1708,8762
6398,2017-5-22,Oklahoma City Thunder,82,19805,3237,7169,0.452,692,2116,0.327,2545,5053,0.504,1575,2113,0.745,1002,2821,3823,1721,648,1199,1715,8741
6399,2017-5-22,Brooklyn Nets,82,19755,3102,6987,0.444,877,2591,0.338,2225,4396,0.506,1592,2020,0.788,721,2879,3600,1756,593,1307,1726,8673
6400,2017-5-22,Minnesota Timberwolves,82,19805,3235,6922,0.467,601,1723,0.349,2634,5199,0.507,1586,1986,0.799,938,2540,3478,1940,654,1099,1646,8657
6401,2017-5-22,San Antonio Spurs,82,19805,3222,6864,0.469,753,1927,0.391,2469,4937,0.5,1440,1806,0.797,821,2777,3598,1954,655,1057,1498,8637
6402,2017-5-22,Indiana Pacers,82,19855,3221,6931,0.465,709,1885,0.376,2512,5046,0.498,1467,1811,0.81,742,2702,3444,1844,669,1087,1597,8618
6403,2017-5-22,Charlotte Hornets,82,19830,3093,7000,0.442,824,2347,0.351,2269,4653,0.488,1591,1953,0.815,721,2853,3574,1891,571,899,1360,8601
6404,2017-5-22,Los Angeles Lakers,82,19705,3224,7164,0.45,730,2110,0.346,2494,5054,0.493,1397,1853,0.754,933,2636,3569,1716,674,1193,1698,8575
6405,2017-5-22,New Orleans Pelicans,82,19905,3210,7130,0.45,768,2196,0.35,2442,4934,0.495,1368,1825,0.75,703,2879,3582,1869,638,1012,1490,8556
6406,2017-5-22,New York Knicks,82,19855,3244,7256,0.447,704,2022,0.348,2540,5234,0.485,1364,1731,0.788,983,2723,3706,1786,581,1081,1668,8556
6407,2017-5-22,Milwaukee Bucks,82,19780,3182,6715,0.474,720,1946,0.37,2462,4769,0.516,1413,1839,0.768,723,2589,3312,1984,666,1096,1660,8497
6408,2017-5-22,Atlanta Hawks,82,19880,3123,6918,0.451,729,2137,0.341,2394,4781,0.501,1484,2039,0.728,842,2793,3635,1938,672,1249,1491,8459
6409,2017-5-22,Miami Heat,82,19780,3202,7037,0.455,808,2213,0.365,2394,4824,0.496,1248,1768,0.706,872,2705,3577,1742,588,1033,1680,8460
6410,2017-5-22,Chicago Bulls,82,19780,3169,7141,0.444,623,1831,0.34,2546,5310,0.479,1474,1848,0.798,999,2797,3796,1851,643,1065,1455,8435
6411,2017-5-22,Sacramento Kings,82,19880,3105,6734,0.461,737,1960,0.376,2368,4774,0.496,1483,1913,0.775,715,2652,3367,1844,627,1157,1667,8430
6412,2017-5-22,Philadelphia 76ers,82,19830,3088,6992,0.442,831,2443,0.34,2257,4549,0.496,1393,1806,0.771,807,2706,3513,1949,692,1310,1793,8400
6413,2017-5-22,Detroit Pistons,82,19805,3269,7282,0.449,631,1915,0.33,2638,5367,0.492,1140,1586,0.719,908,2838,3746,1732,574,932,1467,8309
6414,2017-5-22,Orlando Magic,82,19805,3139,7133,0.44,701,2139,0.328,2438,4994,0.488,1309,1753,0.747,807,2734,3541,1820,580,1053,1584,8288
6415,2017-5-22,Utah Jazz,82,19755,3033,6515,0.466,791,2128,0.372,2242,4387,0.511,1401,1875,0.747,771,2774,3545,1651,550,1060,1545,8258
6416,2017-5-22,Memphis Grizzlies,82,19905,2984,6854,0.435,767,2169,0.354,2217,4685,0.473,1504,1918,0.784,886,2621,3507,1744,653,1019,1840,8239
6417,2017-5-22,Dallas Mavericks,82,19780,2968,6750,0.44,878,2473,0.355,2090,4277,0.489,1215,1516,0.801,647,2516,3163,1705,614,921,1567,8029
6418,2017-5-23,Golden State Warriors,82,19780,3532,7140,0.495,982,2562,0.383,2550,4578,0.557,1457,1850,0.788,770,2873,3643,2491,785,1182,1585,9503
6419,2017-5-23,Houston Rockets,82,19780,3305,7152,0.462,1181,3306,0.357,2124,3846,0.552,1667,2177,0.766,892,2746,3638,2070,670,1188,1634,9458
6420,2017-5-23,Denver Nuggets,82,19755,3377,7194,0.469,870,2365,0.368,2507,4829,0.519,1537,1986,0.774,966,2837,3803,2077,568,1186,1567,9161
6421,2017-5-23,Cleveland Cavaliers,82,19880,3275,6963,0.47,1067,2779,0.384,2208,4184,0.528,1431,1913,0.748,766,2821,3587,1858,539,1081,1486,9048
6422,2017-5-23,Washington Wizards,82,19855,3388,7137,0.475,756,2030,0.372,2632,5107,0.515,1421,1812,0.784,843,2671,3514,1956,693,1103,1745,8953
6423,2017-5-23,Los Angeles Clippers,82,19755,3242,6820,0.475,841,2245,0.375,2401,4575,0.525,1586,2128,0.745,738,2790,3528,1848,612,1022,1626,8911
6424,2017-5-23,Boston Celtics,82,19755,3168,6978,0.454,985,2742,0.359,2183,4236,0.515,1536,1903,0.807,744,2698,3442,2069,617,1037,1686,8857
6425,2017-5-23,Portland Trail Blazers,82,19930,3243,7059,0.459,852,2272,0.375,2391,4787,0.499,1513,1940,0.78,830,2750,3580,1733,574,1077,1736,8851
6426,2017-5-23,Phoenix Suns,82,19830,3270,7260,0.45,615,1854,0.332,2655,5406,0.491,1676,2159,0.776,976,2712,3688,1604,673,1223,2030,8831
6427,2017-5-23,Toronto Raptors,82,19780,3211,6918,0.464,725,1996,0.363,2486,4922,0.505,1615,2028,0.796,871,2676,3547,1517,677,969,1708,8762
6428,2017-5-23,Oklahoma City Thunder,82,19805,3237,7169,0.452,692,2116,0.327,2545,5053,0.504,1575,2113,0.745,1002,2821,3823,1721,648,1199,1715,8741
6429,2017-5-23,Brooklyn Nets,82,19755,3102,6987,0.444,877,2591,0.338,2225,4396,0.506,1592,2020,0.788,721,2879,3600,1756,593,1307,1726,8673
6430,2017-5-23,Minnesota Timberwolves,82,19805,3235,6922,0.467,601,1723,0.349,2634,5199,0.507,1586,1986,0.799,938,2540,3478,1940,654,1099,1646,8657
6431,2017-5-23,San Antonio Spurs,82,19805,3222,6864,0.469,753,1927,0.391,2469,4937,0.5,1440,1806,0.797,821,2777,3598,1954,655,1057,1498,8637
6432,2017-5-23,Indiana Pacers,82,19855,3221,6931,0.465,709,1885,0.376,2512,5046,0.498,1467,1811,0.81,742,2702,3444,1844,669,1087,1597,8618
6433,2017-5-23,Charlotte Hornets,82,19830,3093,7000,0.442,824,2347,0.351,2269,4653,0.488,1591,1953,0.815,721,2853,3574,1891,571,899,1360,8601
6434,2017-5-23,Los Angeles Lakers,82,19705,3224,7164,0.45,730,2110,0.346,2494,5054,0.493,1397,1853,0.754,933,2636,3569,1716,674,1193,1698,8575
6435,2017-5-23,New Orleans Pelicans,82,19905,3210,7130,0.45,768,2196,0.35,2442,4934,0.495,1368,1825,0.75,703,2879,3582,1869,638,1012,1490,8556
6436,2017-5-23,New York Knicks,82,19855,3244,7256,0.447,704,2022,0.348,2540,5234,0.485,1364,1731,0.788,983,2723,3706,1786,581,1081,1668,8556
6437,2017-5-23,Milwaukee Bucks,82,19780,3182,6715,0.474,720,1946,0.37,2462,4769,0.516,1413,1839,0.768,723,2589,3312,1984,666,1096,1660,8497
6438,2017-5-23,Atlanta Hawks,82,19880,3123,6918,0.451,729,2137,0.341,2394,4781,0.501,1484,2039,0.728,842,2793,3635,1938,672,1249,1491,8459
6439,2017-5-23,Miami Heat,82,19780,3202,7037,0.455,808,2213,0.365,2394,4824,0.496,1248,1768,0.706,872,2705,3577,1742,588,1033,1680,8460
6440,2017-5-23,Chicago Bulls,82,19780,3169,7141,0.444,623,1831,0.34,2546,5310,0.479,1474,1848,0.798,999,2797,3796,1851,643,1065,1455,8435
6441,2017-5-23,Sacramento Kings,82,19880,3105,6734,0.461,737,1960,0.376,2368,4774,0.496,1483,1913,0.775,715,2652,3367,1844,627,1157,1667,8430
6442,2017-5-23,Philadelphia 76ers,82,19830,3088,6992,0.442,831,2443,0.34,2257,4549,0.496,1393,1806,0.771,807,2706,3513,1949,692,1310,1793,8400
6443,2017-5-23,Detroit Pistons,82,19805,3269,7282,0.449,631,1915,0.33,2638,5367,0.492,1140,1586,0.719,908,2838,3746,1732,574,932,1467,8309
6444,2017-5-23,Orlando Magic,82,19805,3139,7133,0.44,701,2139,0.328,2438,4994,0.488,1309,1753,0.747,807,2734,3541,1820,580,1053,1584,8288
6445,2017-5-23,Utah Jazz,82,19755,3033,6515,0.466,791,2128,0.372,2242,4387,0.511,1401,1875,0.747,771,2774,3545,1651,550,1060,1545,8258
6446,2017-5-23,Memphis Grizzlies,82,19905,2984,6854,0.435,767,2169,0.354,2217,4685,0.473,1504,1918,0.784,886,2621,3507,1744,653,1019,1840,8239
6447,2017-5-23,Dallas Mavericks,82,19780,2968,6750,0.44,878,2473,0.355,2090,4277,0.489,1215,1516,0.801,647,2516,3163,1705,614,921,1567,8029
6448,2017-5-24,Golden State Warriors,82,19780,3532,7140,0.495,982,2562,0.383,2550,4578,0.557,1457,1850,0.788,770,2873,3643,2491,785,1182,1585,9503
6449,2017-5-24,Houston Rockets,82,19780,3305,7152,0.462,1181,3306,0.357,2124,3846,0.552,1667,2177,0.766,892,2746,3638,2070,670,1188,1634,9458
6450,2017-5-24,Denver Nuggets,82,19755,3377,7194,0.469,870,2365,0.368,2507,4829,0.519,1537,1986,0.774,966,2837,3803,2077,568,1186,1567,9161
6451,2017-5-24,Cleveland Cavaliers,82,19880,3275,6963,0.47,1067,2779,0.384,2208,4184,0.528,1431,1913,0.748,766,2821,3587,1858,539,1081,1486,9048
6452,2017-5-24,Washington Wizards,82,19855,3388,7137,0.475,756,2030,0.372,2632,5107,0.515,1421,1812,0.784,843,2671,3514,1956,693,1103,1745,8953
6453,2017-5-24,Los Angeles Clippers,82,19755,3242,6820,0.475,841,2245,0.375,2401,4575,0.525,1586,2128,0.745,738,2790,3528,1848,612,1022,1626,8911
6454,2017-5-24,Boston Celtics,82,19755,3168,6978,0.454,985,2742,0.359,2183,4236,0.515,1536,1903,0.807,744,2698,3442,2069,617,1037,1686,8857
6455,2017-5-24,Portland Trail Blazers,82,19930,3243,7059,0.459,852,2272,0.375,2391,4787,0.499,1513,1940,0.78,830,2750,3580,1733,574,1077,1736,8851
6456,2017-5-24,Phoenix Suns,82,19830,3270,7260,0.45,615,1854,0.332,2655,5406,0.491,1676,2159,0.776,976,2712,3688,1604,673,1223,2030,8831
6457,2017-5-24,Toronto Raptors,82,19780,3211,6918,0.464,725,1996,0.363,2486,4922,0.505,1615,2028,0.796,871,2676,3547,1517,677,969,1708,8762
6458,2017-5-24,Oklahoma City Thunder,82,19805,3237,7169,0.452,692,2116,0.327,2545,5053,0.504,1575,2113,0.745,1002,2821,3823,1721,648,1199,1715,8741
6459,2017-5-24,Brooklyn Nets,82,19755,3102,6987,0.444,877,2591,0.338,2225,4396,0.506,1592,2020,0.788,721,2879,3600,1756,593,1307,1726,8673
6460,2017-5-24,Minnesota Timberwolves,82,19805,3235,6922,0.467,601,1723,0.349,2634,5199,0.507,1586,1986,0.799,938,2540,3478,1940,654,1099,1646,8657
6461,2017-5-24,San Antonio Spurs,82,19805,3222,6864,0.469,753,1927,0.391,2469,4937,0.5,1440,1806,0.797,821,2777,3598,1954,655,1057,1498,8637
6462,2017-5-24,Indiana Pacers,82,19855,3221,6931,0.465,709,1885,0.376,2512,5046,0.498,1467,1811,0.81,742,2702,3444,1844,669,1087,1597,8618
6463,2017-5-24,Charlotte Hornets,82,19830,3093,7000,0.442,824,2347,0.351,2269,4653,0.488,1591,1953,0.815,721,2853,3574,1891,571,899,1360,8601
6464,2017-5-24,Los Angeles Lakers,82,19705,3224,7164,0.45,730,2110,0.346,2494,5054,0.493,1397,1853,0.754,933,2636,3569,1716,674,1193,1698,8575
6465,2017-5-24,New Orleans Pelicans,82,19905,3210,7130,0.45,768,2196,0.35,2442,4934,0.495,1368,1825,0.75,703,2879,3582,1869,638,1012,1490,8556
6466,2017-5-24,New York Knicks,82,19855,3244,7256,0.447,704,2022,0.348,2540,5234,0.485,1364,1731,0.788,983,2723,3706,1786,581,1081,1668,8556
6467,2017-5-24,Milwaukee Bucks,82,19780,3182,6715,0.474,720,1946,0.37,2462,4769,0.516,1413,1839,0.768,723,2589,3312,1984,666,1096,1660,8497
6468,2017-5-24,Atlanta Hawks,82,19880,3123,6918,0.451,729,2137,0.341,2394,4781,0.501,1484,2039,0.728,842,2793,3635,1938,672,1249,1491,8459
6469,2017-5-24,Miami Heat,82,19780,3202,7037,0.455,808,2213,0.365,2394,4824,0.496,1248,1768,0.706,872,2705,3577,1742,588,1033,1680,8460
6470,2017-5-24,Chicago Bulls,82,19780,3169,7141,0.444,623,1831,0.34,2546,5310,0.479,1474,1848,0.798,999,2797,3796,1851,643,1065,1455,8435
6471,2017-5-24,Sacramento Kings,82,19880,3105,6734,0.461,737,1960,0.376,2368,4774,0.496,1483,1913,0.775,715,2652,3367,1844,627,1157,1667,8430
6472,2017-5-24,Philadelphia 76ers,82,19830,3088,6992,0.442,831,2443,0.34,2257,4549,0.496,1393,1806,0.771,807,2706,3513,1949,692,1310,1793,8400
6473,2017-5-24,Detroit Pistons,82,19805,3269,7282,0.449,631,1915,0.33,2638,5367,0.492,1140,1586,0.719,908,2838,3746,1732,574,932,1467,8309
6474,2017-5-24,Orlando Magic,82,19805,3139,7133,0.44,701,2139,0.328,2438,4994,0.488,1309,1753,0.747,807,2734,3541,1820,580,1053,1584,8288
6475,2017-5-24,Utah Jazz,82,19755,3033,6515,0.466,791,2128,0.372,2242,4387,0.511,1401,1875,0.747,771,2774,3545,1651,550,1060,1545,8258
6476,2017-5-24,Memphis Grizzlies,82,19905,2984,6854,0.435,767,2169,0.354,2217,4685,0.473,1504,1918,0.784,886,2621,3507,1744,653,1019,1840,8239
6477,2017-5-24,Dallas Mavericks,82,19780,2968,6750,0.44,878,2473,0.355,2090,4277,0.489,1215,1516,0.801,647,2516,3163,1705,614,921,1567,8029
6478,2017-5-25,Golden State Warriors,82,19780,3532,7140,0.495,982,2562,0.383,2550,4578,0.557,1457,1850,0.788,770,2873,3643,2491,785,1182,1585,9503
6479,2017-5-25,Houston Rockets,82,19780,3305,7152,0.462,1181,3306,0.357,2124,3846,0.552,1667,2177,0.766,892,2746,3638,2070,670,1188,1634,9458
6480,2017-5-25,Denver Nuggets,82,19755,3377,7194,0.469,870,2365,0.368,2507,4829,0.519,1537,1986,0.774,966,2837,3803,2077,568,1186,1567,9161
6481,2017-5-25,Cleveland Cavaliers,82,19880,3275,6963,0.47,1067,2779,0.384,2208,4184,0.528,1431,1913,0.748,766,2821,3587,1858,539,1081,1486,9048
6482,2017-5-25,Washington Wizards,82,19855,3388,7137,0.475,756,2030,0.372,2632,5107,0.515,1421,1812,0.784,843,2671,3514,1956,693,1103,1745,8953
6483,2017-5-25,Los Angeles Clippers,82,19755,3242,6820,0.475,841,2245,0.375,2401,4575,0.525,1586,2128,0.745,738,2790,3528,1848,612,1022,1626,8911
6484,2017-5-25,Boston Celtics,82,19755,3168,6978,0.454,985,2742,0.359,2183,4236,0.515,1536,1903,0.807,744,2698,3442,2069,617,1037,1686,8857
6485,2017-5-25,Portland Trail Blazers,82,19930,3243,7059,0.459,852,2272,0.375,2391,4787,0.499,1513,1940,0.78,830,2750,3580,1733,574,1077,1736,8851
6486,2017-5-25,Phoenix Suns,82,19830,3270,7260,0.45,615,1854,0.332,2655,5406,0.491,1676,2159,0.776,976,2712,3688,1604,673,1223,2030,8831
6487,2017-5-25,Toronto Raptors,82,19780,3211,6918,0.464,725,1996,0.363,2486,4922,0.505,1615,2028,0.796,871,2676,3547,1517,677,969,1708,8762
6488,2017-5-25,Oklahoma City Thunder,82,19805,3237,7169,0.452,692,2116,0.327,2545,5053,0.504,1575,2113,0.745,1002,2821,3823,1721,648,1199,1715,8741
6489,2017-5-25,Brooklyn Nets,82,19755,3102,6987,0.444,877,2591,0.338,2225,4396,0.506,1592,2020,0.788,721,2879,3600,1756,593,1307,1726,8673
6490,2017-5-25,Minnesota Timberwolves,82,19805,3235,6922,0.467,601,1723,0.349,2634,5199,0.507,1586,1986,0.799,938,2540,3478,1940,654,1099,1646,8657
6491,2017-5-25,San Antonio Spurs,82,19805,3222,6864,0.469,753,1927,0.391,2469,4937,0.5,1440,1806,0.797,821,2777,3598,1954,655,1057,1498,8637
6492,2017-5-25,Indiana Pacers,82,19855,3221,6931,0.465,709,1885,0.376,2512,5046,0.498,1467,1811,0.81,742,2702,3444,1844,669,1087,1597,8618
6493,2017-5-25,Charlotte Hornets,82,19830,3093,7000,0.442,824,2347,0.351,2269,4653,0.488,1591,1953,0.815,721,2853,3574,1891,571,899,1360,8601
6494,2017-5-25,Los Angeles Lakers,82,19705,3224,7164,0.45,730,2110,0.346,2494,5054,0.493,1397,1853,0.754,933,2636,3569,1716,674,1193,1698,8575
6495,2017-5-25,New Orleans Pelicans,82,19905,3210,7130,0.45,768,2196,0.35,2442,4934,0.495,1368,1825,0.75,703,2879,3582,1869,638,1012,1490,8556
6496,2017-5-25,New York Knicks,82,19855,3244,7256,0.447,704,2022,0.348,2540,5234,0.485,1364,1731,0.788,983,2723,3706,1786,581,1081,1668,8556
6497,2017-5-25,Milwaukee Bucks,82,19780,3182,6715,0.474,720,1946,0.37,2462,4769,0.516,1413,1839,0.768,723,2589,3312,1984,666,1096,1660,8497
6498,2017-5-25,Atlanta Hawks,82,19880,3123,6918,0.451,729,2137,0.341,2394,4781,0.501,1484,2039,0.728,842,2793,3635,1938,672,1249,1491,8459
6499,2017-5-25,Miami Heat,82,19780,3202,7037,0.455,808,2213,0.365,2394,4824,0.496,1248,1768,0.706,872,2705,3577,1742,588,1033,1680,8460
6500,2017-5-25,Chicago Bulls,82,19780,3169,7141,0.444,623,1831,0.34,2546,5310,0.479,1474,1848,0.798,999,2797,3796,1851,643,1065,1455,8435
6501,2017-5-25,Sacramento Kings,82,19880,3105,6734,0.461,737,1960,0.376,2368,4774,0.496,1483,1913,0.775,715,2652,3367,1844,627,1157,1667,8430
6502,2017-5-25,Philadelphia 76ers,82,19830,3088,6992,0.442,831,2443,0.34,2257,4549,0.496,1393,1806,0.771,807,2706,3513,1949,692,1310,1793,8400
6503,2017-5-25,Detroit Pistons,82,19805,3269,7282,0.449,631,1915,0.33,2638,5367,0.492,1140,1586,0.719,908,2838,3746,1732,574,932,1467,8309
6504,2017-5-25,Orlando Magic,82,19805,3139,7133,0.44,701,2139,0.328,2438,4994,0.488,1309,1753,0.747,807,2734,3541,1820,580,1053,1584,8288
6505,2017-5-25,Utah Jazz,82,19755,3033,6515,0.466,791,2128,0.372,2242,4387,0.511,1401,1875,0.747,771,2774,3545,1651,550,1060,1545,8258
6506,2017-5-25,Memphis Grizzlies,82,19905,2984,6854,0.435,767,2169,0.354,2217,4685,0.473,1504,1918,0.784,886,2621,3507,1744,653,1019,1840,8239
6507,2017-5-25,Dallas Mavericks,82,19780,2968,6750,0.44,878,2473,0.355,2090,4277,0.489,1215,1516,0.801,647,2516,3163,1705,614,921,1567,8029
6508,2017-5-26,Golden State Warriors,82,19780,3532,7140,0.495,982,2562,0.383,2550,4578,0.557,1457,1850,0.788,770,2873,3643,2491,785,1182,1585,9503
6509,2017-5-26,Houston Rockets,82,19780,3305,7152,0.462,1181,3306,0.357,2124,3846,0.552,1667,2177,0.766,892,2746,3638,2070,670,1188,1634,9458
6510,2017-5-26,Denver Nuggets,82,19755,3377,7194,0.469,870,2365,0.368,2507,4829,0.519,1537,1986,0.774,966,2837,3803,2077,568,1186,1567,9161
6511,2017-5-26,Cleveland Cavaliers,82,19880,3275,6963,0.47,1067,2779,0.384,2208,4184,0.528,1431,1913,0.748,766,2821,3587,1858,539,1081,1486,9048
6512,2017-5-26,Washington Wizards,82,19855,3388,7137,0.475,756,2030,0.372,2632,5107,0.515,1421,1812,0.784,843,2671,3514,1956,693,1103,1745,8953
6513,2017-5-26,Los Angeles Clippers,82,19755,3242,6820,0.475,841,2245,0.375,2401,4575,0.525,1586,2128,0.745,738,2790,3528,1848,612,1022,1626,8911
6514,2017-5-26,Boston Celtics,82,19755,3168,6978,0.454,985,2742,0.359,2183,4236,0.515,1536,1903,0.807,744,2698,3442,2069,617,1037,1686,8857
6515,2017-5-26,Portland Trail Blazers,82,19930,3243,7059,0.459,852,2272,0.375,2391,4787,0.499,1513,1940,0.78,830,2750,3580,1733,574,1077,1736,8851
6516,2017-5-26,Phoenix Suns,82,19830,3270,7260,0.45,615,1854,0.332,2655,5406,0.491,1676,2159,0.776,976,2712,3688,1604,673,1223,2030,8831
6517,2017-5-26,Toronto Raptors,82,19780,3211,6918,0.464,725,1996,0.363,2486,4922,0.505,1615,2028,0.796,871,2676,3547,1517,677,969,1708,8762
6518,2017-5-26,Oklahoma City Thunder,82,19805,3237,7169,0.452,692,2116,0.327,2545,5053,0.504,1575,2113,0.745,1002,2821,3823,1721,648,1199,1715,8741
6519,2017-5-26,Brooklyn Nets,82,19755,3102,6987,0.444,877,2591,0.338,2225,4396,0.506,1592,2020,0.788,721,2879,3600,1756,593,1307,1726,8673
6520,2017-5-26,Minnesota Timberwolves,82,19805,3235,6922,0.467,601,1723,0.349,2634,5199,0.507,1586,1986,0.799,938,2540,3478,1940,654,1099,1646,8657
6521,2017-5-26,San Antonio Spurs,82,19805,3222,6864,0.469,753,1927,0.391,2469,4937,0.5,1440,1806,0.797,821,2777,3598,1954,655,1057,1498,8637
6522,2017-5-26,Indiana Pacers,82,19855,3221,6931,0.465,709,1885,0.376,2512,5046,0.498,1467,1811,0.81,742,2702,3444,1844,669,1087,1597,8618
6523,2017-5-26,Charlotte Hornets,82,19830,3093,7000,0.442,824,2347,0.351,2269,4653,0.488,1591,1953,0.815,721,2853,3574,1891,571,899,1360,8601
6524,2017-5-26,Los Angeles Lakers,82,19705,3224,7164,0.45,730,2110,0.346,2494,5054,0.493,1397,1853,0.754,933,2636,3569,1716,674,1193,1698,8575
6525,2017-5-26,New Orleans Pelicans,82,19905,3210,7130,0.45,768,2196,0.35,2442,4934,0.495,1368,1825,0.75,703,2879,3582,1869,638,1012,1490,8556
6526,2017-5-26,New York Knicks,82,19855,3244,7256,0.447,704,2022,0.348,2540,5234,0.485,1364,1731,0.788,983,2723,3706,1786,581,1081,1668,8556
6527,2017-5-26,Milwaukee Bucks,82,19780,3182,6715,0.474,720,1946,0.37,2462,4769,0.516,1413,1839,0.768,723,2589,3312,1984,666,1096,1660,8497
6528,2017-5-26,Atlanta Hawks,82,19880,3123,6918,0.451,729,2137,0.341,2394,4781,0.501,1484,2039,0.728,842,2793,3635,1938,672,1249,1491,8459
6529,2017-5-26,Miami Heat,82,19780,3202,7037,0.455,808,2213,0.365,2394,4824,0.496,1248,1768,0.706,872,2705,3577,1742,588,1033,1680,8460
6530,2017-5-26,Chicago Bulls,82,19780,3169,7141,0.444,623,1831,0.34,2546,5310,0.479,1474,1848,0.798,999,2797,3796,1851,643,1065,1455,8435
6531,2017-5-26,Sacramento Kings,82,19880,3105,6734,0.461,737,1960,0.376,2368,4774,0.496,1483,1913,0.775,715,2652,3367,1844,627,1157,1667,8430
6532,2017-5-26,Philadelphia 76ers,82,19830,3088,6992,0.442,831,2443,0.34,2257,4549,0.496,1393,1806,0.771,807,2706,3513,1949,692,1310,1793,8400
6533,2017-5-26,Detroit Pistons,82,19805,3269,7282,0.449,631,1915,0.33,2638,5367,0.492,1140,1586,0.719,908,2838,3746,1732,574,932,1467,8309
6534,2017-5-26,Orlando Magic,82,19805,3139,7133,0.44,701,2139,0.328,2438,4994,0.488,1309,1753,0.747,807,2734,3541,1820,580,1053,1584,8288
6535,2017-5-26,Utah Jazz,82,19755,3033,6515,0.466,791,2128,0.372,2242,4387,0.511,1401,1875,0.747,771,2774,3545,1651,550,1060,1545,8258
6536,2017-5-26,Memphis Grizzlies,82,19905,2984,6854,0.435,767,2169,0.354,2217,4685,0.473,1504,1918,0.784,886,2621,3507,1744,653,1019,1840,8239
6537,2017-5-26,Dallas Mavericks,82,19780,2968,6750,0.44,878,2473,0.355,2090,4277,0.489,1215,1516,0.801,647,2516,3163,1705,614,921,1567,8029
6538,2017-5-27,Golden State Warriors,82,19780,3532,7140,0.495,982,2562,0.383,2550,4578,0.557,1457,1850,0.788,770,2873,3643,2491,785,1182,1585,9503
6539,2017-5-27,Houston Rockets,82,19780,3305,7152,0.462,1181,3306,0.357,2124,3846,0.552,1667,2177,0.766,892,2746,3638,2070,670,1188,1634,9458
6540,2017-5-27,Denver Nuggets,82,19755,3377,7194,0.469,870,2365,0.368,2507,4829,0.519,1537,1986,0.774,966,2837,3803,2077,568,1186,1567,9161
6541,2017-5-27,Cleveland Cavaliers,82,19880,3275,6963,0.47,1067,2779,0.384,2208,4184,0.528,1431,1913,0.748,766,2821,3587,1858,539,1081,1486,9048
6542,2017-5-27,Washington Wizards,82,19855,3388,7137,0.475,756,2030,0.372,2632,5107,0.515,1421,1812,0.784,843,2671,3514,1956,693,1103,1745,8953
6543,2017-5-27,Los Angeles Clippers,82,19755,3242,6820,0.475,841,2245,0.375,2401,4575,0.525,1586,2128,0.745,738,2790,3528,1848,612,1022,1626,8911
6544,2017-5-27,Boston Celtics,82,19755,3168,6978,0.454,985,2742,0.359,2183,4236,0.515,1536,1903,0.807,744,2698,3442,2069,617,1037,1686,8857
6545,2017-5-27,Portland Trail Blazers,82,19930,3243,7059,0.459,852,2272,0.375,2391,4787,0.499,1513,1940,0.78,830,2750,3580,1733,574,1077,1736,8851
6546,2017-5-27,Phoenix Suns,82,19830,3270,7260,0.45,615,1854,0.332,2655,5406,0.491,1676,2159,0.776,976,2712,3688,1604,673,1223,2030,8831
6547,2017-5-27,Toronto Raptors,82,19780,3211,6918,0.464,725,1996,0.363,2486,4922,0.505,1615,2028,0.796,871,2676,3547,1517,677,969,1708,8762
6548,2017-5-27,Oklahoma City Thunder,82,19805,3237,7169,0.452,692,2116,0.327,2545,5053,0.504,1575,2113,0.745,1002,2821,3823,1721,648,1199,1715,8741
6549,2017-5-27,Brooklyn Nets,82,19755,3102,6987,0.444,877,2591,0.338,2225,4396,0.506,1592,2020,0.788,721,2879,3600,1756,593,1307,1726,8673
6550,2017-5-27,Minnesota Timberwolves,82,19805,3235,6922,0.467,601,1723,0.349,2634,5199,0.507,1586,1986,0.799,938,2540,3478,1940,654,1099,1646,8657
6551,2017-5-27,San Antonio Spurs,82,19805,3222,6864,0.469,753,1927,0.391,2469,4937,0.5,1440,1806,0.797,821,2777,3598,1954,655,1057,1498,8637
6552,2017-5-27,Indiana Pacers,82,19855,3221,6931,0.465,709,1885,0.376,2512,5046,0.498,1467,1811,0.81,742,2702,3444,1844,669,1087,1597,8618
6553,2017-5-27,Charlotte Hornets,82,19830,3093,7000,0.442,824,2347,0.351,2269,4653,0.488,1591,1953,0.815,721,2853,3574,1891,571,899,1360,8601
6554,2017-5-27,Los Angeles Lakers,82,19705,3224,7164,0.45,730,2110,0.346,2494,5054,0.493,1397,1853,0.754,933,2636,3569,1716,674,1193,1698,8575
6555,2017-5-27,New Orleans Pelicans,82,19905,3210,7130,0.45,768,2196,0.35,2442,4934,0.495,1368,1825,0.75,703,2879,3582,1869,638,1012,1490,8556
6556,2017-5-27,New York Knicks,82,19855,3244,7256,0.447,704,2022,0.348,2540,5234,0.485,1364,1731,0.788,983,2723,3706,1786,581,1081,1668,8556
6557,2017-5-27,Milwaukee Bucks,82,19780,3182,6715,0.474,720,1946,0.37,2462,4769,0.516,1413,1839,0.768,723,2589,3312,1984,666,1096,1660,8497
6558,2017-5-27,Atlanta Hawks,82,19880,3123,6918,0.451,729,2137,0.341,2394,4781,0.501,1484,2039,0.728,842,2793,3635,1938,672,1249,1491,8459
6559,2017-5-27,Miami Heat,82,19780,3202,7037,0.455,808,2213,0.365,2394,4824,0.496,1248,1768,0.706,872,2705,3577,1742,588,1033,1680,8460
6560,2017-5-27,Chicago Bulls,82,19780,3169,7141,0.444,623,1831,0.34,2546,5310,0.479,1474,1848,0.798,999,2797,3796,1851,643,1065,1455,8435
6561,2017-5-27,Sacramento Kings,82,19880,3105,6734,0.461,737,1960,0.376,2368,4774,0.496,1483,1913,0.775,715,2652,3367,1844,627,1157,1667,8430
6562,2017-5-27,Philadelphia 76ers,82,19830,3088,6992,0.442,831,2443,0.34,2257,4549,0.496,1393,1806,0.771,807,2706,3513,1949,692,1310,1793,8400
6563,2017-5-27,Detroit Pistons,82,19805,3269,7282,0.449,631,1915,0.33,2638,5367,0.492,1140,1586,0.719,908,2838,3746,1732,574,932,1467,8309
6564,2017-5-27,Orlando Magic,82,19805,3139,7133,0.44,701,2139,0.328,2438,4994,0.488,1309,1753,0.747,807,2734,3541,1820,580,1053,1584,8288
6565,2017-5-27,Utah Jazz,82,19755,3033,6515,0.466,791,2128,0.372,2242,4387,0.511,1401,1875,0.747,771,2774,3545,1651,550,1060,1545,8258
6566,2017-5-27,Memphis Grizzlies,82,19905,2984,6854,0.435,767,2169,0.354,2217,4685,0.473,1504,1918,0.784,886,2621,3507,1744,653,1019,1840,8239
6567,2017-5-27,Dallas Mavericks,82,19780,2968,6750,0.44,878,2473,0.355,2090,4277,0.489,1215,1516,0.801,647,2516,3163,1705,614,921,1567,8029
6568,2017-5-28,Golden State Warriors,82,19780,3532,7140,0.495,982,2562,0.383,2550,4578,0.557,1457,1850,0.788,770,2873,3643,2491,785,1182,1585,9503
6569,2017-5-28,Houston Rockets,82,19780,3305,7152,0.462,1181,3306,0.357,2124,3846,0.552,1667,2177,0.766,892,2746,3638,2070,670,1188,1634,9458
6570,2017-5-28,Denver Nuggets,82,19755,3377,7194,0.469,870,2365,0.368,2507,4829,0.519,1537,1986,0.774,966,2837,3803,2077,568,1186,1567,9161
6571,2017-5-28,Cleveland Cavaliers,82,19880,3275,6963,0.47,1067,2779,0.384,2208,4184,0.528,1431,1913,0.748,766,2821,3587,1858,539,1081,1486,9048
6572,2017-5-28,Washington Wizards,82,19855,3388,7137,0.475,756,2030,0.372,2632,5107,0.515,1421,1812,0.784,843,2671,3514,1956,693,1103,1745,8953
6573,2017-5-28,Los Angeles Clippers,82,19755,3242,6820,0.475,841,2245,0.375,2401,4575,0.525,1586,2128,0.745,738,2790,3528,1848,612,1022,1626,8911
6574,2017-5-28,Boston Celtics,82,19755,3168,6978,0.454,985,2742,0.359,2183,4236,0.515,1536,1903,0.807,744,2698,3442,2069,617,1037,1686,8857
6575,2017-5-28,Portland Trail Blazers,82,19930,3243,7059,0.459,852,2272,0.375,2391,4787,0.499,1513,1940,0.78,830,2750,3580,1733,574,1077,1736,8851
6576,2017-5-28,Phoenix Suns,82,19830,3270,7260,0.45,615,1854,0.332,2655,5406,0.491,1676,2159,0.776,976,2712,3688,1604,673,1223,2030,8831
6577,2017-5-28,Toronto Raptors,82,19780,3211,6918,0.464,725,1996,0.363,2486,4922,0.505,1615,2028,0.796,871,2676,3547,1517,677,969,1708,8762
6578,2017-5-28,Oklahoma City Thunder,82,19805,3237,7169,0.452,692,2116,0.327,2545,5053,0.504,1575,2113,0.745,1002,2821,3823,1721,648,1199,1715,8741
6579,2017-5-28,Brooklyn Nets,82,19755,3102,6987,0.444,877,2591,0.338,2225,4396,0.506,1592,2020,0.788,721,2879,3600,1756,593,1307,1726,8673
6580,2017-5-28,Minnesota Timberwolves,82,19805,3235,6922,0.467,601,1723,0.349,2634,5199,0.507,1586,1986,0.799,938,2540,3478,1940,654,1099,1646,8657
6581,2017-5-28,San Antonio Spurs,82,19805,3222,6864,0.469,753,1927,0.391,2469,4937,0.5,1440,1806,0.797,821,2777,3598,1954,655,1057,1498,8637
6582,2017-5-28,Indiana Pacers,82,19855,3221,6931,0.465,709,1885,0.376,2512,5046,0.498,1467,1811,0.81,742,2702,3444,1844,669,1087,1597,8618
6583,2017-5-28,Charlotte Hornets,82,19830,3093,7000,0.442,824,2347,0.351,2269,4653,0.488,1591,1953,0.815,721,2853,3574,1891,571,899,1360,8601
6584,2017-5-28,Los Angeles Lakers,82,19705,3224,7164,0.45,730,2110,0.346,2494,5054,0.493,1397,1853,0.754,933,2636,3569,1716,674,1193,1698,8575
6585,2017-5-28,New Orleans Pelicans,82,19905,3210,7130,0.45,768,2196,0.35,2442,4934,0.495,1368,1825,0.75,703,2879,3582,1869,638,1012,1490,8556
6586,2017-5-28,New York Knicks,82,19855,3244,7256,0.447,704,2022,0.348,2540,5234,0.485,1364,1731,0.788,983,2723,3706,1786,581,1081,1668,8556
6587,2017-5-28,Milwaukee Bucks,82,19780,3182,6715,0.474,720,1946,0.37,2462,4769,0.516,1413,1839,0.768,723,2589,3312,1984,666,1096,1660,8497
6588,2017-5-28,Atlanta Hawks,82,19880,3123,6918,0.451,729,2137,0.341,2394,4781,0.501,1484,2039,0.728,842,2793,3635,1938,672,1249,1491,8459
6589,2017-5-28,Miami Heat,82,19780,3202,7037,0.455,808,2213,0.365,2394,4824,0.496,1248,1768,0.706,872,2705,3577,1742,588,1033,1680,8460
6590,2017-5-28,Chicago Bulls,82,19780,3169,7141,0.444,623,1831,0.34,2546,5310,0.479,1474,1848,0.798,999,2797,3796,1851,643,1065,1455,8435
6591,2017-5-28,Sacramento Kings,82,19880,3105,6734,0.461,737,1960,0.376,2368,4774,0.496,1483,1913,0.775,715,2652,3367,1844,627,1157,1667,8430
6592,2017-5-28,Philadelphia 76ers,82,19830,3088,6992,0.442,831,2443,0.34,2257,4549,0.496,1393,1806,0.771,807,2706,3513,1949,692,1310,1793,8400
6593,2017-5-28,Detroit Pistons,82,19805,3269,7282,0.449,631,1915,0.33,2638,5367,0.492,1140,1586,0.719,908,2838,3746,1732,574,932,1467,8309
6594,2017-5-28,Orlando Magic,82,19805,3139,7133,0.44,701,2139,0.328,2438,4994,0.488,1309,1753,0.747,807,2734,3541,1820,580,1053,1584,8288
6595,2017-5-28,Utah Jazz,82,19755,3033,6515,0.466,791,2128,0.372,2242,4387,0.511,1401,1875,0.747,771,2774,3545,1651,550,1060,1545,8258
6596,2017-5-28,Memphis Grizzlies,82,19905,2984,6854,0.435,767,2169,0.354,2217,4685,0.473,1504,1918,0.784,886,2621,3507,1744,653,1019,1840,8239
6597,2017-5-28,Dallas Mavericks,82,19780,2968,6750,0.44,878,2473,0.355,2090,4277,0.489,1215,1516,0.801,647,2516,3163,1705,614,921,1567,8029
6598,2017-5-29,Golden State Warriors,82,19780,3532,7140,0.495,982,2562,0.383,2550,4578,0.557,1457,1850,0.788,770,2873,3643,2491,785,1182,1585,9503
6599,2017-5-29,Houston Rockets,82,19780,3305,7152,0.462,1181,3306,0.357,2124,3846,0.552,1667,2177,0.766,892,2746,3638,2070,670,1188,1634,9458
6600,2017-5-29,Denver Nuggets,82,19755,3377,7194,0.469,870,2365,0.368,2507,4829,0.519,1537,1986,0.774,966,2837,3803,2077,568,1186,1567,9161
6601,2017-5-29,Cleveland Cavaliers,82,19880,3275,6963,0.47,1067,2779,0.384,2208,4184,0.528,1431,1913,0.748,766,2821,3587,1858,539,1081,1486,9048
6602,2017-5-29,Washington Wizards,82,19855,3388,7137,0.475,756,2030,0.372,2632,5107,0.515,1421,1812,0.784,843,2671,3514,1956,693,1103,1745,8953
6603,2017-5-29,Los Angeles Clippers,82,19755,3242,6820,0.475,841,2245,0.375,2401,4575,0.525,1586,2128,0.745,738,2790,3528,1848,612,1022,1626,8911
6604,2017-5-29,Boston Celtics,82,19755,3168,6978,0.454,985,2742,0.359,2183,4236,0.515,1536,1903,0.807,744,2698,3442,2069,617,1037,1686,8857
6605,2017-5-29,Portland Trail Blazers,82,19930,3243,7059,0.459,852,2272,0.375,2391,4787,0.499,1513,1940,0.78,830,2750,3580,1733,574,1077,1736,8851
6606,2017-5-29,Phoenix Suns,82,19830,3270,7260,0.45,615,1854,0.332,2655,5406,0.491,1676,2159,0.776,976,2712,3688,1604,673,1223,2030,8831
6607,2017-5-29,Toronto Raptors,82,19780,3211,6918,0.464,725,1996,0.363,2486,4922,0.505,1615,2028,0.796,871,2676,3547,1517,677,969,1708,8762
6608,2017-5-29,Oklahoma City Thunder,82,19805,3237,7169,0.452,692,2116,0.327,2545,5053,0.504,1575,2113,0.745,1002,2821,3823,1721,648,1199,1715,8741
6609,2017-5-29,Brooklyn Nets,82,19755,3102,6987,0.444,877,2591,0.338,2225,4396,0.506,1592,2020,0.788,721,2879,3600,1756,593,1307,1726,8673
6610,2017-5-29,Minnesota Timberwolves,82,19805,3235,6922,0.467,601,1723,0.349,2634,5199,0.507,1586,1986,0.799,938,2540,3478,1940,654,1099,1646,8657
6611,2017-5-29,San Antonio Spurs,82,19805,3222,6864,0.469,753,1927,0.391,2469,4937,0.5,1440,1806,0.797,821,2777,3598,1954,655,1057,1498,8637
6612,2017-5-29,Indiana Pacers,82,19855,3221,6931,0.465,709,1885,0.376,2512,5046,0.498,1467,1811,0.81,742,2702,3444,1844,669,1087,1597,8618
6613,2017-5-29,Charlotte Hornets,82,19830,3093,7000,0.442,824,2347,0.351,2269,4653,0.488,1591,1953,0.815,721,2853,3574,1891,571,899,1360,8601
6614,2017-5-29,Los Angeles Lakers,82,19705,3224,7164,0.45,730,2110,0.346,2494,5054,0.493,1397,1853,0.754,933,2636,3569,1716,674,1193,1698,8575
6615,2017-5-29,New Orleans Pelicans,82,19905,3210,7130,0.45,768,2196,0.35,2442,4934,0.495,1368,1825,0.75,703,2879,3582,1869,638,1012,1490,8556
6616,2017-5-29,New York Knicks,82,19855,3244,7256,0.447,704,2022,0.348,2540,5234,0.485,1364,1731,0.788,983,2723,3706,1786,581,1081,1668,8556
6617,2017-5-29,Milwaukee Bucks,82,19780,3182,6715,0.474,720,1946,0.37,2462,4769,0.516,1413,1839,0.768,723,2589,3312,1984,666,1096,1660,8497
6618,2017-5-29,Atlanta Hawks,82,19880,3123,6918,0.451,729,2137,0.341,2394,4781,0.501,1484,2039,0.728,842,2793,3635,1938,672,1249,1491,8459
6619,2017-5-29,Miami Heat,82,19780,3202,7037,0.455,808,2213,0.365,2394,4824,0.496,1248,1768,0.706,872,2705,3577,1742,588,1033,1680,8460
6620,2017-5-29,Chicago Bulls,82,19780,3169,7141,0.444,623,1831,0.34,2546,5310,0.479,1474,1848,0.798,999,2797,3796,1851,643,1065,1455,8435
6621,2017-5-29,Sacramento Kings,82,19880,3105,6734,0.461,737,1960,0.376,2368,4774,0.496,1483,1913,0.775,715,2652,3367,1844,627,1157,1667,8430
6622,2017-5-29,Philadelphia 76ers,82,19830,3088,6992,0.442,831,2443,0.34,2257,4549,0.496,1393,1806,0.771,807,2706,3513,1949,692,1310,1793,8400
6623,2017-5-29,Detroit Pistons,82,19805,3269,7282,0.449,631,1915,0.33,2638,5367,0.492,1140,1586,0.719,908,2838,3746,1732,574,932,1467,8309
6624,2017-5-29,Orlando Magic,82,19805,3139,7133,0.44,701,2139,0.328,2438,4994,0.488,1309,1753,0.747,807,2734,3541,1820,580,1053,1584,8288
6625,2017-5-29,Utah Jazz,82,19755,3033,6515,0.466,791,2128,0.372,2242,4387,0.511,1401,1875,0.747,771,2774,3545,1651,550,1060,1545,8258
6626,2017-5-29,Memphis Grizzlies,82,19905,2984,6854,0.435,767,2169,0.354,2217,4685,0.473,1504,1918,0.784,886,2621,3507,1744,653,1019,1840,8239
6627,2017-5-29,Dallas Mavericks,82,19780,2968,6750,0.44,878,2473,0.355,2090,4277,0.489,1215,1516,0.801,647,2516,3163,1705,614,921,1567,8029
6628,2017-5-30,Golden State Warriors,82,19780,3532,7140,0.495,982,2562,0.383,2550,4578,0.557,1457,1850,0.788,770,2873,3643,2491,785,1182,1585,9503
6629,2017-5-30,Houston Rockets,82,19780,3305,7152,0.462,1181,3306,0.357,2124,3846,0.552,1667,2177,0.766,892,2746,3638,2070,670,1188,1634,9458
6630,2017-5-30,Denver Nuggets,82,19755,3377,7194,0.469,870,2365,0.368,2507,4829,0.519,1537,1986,0.774,966,2837,3803,2077,568,1186,1567,9161
6631,2017-5-30,Cleveland Cavaliers,82,19880,3275,6963,0.47,1067,2779,0.384,2208,4184,0.528,1431,1913,0.748,766,2821,3587,1858,539,1081,1486,9048
6632,2017-5-30,Washington Wizards,82,19855,3388,7137,0.475,756,2030,0.372,2632,5107,0.515,1421,1812,0.784,843,2671,3514,1956,693,1103,1745,8953
6633,2017-5-30,Los Angeles Clippers,82,19755,3242,6820,0.475,841,2245,0.375,2401,4575,0.525,1586,2128,0.745,738,2790,3528,1848,612,1022,1626,8911
6634,2017-5-30,Boston Celtics,82,19755,3168,6978,0.454,985,2742,0.359,2183,4236,0.515,1536,1903,0.807,744,2698,3442,2069,617,1037,1686,8857
6635,2017-5-30,Portland Trail Blazers,82,19930,3243,7059,0.459,852,2272,0.375,2391,4787,0.499,1513,1940,0.78,830,2750,3580,1733,574,1077,1736,8851
6636,2017-5-30,Phoenix Suns,82,19830,3270,7260,0.45,615,1854,0.332,2655,5406,0.491,1676,2159,0.776,976,2712,3688,1604,673,1223,2030,8831
6637,2017-5-30,Toronto Raptors,82,19780,3211,6918,0.464,725,1996,0.363,2486,4922,0.505,1615,2028,0.796,871,2676,3547,1517,677,969,1708,8762
6638,2017-5-30,Oklahoma City Thunder,82,19805,3237,7169,0.452,692,2116,0.327,2545,5053,0.504,1575,2113,0.745,1002,2821,3823,1721,648,1199,1715,8741
6639,2017-5-30,Brooklyn Nets,82,19755,3102,6987,0.444,877,2591,0.338,2225,4396,0.506,1592,2020,0.788,721,2879,3600,1756,593,1307,1726,8673
6640,2017-5-30,Minnesota Timberwolves,82,19805,3235,6922,0.467,601,1723,0.349,2634,5199,0.507,1586,1986,0.799,938,2540,3478,1940,654,1099,1646,8657
6641,2017-5-30,San Antonio Spurs,82,19805,3222,6864,0.469,753,1927,0.391,2469,4937,0.5,1440,1806,0.797,821,2777,3598,1954,655,1057,1498,8637
6642,2017-5-30,Indiana Pacers,82,19855,3221,6931,0.465,709,1885,0.376,2512,5046,0.498,1467,1811,0.81,742,2702,3444,1844,669,1087,1597,8618
6643,2017-5-30,Charlotte Hornets,82,19830,3093,7000,0.442,824,2347,0.351,2269,4653,0.488,1591,1953,0.815,721,2853,3574,1891,571,899,1360,8601
6644,2017-5-30,Los Angeles Lakers,82,19705,3224,7164,0.45,730,2110,0.346,2494,5054,0.493,1397,1853,0.754,933,2636,3569,1716,674,1193,1698,8575
6645,2017-5-30,New Orleans Pelicans,82,19905,3210,7130,0.45,768,2196,0.35,2442,4934,0.495,1368,1825,0.75,703,2879,3582,1869,638,1012,1490,8556
6646,2017-5-30,New York Knicks,82,19855,3244,7256,0.447,704,2022,0.348,2540,5234,0.485,1364,1731,0.788,983,2723,3706,1786,581,1081,1668,8556
6647,2017-5-30,Milwaukee Bucks,82,19780,3182,6715,0.474,720,1946,0.37,2462,4769,0.516,1413,1839,0.768,723,2589,3312,1984,666,1096,1660,8497
6648,2017-5-30,Atlanta Hawks,82,19880,3123,6918,0.451,729,2137,0.341,2394,4781,0.501,1484,2039,0.728,842,2793,3635,1938,672,1249,1491,8459
6649,2017-5-30,Miami Heat,82,19780,3202,7037,0.455,808,2213,0.365,2394,4824,0.496,1248,1768,0.706,872,2705,3577,1742,588,1033,1680,8460
6650,2017-5-30,Chicago Bulls,82,19780,3169,7141,0.444,623,1831,0.34,2546,5310,0.479,1474,1848,0.798,999,2797,3796,1851,643,1065,1455,8435
6651,2017-5-30,Sacramento Kings,82,19880,3105,6734,0.461,737,1960,0.376,2368,4774,0.496,1483,1913,0.775,715,2652,3367,1844,627,1157,1667,8430
6652,2017-5-30,Philadelphia 76ers,82,19830,3088,6992,0.442,831,2443,0.34,2257,4549,0.496,1393,1806,0.771,807,2706,3513,1949,692,1310,1793,8400
6653,2017-5-30,Detroit Pistons,82,19805,3269,7282,0.449,631,1915,0.33,2638,5367,0.492,1140,1586,0.719,908,2838,3746,1732,574,932,1467,8309
6654,2017-5-30,Orlando Magic,82,19805,3139,7133,0.44,701,2139,0.328,2438,4994,0.488,1309,1753,0.747,807,2734,3541,1820,580,1053,1584,8288
6655,2017-5-30,Utah Jazz,82,19755,3033,6515,0.466,791,2128,0.372,2242,4387,0.511,1401,1875,0.747,771,2774,3545,1651,550,1060,1545,8258
6656,2017-5-30,Memphis Grizzlies,82,19905,2984,6854,0.435,767,2169,0.354,2217,4685,0.473,1504,1918,0.784,886,2621,3507,1744,653,1019,1840,8239
6657,2017-5-30,Dallas Mavericks,82,19780,2968,6750,0.44,878,2473,0.355,2090,4277,0.489,1215,1516,0.801,647,2516,3163,1705,614,921,1567,8029
6658,2018-1-1,Houston Rockets,35,8450,1369,2952,0.464,554,1516,0.365,815,1436,0.568,741,927,0.799,325,1206,1531,777,320,512,728,4033
6659,2018-1-1,Golden State Warriors,37,8930,1609,3169,0.508,431,1105,0.39,1178,2064,0.571,612,750,0.816,317,1342,1659,1127,308,579,741,4261
6660,2018-1-1,New Orleans Pelicans,36,8715,1499,3061,0.49,405,1064,0.381,1094,1997,0.548,599,792,0.756,294,1246,1540,962,265,548,706,4002
6661,2018-1-1,Toronto Raptors,34,8160,1381,2930,0.471,379,1082,0.35,1002,1848,0.542,621,778,0.798,326,1118,1444,776,299,451,754,3762
6662,2018-1-1,Cleveland Cavaliers,36,8665,1424,2982,0.478,451,1183,0.381,973,1799,0.541,663,819,0.81,298,1206,1504,845,261,500,669,3962
6663,2018-1-1,Minnesota Timberwolves,37,8955,1498,3148,0.476,302,854,0.354,1196,2294,0.521,718,904,0.794,387,1151,1538,844,329,464,665,4016
6664,2018-1-1,Philadelphia 76ers,36,8740,1447,3139,0.461,382,1075,0.355,1065,2064,0.516,623,829,0.752,407,1311,1718,944,303,629,860,3899
6665,2018-1-1,Brooklyn Nets,36,8665,1386,3144,0.441,433,1236,0.35,953,1908,0.499,663,879,0.754,377,1261,1638,821,235,533,743,3868
6666,2018-1-1,Los Angeles Lakers,35,8550,1432,3154,0.454,307,940,0.327,1125,2214,0.508,585,848,0.69,397,1228,1625,811,286,553,787,3756
6667,2018-1-1,Denver Nuggets,36,8715,1434,3105,0.462,398,1099,0.362,1036,2006,0.516,592,797,0.743,425,1213,1638,838,276,536,638,3858
6668,2018-1-1,Indiana Pacers,37,8930,1517,3186,0.476,361,936,0.386,1156,2250,0.514,563,729,0.772,340,1213,1553,839,289,485,682,3958
6669,2018-1-1,Washington Wizards,37,8930,1464,3191,0.459,362,984,0.368,1102,2207,0.499,642,843,0.762,369,1238,1607,840,287,486,804,3932
6670,2018-1-1,Phoenix Suns,38,9145,1469,3315,0.443,334,990,0.337,1135,2325,0.488,750,988,0.759,426,1296,1722,775,250,574,850,4022
6671,2018-1-1,Los Angeles Clippers,35,8425,1340,2952,0.454,373,1053,0.354,967,1899,0.509,640,852,0.751,366,1162,1528,728,267,490,732,3693
6672,2018-1-1,Orlando Magic,37,8905,1463,3186,0.459,391,1079,0.362,1072,2107,0.509,567,761,0.745,309,1222,1531,858,273,535,729,3884
6673,2018-1-1,Milwaukee Bucks,34,8185,1340,2779,0.482,295,846,0.349,1045,1933,0.541,589,778,0.757,259,1055,1314,769,286,427,761,3564
6674,2018-1-1,Charlotte Hornets,36,8690,1353,3107,0.435,315,903,0.349,1038,2204,0.471,731,1002,0.73,384,1297,1681,742,236,470,656,3752
6675,2018-1-1,Atlanta Hawks,36,8665,1395,3049,0.458,394,1030,0.383,1001,2019,0.496,556,713,0.78,336,1108,1444,871,309,538,708,3740
6676,2018-1-1,New York Knicks,36,8665,1439,3095,0.465,277,779,0.356,1162,2316,0.502,575,720,0.799,392,1211,1603,821,253,530,746,3730
6677,2018-1-1,Oklahoma City Thunder,37,8980,1430,3198,0.447,376,1066,0.353,1054,2132,0.494,595,838,0.71,448,1183,1631,765,358,515,764,3831
6678,2018-1-1,Boston Celtics,40,9625,1506,3324,0.453,468,1244,0.376,1038,2080,0.499,658,861,0.764,352,1409,1761,883,301,533,803,4138
6679,2018-1-1,Detroit Pistons,35,8400,1345,3009,0.447,383,1010,0.379,962,1999,0.481,502,665,0.755,365,1124,1489,767,272,470,660,3575
6680,2018-1-1,Portland Trail Blazers,35,8425,1321,2982,0.443,318,865,0.368,1003,2117,0.474,598,753,0.794,346,1227,1573,633,234,492,684,3558
6681,2018-1-1,San Antonio Spurs,37,8880,1420,3092,0.459,324,897,0.361,1096,2195,0.499,579,741,0.781,374,1273,1647,819,260,500,632,3743
6682,2018-1-1,Utah Jazz,37,8905,1366,3047,0.448,413,1104,0.374,953,1943,0.49,600,744,0.806,312,1186,1498,783,338,512,741,3745
6683,2018-1-1,Dallas Mavericks,38,9145,1434,3194,0.449,445,1211,0.367,989,1983,0.499,526,683,0.77,293,1253,1546,843,251,472,729,3839
6684,2018-1-1,Chicago Bulls,36,8690,1382,3171,0.436,377,1077,0.35,1005,2094,0.48,477,645,0.74,335,1277,1612,844,254,466,687,3618
6685,2018-1-1,Miami Heat,36,8665,1340,2948,0.455,414,1126,0.368,926,1822,0.508,520,680,0.765,293,1191,1484,755,266,523,725,3614
6686,2018-1-1,Memphis Grizzlies,37,8905,1326,2982,0.445,354,1001,0.354,972,1981,0.491,647,815,0.794,319,1148,1467,769,270,500,842,3653
6687,2018-1-1,Sacramento Kings,36,8665,1367,3050,0.448,311,813,0.383,1056,2237,0.472,446,618,0.722,335,1101,1436,748,286,489,710,3491
6688,2018-1-2,Houston Rockets,35,8450,1369,2952,0.464,554,1516,0.365,815,1436,0.568,741,927,0.799,325,1206,1531,777,320,512,728,4033
6689,2018-1-2,Golden State Warriors,37,8930,1609,3169,0.508,431,1105,0.39,1178,2064,0.571,612,750,0.816,317,1342,1659,1127,308,579,741,4261
6690,2018-1-2,New Orleans Pelicans,36,8715,1499,3061,0.49,405,1064,0.381,1094,1997,0.548,599,792,0.756,294,1246,1540,962,265,548,706,4002
6691,2018-1-2,Toronto Raptors,35,8425,1426,3021,0.472,393,1115,0.352,1033,1906,0.542,648,811,0.799,332,1152,1484,801,307,463,774,3893
6692,2018-1-2,Cleveland Cavaliers,36,8665,1424,2982,0.478,451,1183,0.381,973,1799,0.541,663,819,0.81,298,1206,1504,845,261,500,669,3962
6693,2018-1-2,Minnesota Timberwolves,38,9195,1538,3229,0.476,309,874,0.354,1229,2355,0.522,745,934,0.798,394,1185,1579,870,343,481,689,4130
6694,2018-1-2,Philadelphia 76ers,36,8740,1447,3139,0.461,382,1075,0.355,1065,2064,0.516,623,829,0.752,407,1311,1718,944,303,629,860,3899
6695,2018-1-2,Brooklyn Nets,37,8905,1422,3226,0.441,442,1261,0.351,980,1965,0.499,680,902,0.754,387,1303,1690,838,242,546,765,3966
6696,2018-1-2,Denver Nuggets,36,8715,1434,3105,0.462,398,1099,0.362,1036,2006,0.516,592,797,0.743,425,1213,1638,838,276,536,638,3858
6697,2018-1-2,Los Angeles Lakers,36,8790,1466,3230,0.454,315,966,0.326,1151,2264,0.508,605,877,0.69,406,1256,1662,829,298,577,812,3852
6698,2018-1-2,Indiana Pacers,37,8930,1517,3186,0.476,361,936,0.386,1156,2250,0.514,563,729,0.772,340,1213,1553,839,289,485,682,3958
6699,2018-1-2,Washington Wizards,37,8930,1464,3191,0.459,362,984,0.368,1102,2207,0.499,642,843,0.762,369,1238,1607,840,287,486,804,3932
6700,2018-1-2,Phoenix Suns,38,9145,1469,3315,0.443,334,990,0.337,1135,2325,0.488,750,988,0.759,426,1296,1722,775,250,574,850,4022
6701,2018-1-2,Milwaukee Bucks,35,8450,1384,2872,0.482,308,873,0.353,1076,1999,0.538,615,806,0.763,269,1088,1357,796,295,441,784,3691
6702,2018-1-2,Los Angeles Clippers,35,8425,1340,2952,0.454,373,1053,0.354,967,1899,0.509,640,852,0.751,366,1162,1528,728,267,490,732,3693
6703,2018-1-2,Orlando Magic,38,9145,1498,3282,0.456,397,1110,0.358,1101,2172,0.507,586,786,0.746,328,1255,1583,874,278,547,747,3979
6704,2018-1-2,Charlotte Hornets,36,8690,1353,3107,0.435,315,903,0.349,1038,2204,0.471,731,1002,0.73,384,1297,1681,742,236,470,656,3752
6705,2018-1-2,Atlanta Hawks,36,8665,1395,3049,0.458,394,1030,0.383,1001,2019,0.496,556,713,0.78,336,1108,1444,871,309,538,708,3740
6706,2018-1-2,New York Knicks,36,8665,1439,3095,0.465,277,779,0.356,1162,2316,0.502,575,720,0.799,392,1211,1603,821,253,530,746,3730
6707,2018-1-2,Oklahoma City Thunder,37,8980,1430,3198,0.447,376,1066,0.353,1054,2132,0.494,595,838,0.71,448,1183,1631,765,358,515,764,3831
6708,2018-1-2,Boston Celtics,40,9625,1506,3324,0.453,468,1244,0.376,1038,2080,0.499,658,861,0.764,352,1409,1761,883,301,533,803,4138
6709,2018-1-2,Portland Trail Blazers,36,8690,1368,3090,0.443,332,898,0.37,1036,2192,0.473,614,771,0.796,358,1265,1623,658,241,500,700,3682
6710,2018-1-2,Detroit Pistons,35,8400,1345,3009,0.447,383,1010,0.379,962,1999,0.481,502,665,0.755,365,1124,1489,767,272,470,660,3575
6711,2018-1-2,San Antonio Spurs,37,8880,1420,3092,0.459,324,897,0.361,1096,2195,0.499,579,741,0.781,374,1273,1647,819,260,500,632,3743
6712,2018-1-2,Utah Jazz,37,8905,1366,3047,0.448,413,1104,0.374,953,1943,0.49,600,744,0.806,312,1186,1498,783,338,512,741,3745
6713,2018-1-2,Dallas Mavericks,38,9145,1434,3194,0.449,445,1211,0.367,989,1983,0.499,526,683,0.77,293,1253,1546,843,251,472,729,3839
6714,2018-1-2,Chicago Bulls,37,8955,1427,3275,0.436,388,1104,0.351,1039,2171,0.479,496,668,0.743,350,1320,1670,872,259,478,708,3738
6715,2018-1-2,Miami Heat,36,8665,1340,2948,0.455,414,1126,0.368,926,1822,0.508,520,680,0.765,293,1191,1484,755,266,523,725,3614
6716,2018-1-2,Memphis Grizzlies,37,8905,1326,2982,0.445,354,1001,0.354,972,1981,0.491,647,815,0.794,319,1148,1467,769,270,500,842,3653
6717,2018-1-2,Sacramento Kings,36,8665,1367,3050,0.448,311,813,0.383,1056,2237,0.472,446,618,0.722,335,1101,1436,748,286,489,710,3491
6718,2018-1-3,Houston Rockets,35,8450,1369,2952,0.464,554,1516,0.365,815,1436,0.568,741,927,0.799,325,1206,1531,777,320,512,728,4033
6719,2018-1-3,Golden State Warriors,37,8930,1609,3169,0.508,431,1105,0.39,1178,2064,0.571,612,750,0.816,317,1342,1659,1127,308,579,741,4261
6720,2018-1-3,New Orleans Pelicans,36,8715,1499,3061,0.49,405,1064,0.381,1094,1997,0.548,599,792,0.756,294,1246,1540,962,265,548,706,4002
6721,2018-1-3,Toronto Raptors,35,8425,1426,3021,0.472,393,1115,0.352,1033,1906,0.542,648,811,0.799,332,1152,1484,801,307,463,774,3893
6722,2018-1-3,Cleveland Cavaliers,37,8905,1467,3065,0.479,464,1215,0.382,1003,1850,0.542,691,856,0.807,306,1238,1544,873,272,510,686,4089
6723,2018-1-3,Minnesota Timberwolves,38,9195,1538,3229,0.476,309,874,0.354,1229,2355,0.522,745,934,0.798,394,1185,1579,870,343,481,689,4130
6724,2018-1-3,Philadelphia 76ers,36,8740,1447,3139,0.461,382,1075,0.355,1065,2064,0.516,623,829,0.752,407,1311,1718,944,303,629,860,3899
6725,2018-1-3,Brooklyn Nets,37,8905,1422,3226,0.441,442,1261,0.351,980,1965,0.499,680,902,0.754,387,1303,1690,838,242,546,765,3966
6726,2018-1-3,Denver Nuggets,36,8715,1434,3105,0.462,398,1099,0.362,1036,2006,0.516,592,797,0.743,425,1213,1638,838,276,536,638,3858
6727,2018-1-3,Los Angeles Lakers,36,8790,1466,3230,0.454,315,966,0.326,1151,2264,0.508,605,877,0.69,406,1256,1662,829,298,577,812,3852
6728,2018-1-3,Indiana Pacers,37,8930,1517,3186,0.476,361,936,0.386,1156,2250,0.514,563,729,0.772,340,1213,1553,839,289,485,682,3958
6729,2018-1-3,Washington Wizards,37,8930,1464,3191,0.459,362,984,0.368,1102,2207,0.499,642,843,0.762,369,1238,1607,840,287,486,804,3932
6730,2018-1-3,Phoenix Suns,39,9385,1508,3392,0.445,341,1012,0.337,1167,2380,0.49,769,1015,0.758,437,1332,1769,799,257,595,872,4126
6731,2018-1-3,Los Angeles Clippers,36,8665,1379,3023,0.456,382,1076,0.355,997,1947,0.512,666,883,0.754,370,1192,1562,751,272,509,756,3806
6732,2018-1-3,Milwaukee Bucks,35,8450,1384,2872,0.482,308,873,0.353,1076,1999,0.538,615,806,0.763,269,1088,1357,796,295,441,784,3691
6733,2018-1-3,Charlotte Hornets,37,8930,1404,3196,0.439,330,935,0.353,1074,2261,0.475,745,1020,0.73,389,1322,1711,767,243,473,670,3883
6734,2018-1-3,Orlando Magic,38,9145,1498,3282,0.456,397,1110,0.358,1101,2172,0.507,586,786,0.746,328,1255,1583,874,278,547,747,3979
6735,2018-1-3,Atlanta Hawks,37,8905,1431,3136,0.456,404,1061,0.381,1027,2075,0.495,577,738,0.782,353,1131,1484,889,320,554,730,3843
6736,2018-1-3,Oklahoma City Thunder,37,8980,1430,3198,0.447,376,1066,0.353,1054,2132,0.494,595,838,0.71,448,1183,1631,765,358,515,764,3831
6737,2018-1-3,Boston Celtics,40,9625,1506,3324,0.453,468,1244,0.376,1038,2080,0.499,658,861,0.764,352,1409,1761,883,301,533,803,4138
6738,2018-1-3,New York Knicks,37,8905,1474,3182,0.463,284,801,0.355,1190,2381,0.5,589,738,0.798,404,1249,1653,842,258,544,769,3821
6739,2018-1-3,Portland Trail Blazers,37,8930,1410,3180,0.443,345,930,0.371,1065,2250,0.473,627,790,0.794,371,1295,1666,683,246,515,729,3792
6740,2018-1-3,Detroit Pistons,35,8400,1345,3009,0.447,383,1010,0.379,962,1999,0.481,502,665,0.755,365,1124,1489,767,272,470,660,3575
6741,2018-1-3,Utah Jazz,37,8905,1366,3047,0.448,413,1104,0.374,953,1943,0.49,600,744,0.806,312,1186,1498,783,338,512,741,3745
6742,2018-1-3,San Antonio Spurs,38,9120,1451,3174,0.457,334,924,0.361,1117,2250,0.496,607,775,0.783,388,1309,1697,837,271,508,649,3843
6743,2018-1-3,Dallas Mavericks,38,9145,1434,3194,0.449,445,1211,0.367,989,1983,0.499,526,683,0.77,293,1253,1546,843,251,472,729,3839
6744,2018-1-3,Chicago Bulls,37,8955,1427,3275,0.436,388,1104,0.351,1039,2171,0.479,496,668,0.743,350,1320,1670,872,259,478,708,3738
6745,2018-1-3,Miami Heat,36,8665,1340,2948,0.455,414,1126,0.368,926,1822,0.508,520,680,0.765,293,1191,1484,755,266,523,725,3614
6746,2018-1-3,Memphis Grizzlies,38,9145,1364,3061,0.446,362,1027,0.352,1002,2034,0.493,668,848,0.788,329,1176,1505,787,280,514,871,3758
6747,2018-1-3,Sacramento Kings,37,8905,1412,3137,0.45,318,830,0.383,1094,2307,0.474,460,636,0.723,351,1132,1483,770,287,504,729,3602
6748,2018-1-4,Golden State Warriors,38,9170,1657,3260,0.508,444,1137,0.391,1213,2123,0.571,628,769,0.817,324,1381,1705,1163,316,593,762,4386
6749,2018-1-4,Houston Rockets,36,8690,1411,3041,0.464,569,1550,0.367,842,1491,0.565,758,948,0.8,334,1248,1582,802,326,527,747,4149
6750,2018-1-4,Toronto Raptors,36,8665,1471,3113,0.473,408,1153,0.354,1063,1960,0.542,667,830,0.804,339,1194,1533,824,316,474,794,4017
6751,2018-1-4,New Orleans Pelicans,37,8955,1540,3143,0.49,419,1094,0.383,1121,2049,0.547,611,804,0.76,301,1281,1582,985,273,568,724,4110
6752,2018-1-4,Cleveland Cavaliers,38,9145,1498,3154,0.475,472,1247,0.379,1026,1907,0.538,709,874,0.811,315,1277,1592,889,278,524,703,4177
6753,2018-1-4,Minnesota Timberwolves,39,9435,1574,3309,0.476,310,885,0.35,1264,2424,0.521,769,964,0.798,401,1210,1611,880,352,489,701,4227
6754,2018-1-4,Philadelphia 76ers,37,8980,1483,3219,0.461,389,1097,0.355,1094,2122,0.516,656,872,0.752,420,1343,1763,967,313,642,881,4011
6755,2018-1-4,Denver Nuggets,37,8955,1485,3187,0.466,410,1126,0.364,1075,2061,0.522,612,819,0.747,433,1253,1686,873,284,556,654,3992
6756,2018-1-4,Brooklyn Nets,38,9145,1459,3298,0.442,456,1291,0.353,1003,2007,0.5,690,913,0.756,391,1337,1728,860,245,565,788,4064
6757,2018-1-4,Indiana Pacers,38,9170,1558,3270,0.476,364,951,0.383,1194,2319,0.515,579,748,0.774,348,1235,1583,863,296,499,702,4059
6758,2018-1-4,Los Angeles Lakers,37,9030,1504,3322,0.453,326,999,0.326,1178,2323,0.507,614,892,0.688,422,1285,1707,853,303,594,822,3948
6759,2018-1-4,Washington Wizards,38,9170,1512,3272,0.462,371,1007,0.368,1141,2265,0.504,658,869,0.757,375,1274,1649,867,296,498,825,4053
6760,2018-1-4,Milwaukee Bucks,36,8690,1428,2947,0.485,317,890,0.356,1111,2057,0.54,640,834,0.767,275,1116,1391,829,303,457,807,3813
6761,2018-1-4,Phoenix Suns,40,9625,1547,3484,0.444,354,1047,0.338,1193,2437,0.49,789,1043,0.756,451,1353,1804,825,269,607,890,4237
6762,2018-1-4,Los Angeles Clippers,36,8665,1379,3023,0.456,382,1076,0.355,997,1947,0.512,666,883,0.754,370,1192,1562,751,272,509,756,3806
6763,2018-1-4,Charlotte Hornets,37,8930,1404,3196,0.439,330,935,0.353,1074,2261,0.475,745,1020,0.73,389,1322,1711,767,243,473,670,3883
6764,2018-1-4,Orlando Magic,39,9385,1533,3373,0.454,403,1141,0.353,1130,2232,0.506,608,811,0.75,337,1294,1631,890,285,559,766,4077
6765,2018-1-4,Oklahoma City Thunder,38,9220,1486,3291,0.452,390,1096,0.356,1096,2195,0.499,602,847,0.711,455,1220,1675,801,370,524,781,3964
6766,2018-1-4,Atlanta Hawks,37,8905,1431,3136,0.456,404,1061,0.381,1027,2075,0.495,577,738,0.782,353,1131,1484,889,320,554,730,3843
6767,2018-1-4,Boston Celtics,41,9865,1547,3416,0.453,480,1280,0.375,1067,2136,0.5,666,872,0.764,361,1452,1813,910,310,548,823,4240
6768,2018-1-4,New York Knicks,38,9145,1515,3268,0.464,291,820,0.355,1224,2448,0.5,603,756,0.798,412,1277,1689,861,265,558,789,3924
6769,2018-1-4,Portland Trail Blazers,37,8930,1410,3180,0.443,345,930,0.371,1065,2250,0.473,627,790,0.794,371,1295,1666,683,246,515,729,3792
6770,2018-1-4,Detroit Pistons,36,8640,1386,3095,0.448,392,1034,0.379,994,2061,0.482,515,681,0.756,370,1154,1524,788,276,479,674,3679
6771,2018-1-4,Dallas Mavericks,39,9385,1477,3284,0.45,464,1254,0.37,1013,2030,0.499,543,705,0.77,300,1286,1586,872,257,484,746,3961
6772,2018-1-4,Chicago Bulls,38,9195,1470,3368,0.436,401,1137,0.353,1069,2231,0.479,512,687,0.745,359,1354,1713,901,264,491,728,3853
6773,2018-1-4,San Antonio Spurs,39,9360,1490,3261,0.457,342,949,0.36,1148,2312,0.497,627,798,0.786,400,1340,1740,852,275,523,674,3949
6774,2018-1-4,Utah Jazz,38,9145,1404,3131,0.448,420,1136,0.37,984,1995,0.493,615,761,0.808,318,1216,1534,806,350,526,762,3843
6775,2018-1-4,Miami Heat,37,8905,1383,3032,0.456,431,1160,0.372,952,1872,0.509,528,691,0.764,300,1225,1525,784,272,535,741,3725
6776,2018-1-4,Memphis Grizzlies,38,9145,1364,3061,0.446,362,1027,0.352,1002,2034,0.493,668,848,0.788,329,1176,1505,787,280,514,871,3758
6777,2018-1-4,Sacramento Kings,37,8905,1412,3137,0.45,318,830,0.383,1094,2307,0.474,460,636,0.723,351,1132,1483,770,287,504,729,3602
6778,2018-1-5,Golden State Warriors,39,9410,1705,3347,0.509,457,1167,0.392,1248,2180,0.572,643,789,0.815,330,1420,1750,1198,322,605,780,4510
6779,2018-1-5,Houston Rockets,37,8930,1453,3130,0.464,586,1600,0.366,867,1530,0.567,771,970,0.795,340,1280,1620,822,333,537,764,4263
6780,2018-1-5,Toronto Raptors,36,8665,1471,3113,0.473,408,1153,0.354,1063,1960,0.542,667,830,0.804,339,1194,1533,824,316,474,794,4017
6781,2018-1-5,New Orleans Pelicans,37,8955,1540,3143,0.49,419,1094,0.383,1121,2049,0.547,611,804,0.76,301,1281,1582,985,273,568,724,4110
6782,2018-1-5,Cleveland Cavaliers,38,9145,1498,3154,0.475,472,1247,0.379,1026,1907,0.538,709,874,0.811,315,1277,1592,889,278,524,703,4177
6783,2018-1-5,Minnesota Timberwolves,39,9435,1574,3309,0.476,310,885,0.35,1264,2424,0.521,769,964,0.798,401,1210,1611,880,352,489,701,4227
6784,2018-1-5,Philadelphia 76ers,37,8980,1483,3219,0.461,389,1097,0.355,1094,2122,0.516,656,872,0.752,420,1343,1763,967,313,642,881,4011
6785,2018-1-5,Denver Nuggets,37,8955,1485,3187,0.466,410,1126,0.364,1075,2061,0.522,612,819,0.747,433,1253,1686,873,284,556,654,3992
6786,2018-1-5,Brooklyn Nets,38,9145,1459,3298,0.442,456,1291,0.353,1003,2007,0.5,690,913,0.756,391,1337,1728,860,245,565,788,4064
6787,2018-1-5,Indiana Pacers,38,9170,1558,3270,0.476,364,951,0.383,1194,2319,0.515,579,748,0.774,348,1235,1583,863,296,499,702,4059
6788,2018-1-5,Los Angeles Lakers,37,9030,1504,3322,0.453,326,999,0.326,1178,2323,0.507,614,892,0.688,422,1285,1707,853,303,594,822,3948
6789,2018-1-5,Washington Wizards,38,9170,1512,3272,0.462,371,1007,0.368,1141,2265,0.504,658,869,0.757,375,1274,1649,867,296,498,825,4053
6790,2018-1-5,Los Angeles Clippers,37,8905,1424,3123,0.456,391,1106,0.354,1033,2017,0.512,684,906,0.755,385,1222,1607,780,277,519,771,3923
6791,2018-1-5,Milwaukee Bucks,36,8690,1428,2947,0.485,317,890,0.356,1111,2057,0.54,640,834,0.767,275,1116,1391,829,303,457,807,3813
6792,2018-1-5,Phoenix Suns,40,9625,1547,3484,0.444,354,1047,0.338,1193,2437,0.49,789,1043,0.756,451,1353,1804,825,269,607,890,4237
6793,2018-1-5,Charlotte Hornets,37,8930,1404,3196,0.439,330,935,0.353,1074,2261,0.475,745,1020,0.73,389,1322,1711,767,243,473,670,3883
6794,2018-1-5,Oklahoma City Thunder,39,9460,1537,3386,0.454,405,1130,0.358,1132,2256,0.502,612,861,0.711,466,1255,1721,824,374,537,804,4091
6795,2018-1-5,Orlando Magic,39,9385,1533,3373,0.454,403,1141,0.353,1130,2232,0.506,608,811,0.75,337,1294,1631,890,285,559,766,4077
6796,2018-1-5,Atlanta Hawks,37,8905,1431,3136,0.456,404,1061,0.381,1027,2075,0.495,577,738,0.782,353,1131,1484,889,320,554,730,3843
6797,2018-1-5,Boston Celtics,41,9865,1547,3416,0.453,480,1280,0.375,1067,2136,0.5,666,872,0.764,361,1452,1813,910,310,548,823,4240
6798,2018-1-5,New York Knicks,38,9145,1515,3268,0.464,291,820,0.355,1224,2448,0.5,603,756,0.798,412,1277,1689,861,265,558,789,3924
6799,2018-1-5,Portland Trail Blazers,37,8930,1410,3180,0.443,345,930,0.371,1065,2250,0.473,627,790,0.794,371,1295,1666,683,246,515,729,3792
6800,2018-1-5,Detroit Pistons,36,8640,1386,3095,0.448,392,1034,0.379,994,2061,0.482,515,681,0.756,370,1154,1524,788,276,479,674,3679
6801,2018-1-5,Dallas Mavericks,39,9385,1477,3284,0.45,464,1254,0.37,1013,2030,0.499,543,705,0.77,300,1286,1586,872,257,484,746,3961
6802,2018-1-5,Chicago Bulls,38,9195,1470,3368,0.436,401,1137,0.353,1069,2231,0.479,512,687,0.745,359,1354,1713,901,264,491,728,3853
6803,2018-1-5,San Antonio Spurs,39,9360,1490,3261,0.457,342,949,0.36,1148,2312,0.497,627,798,0.786,400,1340,1740,852,275,523,674,3949
6804,2018-1-5,Utah Jazz,38,9145,1404,3131,0.448,420,1136,0.37,984,1995,0.493,615,761,0.808,318,1216,1534,806,350,526,762,3843
6805,2018-1-5,Miami Heat,37,8905,1383,3032,0.456,431,1160,0.372,952,1872,0.509,528,691,0.764,300,1225,1525,784,272,535,741,3725
6806,2018-1-5,Memphis Grizzlies,38,9145,1364,3061,0.446,362,1027,0.352,1002,2034,0.493,668,848,0.788,329,1176,1505,787,280,514,871,3758
6807,2018-1-5,Sacramento Kings,37,8905,1412,3137,0.45,318,830,0.383,1094,2307,0.474,460,636,0.723,351,1132,1483,770,287,504,729,3602
6808,2018-1-6,Golden State Warriors,39,9410,1705,3347,0.509,457,1167,0.392,1248,2180,0.572,643,789,0.815,330,1420,1750,1198,322,605,780,4510
6809,2018-1-6,Houston Rockets,37,8930,1453,3130,0.464,586,1600,0.366,867,1530,0.567,771,970,0.795,340,1280,1620,822,333,537,764,4263
6810,2018-1-6,Toronto Raptors,37,8905,1519,3199,0.475,418,1186,0.352,1101,2013,0.547,690,858,0.804,351,1225,1576,849,325,485,816,4146
6811,2018-1-6,New Orleans Pelicans,37,8955,1540,3143,0.49,419,1094,0.383,1121,2049,0.547,611,804,0.76,301,1281,1582,985,273,568,724,4110
6812,2018-1-6,Cleveland Cavaliers,38,9145,1498,3154,0.475,472,1247,0.379,1026,1907,0.538,709,874,0.811,315,1277,1592,889,278,524,703,4177
6813,2018-1-6,Philadelphia 76ers,38,9220,1527,3309,0.461,403,1127,0.358,1124,2182,0.515,668,885,0.755,433,1385,1818,996,318,654,898,4125
6814,2018-1-6,Minnesota Timberwolves,40,9675,1602,3385,0.473,317,908,0.349,1285,2477,0.519,790,992,0.796,410,1244,1654,895,358,501,716,4311
6815,2018-1-6,Denver Nuggets,38,9195,1523,3273,0.465,424,1161,0.365,1099,2112,0.52,621,835,0.744,437,1286,1723,897,293,566,665,4091
6816,2018-1-6,Brooklyn Nets,38,9145,1459,3298,0.442,456,1291,0.353,1003,2007,0.5,690,913,0.756,391,1337,1728,860,245,565,788,4064
6817,2018-1-6,Indiana Pacers,38,9170,1558,3270,0.476,364,951,0.383,1194,2319,0.515,579,748,0.774,348,1235,1583,863,296,499,702,4059
6818,2018-1-6,Washington Wizards,39,9410,1545,3356,0.46,381,1034,0.368,1164,2322,0.501,684,903,0.757,387,1310,1697,888,303,511,848,4155
6819,2018-1-6,Los Angeles Lakers,38,9270,1542,3416,0.451,335,1035,0.324,1207,2381,0.507,623,904,0.689,434,1319,1753,877,310,610,842,4042
6820,2018-1-6,Milwaukee Bucks,37,8930,1469,3024,0.486,324,907,0.357,1145,2117,0.541,661,863,0.766,280,1139,1419,855,307,468,830,3923
6821,2018-1-6,Los Angeles Clippers,37,8905,1424,3123,0.456,391,1106,0.354,1033,2017,0.512,684,906,0.755,385,1222,1607,780,277,519,771,3923
6822,2018-1-6,Phoenix Suns,41,9865,1582,3567,0.444,361,1077,0.335,1221,2490,0.49,801,1061,0.755,460,1390,1850,847,280,630,913,4326
6823,2018-1-6,Charlotte Hornets,38,9170,1446,3295,0.439,342,968,0.353,1104,2327,0.474,757,1036,0.731,405,1362,1767,793,253,487,688,3991
6824,2018-1-6,Oklahoma City Thunder,39,9460,1537,3386,0.454,405,1130,0.358,1132,2256,0.502,612,861,0.711,466,1255,1721,824,374,537,804,4091
6825,2018-1-6,Orlando Magic,39,9385,1533,3373,0.454,403,1141,0.353,1130,2232,0.506,608,811,0.75,337,1294,1631,890,285,559,766,4077
6826,2018-1-6,Atlanta Hawks,38,9145,1461,3219,0.454,412,1087,0.379,1049,2132,0.492,598,763,0.784,364,1159,1523,903,327,570,746,3932
6827,2018-1-6,New York Knicks,39,9410,1554,3348,0.464,296,833,0.355,1258,2515,0.5,623,779,0.8,420,1308,1728,875,276,577,815,4027
6828,2018-1-6,Boston Celtics,42,10105,1585,3510,0.452,486,1316,0.369,1099,2194,0.501,675,885,0.763,378,1491,1869,934,316,558,845,4331
6829,2018-1-6,Portland Trail Blazers,38,9170,1453,3260,0.446,358,960,0.373,1095,2300,0.476,638,804,0.794,377,1333,1710,713,257,530,749,3902
6830,2018-1-6,Dallas Mavericks,40,9625,1526,3376,0.452,478,1286,0.372,1048,2090,0.501,555,722,0.769,307,1313,1620,905,268,497,770,4085
6831,2018-1-6,Chicago Bulls,39,9435,1514,3446,0.439,415,1165,0.356,1099,2281,0.482,537,719,0.747,367,1388,1755,926,273,509,747,3980
6832,2018-1-6,Detroit Pistons,37,8880,1416,3173,0.446,399,1056,0.378,1017,2117,0.48,526,700,0.751,376,1182,1558,808,285,491,688,3757
6833,2018-1-6,San Antonio Spurs,40,9600,1531,3348,0.457,353,979,0.361,1178,2369,0.497,637,816,0.781,407,1377,1784,873,290,538,690,4052
6834,2018-1-6,Utah Jazz,39,9385,1442,3215,0.449,432,1169,0.37,1010,2046,0.494,618,767,0.806,326,1261,1587,832,357,543,778,3934
6835,2018-1-6,Miami Heat,38,9170,1421,3126,0.455,443,1202,0.369,978,1924,0.508,547,711,0.769,315,1254,1569,808,282,549,760,3832
6836,2018-1-6,Memphis Grizzlies,39,9385,1399,3147,0.445,372,1057,0.352,1027,2090,0.491,688,874,0.787,340,1211,1551,807,286,530,896,3858
6837,2018-1-6,Sacramento Kings,37,8905,1412,3137,0.45,318,830,0.383,1094,2307,0.474,460,636,0.723,351,1132,1483,770,287,504,729,3602
6838,2018-1-7,Golden State Warriors,40,9650,1744,3441,0.507,470,1206,0.39,1274,2235,0.57,673,826,0.815,344,1460,1804,1229,335,621,805,4631
6839,2018-1-7,Houston Rockets,38,9170,1491,3220,0.463,601,1647,0.365,890,1573,0.566,781,981,0.796,352,1310,1662,851,338,550,784,4364
6840,2018-1-7,Toronto Raptors,37,8905,1519,3199,0.475,418,1186,0.352,1101,2013,0.547,690,858,0.804,351,1225,1576,849,325,485,816,4146
6841,2018-1-7,New Orleans Pelicans,38,9195,1573,3221,0.488,425,1123,0.378,1148,2098,0.547,637,832,0.766,308,1312,1620,1005,278,583,743,4208
6842,2018-1-7,Cleveland Cavaliers,39,9385,1545,3248,0.476,487,1281,0.38,1058,1967,0.538,731,905,0.808,329,1308,1637,914,289,541,729,4308
6843,2018-1-7,Philadelphia 76ers,38,9220,1527,3309,0.461,403,1127,0.358,1124,2182,0.515,668,885,0.755,433,1385,1818,996,318,654,898,4125
6844,2018-1-7,Minnesota Timberwolves,41,9915,1646,3475,0.474,326,926,0.352,1320,2549,0.518,809,1013,0.799,423,1278,1701,921,368,510,736,4427
6845,2018-1-7,Denver Nuggets,39,9435,1558,3349,0.465,437,1195,0.366,1121,2154,0.52,636,856,0.743,445,1324,1769,917,295,591,682,4189
6846,2018-1-7,Indiana Pacers,39,9410,1606,3356,0.479,379,982,0.386,1227,2374,0.517,593,766,0.774,358,1274,1632,887,305,511,721,4184
6847,2018-1-7,Washington Wizards,40,9650,1582,3434,0.461,389,1055,0.369,1193,2379,0.501,705,932,0.756,391,1340,1731,913,309,525,870,4258
6848,2018-1-7,Los Angeles Lakers,38,9270,1542,3416,0.451,335,1035,0.324,1207,2381,0.507,623,904,0.689,434,1319,1753,877,310,610,842,4042
6849,2018-1-7,Brooklyn Nets,39,9385,1489,3389,0.439,462,1322,0.349,1027,2067,0.497,709,935,0.758,403,1380,1783,871,247,581,802,4149
6850,2018-1-7,Milwaukee Bucks,38,9170,1508,3104,0.486,331,929,0.356,1177,2175,0.541,686,893,0.768,290,1174,1464,875,318,483,856,4033
6851,2018-1-7,Los Angeles Clippers,38,9145,1463,3214,0.455,394,1117,0.353,1069,2097,0.51,708,936,0.756,395,1257,1652,799,287,537,796,4028
6852,2018-1-7,Phoenix Suns,41,9865,1582,3567,0.444,361,1077,0.335,1221,2490,0.49,801,1061,0.755,460,1390,1850,847,280,630,913,4326
6853,2018-1-7,Orlando Magic,40,9625,1582,3471,0.456,417,1178,0.354,1165,2293,0.508,623,833,0.748,351,1326,1677,919,290,578,794,4204
6854,2018-1-7,Charlotte Hornets,38,9170,1446,3295,0.439,342,968,0.353,1104,2327,0.474,757,1036,0.731,405,1362,1767,793,253,487,688,3991
6855,2018-1-7,Oklahoma City Thunder,39,9460,1537,3386,0.454,405,1130,0.358,1132,2256,0.502,612,861,0.711,466,1255,1721,824,374,537,804,4091
6856,2018-1-7,Atlanta Hawks,38,9145,1461,3219,0.454,412,1087,0.379,1049,2132,0.492,598,763,0.784,364,1159,1523,903,327,570,746,3932
6857,2018-1-7,New York Knicks,39,9410,1554,3348,0.464,296,833,0.355,1258,2515,0.5,623,779,0.8,420,1308,1728,875,276,577,815,4027
6858,2018-1-7,Portland Trail Blazers,38,9170,1453,3260,0.446,358,960,0.373,1095,2300,0.476,638,804,0.794,377,1333,1710,713,257,530,749,3902
6859,2018-1-7,Boston Celtics,43,10345,1622,3608,0.45,491,1334,0.368,1131,2274,0.497,683,900,0.759,390,1523,1913,946,324,562,862,4418
6860,2018-1-7,Dallas Mavericks,40,9625,1526,3376,0.452,478,1286,0.372,1048,2090,0.501,555,722,0.769,307,1313,1620,905,268,497,770,4085
6861,2018-1-7,Detroit Pistons,38,9120,1454,3248,0.448,411,1081,0.38,1043,2167,0.481,546,727,0.751,381,1212,1593,829,293,502,703,3865
6862,2018-1-7,Chicago Bulls,40,9675,1544,3526,0.438,425,1197,0.355,1119,2329,0.48,553,739,0.748,376,1413,1789,941,277,525,762,4066
6863,2018-1-7,San Antonio Spurs,40,9600,1531,3348,0.457,353,979,0.361,1178,2369,0.497,637,816,0.781,407,1377,1784,873,290,538,690,4052
6864,2018-1-7,Utah Jazz,39,9385,1442,3215,0.449,432,1169,0.37,1010,2046,0.494,618,767,0.806,326,1261,1587,832,357,543,778,3934
6865,2018-1-7,Miami Heat,38,9170,1421,3126,0.455,443,1202,0.369,978,1924,0.508,547,711,0.769,315,1254,1569,808,282,549,760,3832
6866,2018-1-7,Memphis Grizzlies,39,9385,1399,3147,0.445,372,1057,0.352,1027,2090,0.491,688,874,0.787,340,1211,1551,807,286,530,896,3858
6867,2018-1-7,Sacramento Kings,38,9145,1454,3231,0.45,327,855,0.382,1127,2376,0.474,473,653,0.724,361,1161,1522,791,303,513,751,3708
6868,2018-1-8,Golden State Warriors,40,9650,1744,3441,0.507,470,1206,0.39,1274,2235,0.57,673,826,0.815,344,1460,1804,1229,335,621,805,4631
6869,2018-1-8,Houston Rockets,38,9170,1491,3220,0.463,601,1647,0.365,890,1573,0.566,781,981,0.796,352,1310,1662,851,338,550,784,4364
6870,2018-1-8,Toronto Raptors,37,8905,1519,3199,0.475,418,1186,0.352,1101,2013,0.547,690,858,0.804,351,1225,1576,849,325,485,816,4146
6871,2018-1-8,New Orleans Pelicans,38,9195,1573,3221,0.488,425,1123,0.378,1148,2098,0.547,637,832,0.766,308,1312,1620,1005,278,583,743,4208
6872,2018-1-8,Cleveland Cavaliers,39,9385,1545,3248,0.476,487,1281,0.38,1058,1967,0.538,731,905,0.808,329,1308,1637,914,289,541,729,4308
6873,2018-1-8,Philadelphia 76ers,38,9220,1527,3309,0.461,403,1127,0.358,1124,2182,0.515,668,885,0.755,433,1385,1818,996,318,654,898,4125
6874,2018-1-8,Minnesota Timberwolves,41,9915,1646,3475,0.474,326,926,0.352,1320,2549,0.518,809,1013,0.799,423,1278,1701,921,368,510,736,4427
6875,2018-1-8,Denver Nuggets,39,9435,1558,3349,0.465,437,1195,0.366,1121,2154,0.52,636,856,0.743,445,1324,1769,917,295,591,682,4189
6876,2018-1-8,Indiana Pacers,39,9410,1606,3356,0.479,379,982,0.386,1227,2374,0.517,593,766,0.774,358,1274,1632,887,305,511,721,4184
6877,2018-1-8,Los Angeles Lakers,39,9510,1590,3502,0.454,351,1071,0.328,1239,2431,0.51,643,929,0.692,440,1362,1802,909,323,628,867,4174
6878,2018-1-8,Washington Wizards,40,9650,1582,3434,0.461,389,1055,0.369,1193,2379,0.501,705,932,0.756,391,1340,1731,913,309,525,870,4258
6879,2018-1-8,Brooklyn Nets,39,9385,1489,3389,0.439,462,1322,0.349,1027,2067,0.497,709,935,0.758,403,1380,1783,871,247,581,802,4149
6880,2018-1-8,Milwaukee Bucks,38,9170,1508,3104,0.486,331,929,0.356,1177,2175,0.541,686,893,0.768,290,1174,1464,875,318,483,856,4033
6881,2018-1-8,Los Angeles Clippers,38,9145,1463,3214,0.455,394,1117,0.353,1069,2097,0.51,708,936,0.756,395,1257,1652,799,287,537,796,4028
6882,2018-1-8,Phoenix Suns,42,10105,1621,3655,0.444,378,1116,0.339,1243,2539,0.49,820,1084,0.756,472,1421,1893,871,286,637,932,4440
6883,2018-1-8,Orlando Magic,40,9625,1582,3471,0.456,417,1178,0.354,1165,2293,0.508,623,833,0.748,351,1326,1677,919,290,578,794,4204
6884,2018-1-8,Charlotte Hornets,38,9170,1446,3295,0.439,342,968,0.353,1104,2327,0.474,757,1036,0.731,405,1362,1767,793,253,487,688,3991
6885,2018-1-8,Oklahoma City Thunder,40,9700,1577,3472,0.454,413,1157,0.357,1164,2315,0.503,624,882,0.707,474,1289,1763,847,381,548,821,4191
6886,2018-1-8,Atlanta Hawks,39,9385,1502,3313,0.453,424,1121,0.378,1078,2192,0.492,617,786,0.785,374,1186,1560,925,332,585,762,4045
6887,2018-1-8,New York Knicks,40,9650,1592,3431,0.464,302,849,0.356,1290,2582,0.5,641,799,0.802,430,1357,1787,897,280,593,838,4127
6888,2018-1-8,Portland Trail Blazers,39,9410,1501,3352,0.448,366,983,0.372,1135,2369,0.479,645,814,0.792,386,1362,1748,732,264,539,773,4013
6889,2018-1-8,Boston Celtics,43,10345,1622,3608,0.45,491,1334,0.368,1131,2274,0.497,683,900,0.759,390,1523,1913,946,324,562,862,4418
6890,2018-1-8,Dallas Mavericks,41,9865,1561,3468,0.45,484,1310,0.369,1077,2158,0.499,575,746,0.771,316,1344,1660,927,275,504,790,4181
6891,2018-1-8,Detroit Pistons,38,9120,1454,3248,0.448,411,1081,0.38,1043,2167,0.481,546,727,0.751,381,1212,1593,829,293,502,703,3865
6892,2018-1-8,Chicago Bulls,40,9675,1544,3526,0.438,425,1197,0.355,1119,2329,0.48,553,739,0.748,376,1413,1789,941,277,525,762,4066
6893,2018-1-8,San Antonio Spurs,41,9840,1571,3429,0.458,364,1002,0.363,1207,2427,0.497,656,842,0.779,417,1409,1826,899,294,552,706,4162
6894,2018-1-8,Miami Heat,39,9410,1461,3209,0.455,452,1231,0.367,1009,1978,0.51,561,731,0.767,323,1283,1606,829,288,557,776,3935
6895,2018-1-8,Utah Jazz,40,9625,1479,3297,0.449,442,1201,0.368,1037,2096,0.495,636,787,0.808,334,1297,1631,847,363,554,796,4036
6896,2018-1-8,Memphis Grizzlies,39,9385,1399,3147,0.445,372,1057,0.352,1027,2090,0.491,688,874,0.787,340,1211,1551,807,286,530,896,3858
6897,2018-1-8,Sacramento Kings,38,9145,1454,3231,0.45,327,855,0.382,1127,2376,0.474,473,653,0.724,361,1161,1522,791,303,513,751,3708
6898,2018-1-9,Golden State Warriors,41,9890,1792,3526,0.508,483,1236,0.391,1309,2290,0.572,688,847,0.812,354,1493,1847,1262,342,637,820,4755
6899,2018-1-9,Houston Rockets,39,9410,1530,3306,0.463,621,1701,0.365,909,1605,0.566,799,1005,0.795,363,1350,1713,879,344,566,798,4480
6900,2018-1-9,Toronto Raptors,38,9170,1562,3300,0.473,428,1220,0.351,1134,2080,0.545,708,881,0.804,359,1268,1627,868,332,500,843,4260
6901,2018-1-9,New Orleans Pelicans,39,9435,1619,3303,0.49,431,1145,0.376,1188,2158,0.551,651,853,0.763,317,1344,1661,1036,285,599,761,4320
6902,2018-1-9,Cleveland Cavaliers,40,9625,1582,3332,0.475,500,1319,0.379,1082,2013,0.538,743,921,0.807,337,1337,1674,940,289,554,744,4407
6903,2018-1-9,Philadelphia 76ers,38,9220,1527,3309,0.461,403,1127,0.358,1124,2182,0.515,668,885,0.755,433,1385,1818,996,318,654,898,4125
6904,2018-1-9,Minnesota Timberwolves,42,10155,1698,3575,0.475,336,957,0.351,1362,2618,0.52,822,1030,0.798,438,1319,1757,951,374,515,753,4554
6905,2018-1-9,Denver Nuggets,40,9675,1605,3444,0.466,445,1214,0.367,1160,2230,0.52,648,872,0.743,458,1350,1808,947,303,602,698,4303
6906,2018-1-9,Indiana Pacers,40,9650,1650,3435,0.48,386,1004,0.384,1264,2431,0.52,607,786,0.772,366,1306,1672,917,314,527,744,4293
6907,2018-1-9,Los Angeles Lakers,39,9510,1590,3502,0.454,351,1071,0.328,1239,2431,0.51,643,929,0.692,440,1362,1802,909,323,628,867,4174
6908,2018-1-9,Brooklyn Nets,40,9650,1528,3489,0.438,474,1355,0.35,1054,2134,0.494,732,963,0.76,414,1424,1838,893,255,597,829,4262
6909,2018-1-9,Washington Wizards,40,9650,1582,3434,0.461,389,1055,0.369,1193,2379,0.501,705,932,0.756,391,1340,1731,913,309,525,870,4258
6910,2018-1-9,Los Angeles Clippers,39,9385,1501,3299,0.455,403,1135,0.355,1098,2164,0.507,731,970,0.754,409,1290,1699,815,297,553,821,4136
6911,2018-1-9,Milwaukee Bucks,39,9410,1542,3178,0.485,338,956,0.354,1204,2222,0.542,707,920,0.768,295,1203,1498,893,329,500,880,4129
6912,2018-1-9,Phoenix Suns,42,10105,1621,3655,0.444,378,1116,0.339,1243,2539,0.49,820,1084,0.756,472,1421,1893,871,286,637,932,4440
6913,2018-1-9,Orlando Magic,40,9625,1582,3471,0.456,417,1178,0.354,1165,2293,0.508,623,833,0.748,351,1326,1677,919,290,578,794,4204
6914,2018-1-9,Charlotte Hornets,38,9170,1446,3295,0.439,342,968,0.353,1104,2327,0.474,757,1036,0.731,405,1362,1767,793,253,487,688,3991
6915,2018-1-9,Oklahoma City Thunder,40,9700,1577,3472,0.454,413,1157,0.357,1164,2315,0.503,624,882,0.707,474,1289,1763,847,381,548,821,4191
6916,2018-1-9,Atlanta Hawks,40,9625,1540,3409,0.452,434,1158,0.375,1106,2251,0.491,638,815,0.783,393,1223,1616,945,341,599,788,4152
6917,2018-1-9,New York Knicks,40,9650,1592,3431,0.464,302,849,0.356,1290,2582,0.5,641,799,0.802,430,1357,1787,897,280,593,838,4127
6918,2018-1-9,Portland Trail Blazers,39,9410,1501,3352,0.448,366,983,0.372,1135,2369,0.479,645,814,0.792,386,1362,1748,732,264,539,773,4013
6919,2018-1-9,Boston Celtics,43,10345,1622,3608,0.45,491,1334,0.368,1131,2274,0.497,683,900,0.759,390,1523,1913,946,324,562,862,4418
6920,2018-1-9,Dallas Mavericks,41,9865,1561,3468,0.45,484,1310,0.369,1077,2158,0.499,575,746,0.771,316,1344,1660,927,275,504,790,4181
6921,2018-1-9,Detroit Pistons,39,9360,1495,3341,0.447,419,1108,0.378,1076,2233,0.482,565,749,0.754,393,1239,1632,851,298,514,721,3974
6922,2018-1-9,Chicago Bulls,41,9915,1584,3612,0.439,437,1225,0.357,1147,2387,0.481,568,757,0.75,379,1447,1826,967,283,536,779,4173
6923,2018-1-9,San Antonio Spurs,42,10080,1615,3519,0.459,375,1028,0.365,1240,2491,0.498,664,855,0.777,425,1438,1863,922,305,562,718,4269
6924,2018-1-9,Miami Heat,39,9410,1461,3209,0.455,452,1231,0.367,1009,1978,0.51,561,731,0.767,323,1283,1606,829,288,557,776,3935
6925,2018-1-9,Utah Jazz,40,9625,1479,3297,0.449,442,1201,0.368,1037,2096,0.495,636,787,0.808,334,1297,1631,847,363,554,796,4036
6926,2018-1-9,Memphis Grizzlies,39,9385,1399,3147,0.445,372,1057,0.352,1027,2090,0.491,688,874,0.787,340,1211,1551,807,286,530,896,3858
6927,2018-1-9,Sacramento Kings,39,9385,1494,3313,0.451,335,878,0.382,1159,2435,0.476,485,669,0.725,369,1198,1567,810,309,531,765,3808
6928,2018-1-10,Golden State Warriors,41,9890,1792,3526,0.508,483,1236,0.391,1309,2290,0.572,688,847,0.812,354,1493,1847,1262,342,637,820,4755
6929,2018-1-10,Houston Rockets,39,9410,1530,3306,0.463,621,1701,0.365,909,1605,0.566,799,1005,0.795,363,1350,1713,879,344,566,798,4480
6930,2018-1-10,Toronto Raptors,39,9410,1597,3390,0.471,435,1241,0.351,1162,2149,0.541,720,896,0.804,366,1298,1664,883,339,505,859,4349
6931,2018-1-10,New Orleans Pelicans,39,9435,1619,3303,0.49,431,1145,0.376,1188,2158,0.551,651,853,0.763,317,1344,1661,1036,285,599,761,4320
6932,2018-1-10,Cleveland Cavaliers,40,9625,1582,3332,0.475,500,1319,0.379,1082,2013,0.538,743,921,0.807,337,1337,1674,940,289,554,744,4407
6933,2018-1-10,Philadelphia 76ers,38,9220,1527,3309,0.461,403,1127,0.358,1124,2182,0.515,668,885,0.755,433,1385,1818,996,318,654,898,4125
6934,2018-1-10,Minnesota Timberwolves,42,10155,1698,3575,0.475,336,957,0.351,1362,2618,0.52,822,1030,0.798,438,1319,1757,951,374,515,753,4554
6935,2018-1-10,Denver Nuggets,40,9675,1605,3444,0.466,445,1214,0.367,1160,2230,0.52,648,872,0.743,458,1350,1808,947,303,602,698,4303
6936,2018-1-10,Indiana Pacers,40,9650,1650,3435,0.48,386,1004,0.384,1264,2431,0.52,607,786,0.772,366,1306,1672,917,314,527,744,4293
6937,2018-1-10,Los Angeles Lakers,40,9750,1627,3579,0.455,363,1106,0.328,1264,2473,0.511,656,950,0.691,449,1408,1857,939,335,653,890,4273
6938,2018-1-10,Brooklyn Nets,40,9650,1528,3489,0.438,474,1355,0.35,1054,2134,0.494,732,963,0.76,414,1424,1838,893,255,597,829,4262
6939,2018-1-10,Washington Wizards,40,9650,1582,3434,0.461,389,1055,0.369,1193,2379,0.501,705,932,0.756,391,1340,1731,913,309,525,870,4258
6940,2018-1-10,Los Angeles Clippers,39,9385,1501,3299,0.455,403,1135,0.355,1098,2164,0.507,731,970,0.754,409,1290,1699,815,297,553,821,4136
6941,2018-1-10,Milwaukee Bucks,39,9410,1542,3178,0.485,338,956,0.354,1204,2222,0.542,707,920,0.768,295,1203,1498,893,329,500,880,4129
6942,2018-1-10,Phoenix Suns,42,10105,1621,3655,0.444,378,1116,0.339,1243,2539,0.49,820,1084,0.756,472,1421,1893,871,286,637,932,4440
6943,2018-1-10,Orlando Magic,41,9865,1618,3550,0.456,428,1207,0.355,1190,2343,0.508,639,855,0.747,360,1358,1718,946,292,591,817,4303
6944,2018-1-10,Charlotte Hornets,38,9170,1446,3295,0.439,342,968,0.353,1104,2327,0.474,757,1036,0.731,405,1362,1767,793,253,487,688,3991
6945,2018-1-10,Oklahoma City Thunder,41,9940,1614,3556,0.454,426,1188,0.359,1188,2368,0.502,643,908,0.708,485,1316,1801,867,387,562,838,4297
6946,2018-1-10,Atlanta Hawks,40,9625,1540,3409,0.452,434,1158,0.375,1106,2251,0.491,638,815,0.783,393,1223,1616,945,341,599,788,4152
6947,2018-1-10,Portland Trail Blazers,40,9650,1544,3433,0.45,376,1006,0.374,1168,2427,0.481,666,840,0.793,394,1396,1790,751,274,554,793,4130
6948,2018-1-10,New York Knicks,40,9650,1592,3431,0.464,302,849,0.356,1290,2582,0.5,641,799,0.802,430,1357,1787,897,280,593,838,4127
6949,2018-1-10,Boston Celtics,43,10345,1622,3608,0.45,491,1334,0.368,1131,2274,0.497,683,900,0.759,390,1523,1913,946,324,562,862,4418
6950,2018-1-10,Dallas Mavericks,42,10105,1604,3551,0.452,493,1336,0.369,1111,2215,0.502,594,768,0.773,321,1377,1698,954,281,508,812,4295
6951,2018-1-10,Detroit Pistons,39,9360,1495,3341,0.447,419,1108,0.378,1076,2233,0.482,565,749,0.754,393,1239,1632,851,298,514,721,3974
6952,2018-1-10,Chicago Bulls,41,9915,1584,3612,0.439,437,1225,0.357,1147,2387,0.481,568,757,0.75,379,1447,1826,967,283,536,779,4173
6953,2018-1-10,San Antonio Spurs,42,10080,1615,3519,0.459,375,1028,0.365,1240,2491,0.498,664,855,0.777,425,1438,1863,922,305,562,718,4269
6954,2018-1-10,Utah Jazz,40,9625,1479,3297,0.449,442,1201,0.368,1037,2096,0.495,636,787,0.808,334,1297,1631,847,363,554,796,4036
6955,2018-1-10,Miami Heat,40,9650,1500,3306,0.454,456,1253,0.364,1044,2053,0.509,569,741,0.768,343,1327,1670,847,290,570,795,4025
6956,2018-1-10,Memphis Grizzlies,39,9385,1399,3147,0.445,372,1057,0.352,1027,2090,0.491,688,874,0.787,340,1211,1551,807,286,530,896,3858
6957,2018-1-10,Sacramento Kings,40,9625,1524,3400,0.448,343,899,0.382,1181,2501,0.472,503,696,0.723,379,1231,1610,825,324,547,784,3894
6958,2018-1-11,Golden State Warriors,42,10130,1830,3605,0.508,491,1259,0.39,1339,2346,0.571,710,873,0.813,358,1522,1880,1288,351,653,841,4861
6959,2018-1-11,Houston Rockets,40,9650,1575,3406,0.462,633,1739,0.364,942,1667,0.565,818,1030,0.794,380,1382,1762,904,351,579,828,4601
6960,2018-1-11,Toronto Raptors,39,9410,1597,3390,0.471,435,1241,0.351,1162,2149,0.541,720,896,0.804,366,1298,1664,883,339,505,859,4349
6961,2018-1-11,New Orleans Pelicans,40,9675,1653,3380,0.489,442,1180,0.375,1211,2200,0.55,674,887,0.76,326,1375,1701,1056,290,611,787,4422
6962,2018-1-11,Cleveland Cavaliers,40,9625,1582,3332,0.475,500,1319,0.379,1082,2013,0.538,743,921,0.807,337,1337,1674,940,289,554,744,4407
6963,2018-1-11,Philadelphia 76ers,38,9220,1527,3309,0.461,403,1127,0.358,1124,2182,0.515,668,885,0.755,433,1385,1818,996,318,654,898,4125
6964,2018-1-11,Minnesota Timberwolves,43,10395,1737,3655,0.475,343,977,0.351,1394,2678,0.521,841,1057,0.796,449,1353,1802,973,385,529,775,4658
6965,2018-1-11,Denver Nuggets,41,9915,1643,3539,0.464,454,1251,0.363,1189,2288,0.52,660,892,0.74,472,1376,1848,974,316,614,716,4400
6966,2018-1-11,Indiana Pacers,41,9890,1693,3522,0.481,387,1022,0.379,1306,2500,0.522,626,815,0.768,378,1339,1717,930,321,541,767,4399
6967,2018-1-11,Los Angeles Lakers,40,9750,1627,3579,0.455,363,1106,0.328,1264,2473,0.511,656,950,0.691,449,1408,1857,939,335,653,890,4273
6968,2018-1-11,Los Angeles Clippers,40,9625,1547,3393,0.456,414,1159,0.357,1133,2234,0.507,753,998,0.755,420,1325,1745,839,306,567,840,4261
6969,2018-1-11,Washington Wizards,41,9890,1623,3512,0.462,399,1080,0.369,1224,2432,0.503,717,948,0.756,400,1376,1776,938,317,548,887,4362
6970,2018-1-11,Milwaukee Bucks,40,9650,1587,3260,0.487,342,975,0.351,1245,2285,0.545,723,945,0.765,306,1239,1545,913,333,514,901,4239
6971,2018-1-11,Brooklyn Nets,41,9890,1555,3563,0.436,486,1392,0.349,1069,2171,0.492,746,978,0.763,416,1457,1873,912,266,614,840,4342
6972,2018-1-11,Phoenix Suns,42,10105,1621,3655,0.444,378,1116,0.339,1243,2539,0.49,820,1084,0.756,472,1421,1893,871,286,637,932,4440
6973,2018-1-11,Charlotte Hornets,39,9410,1489,3379,0.441,352,994,0.354,1137,2385,0.477,772,1066,0.724,409,1401,1810,809,259,498,710,4102
6974,2018-1-11,Orlando Magic,42,10105,1657,3640,0.455,436,1236,0.353,1221,2404,0.508,656,873,0.751,368,1384,1752,972,298,599,838,4406
6975,2018-1-11,Oklahoma City Thunder,42,10180,1646,3636,0.453,432,1213,0.356,1214,2423,0.501,661,932,0.709,495,1347,1842,880,396,580,860,4385
6976,2018-1-11,Atlanta Hawks,41,9865,1580,3489,0.453,446,1185,0.376,1134,2304,0.492,656,833,0.788,399,1261,1660,970,347,615,811,4262
6977,2018-1-11,New York Knicks,41,9940,1640,3527,0.465,312,871,0.358,1328,2656,0.5,654,820,0.798,441,1397,1838,921,285,611,858,4246
6978,2018-1-11,Portland Trail Blazers,41,9890,1584,3516,0.451,385,1032,0.373,1199,2484,0.483,689,872,0.79,400,1430,1830,772,279,566,819,4242
6979,2018-1-11,Boston Celtics,43,10345,1622,3608,0.45,491,1334,0.368,1131,2274,0.497,683,900,0.759,390,1523,1913,946,324,562,862,4418
6980,2018-1-11,Dallas Mavericks,43,10345,1643,3634,0.452,508,1372,0.37,1135,2262,0.502,616,796,0.774,324,1413,1737,977,288,516,834,4410
6981,2018-1-11,Chicago Bulls,42,10205,1629,3710,0.439,452,1258,0.359,1177,2452,0.48,585,777,0.753,389,1485,1874,988,293,552,798,4295
6982,2018-1-11,Detroit Pistons,40,9600,1543,3434,0.449,429,1129,0.38,1114,2305,0.483,573,761,0.753,404,1282,1686,875,308,527,735,4088
6983,2018-1-11,San Antonio Spurs,42,10080,1615,3519,0.459,375,1028,0.365,1240,2491,0.498,664,855,0.777,425,1438,1863,922,305,562,718,4269
6984,2018-1-11,Miami Heat,41,9890,1543,3387,0.456,469,1283,0.366,1074,2104,0.51,584,762,0.766,349,1358,1707,872,296,585,820,4139
6985,2018-1-11,Utah Jazz,41,9865,1522,3389,0.449,453,1234,0.367,1069,2155,0.496,646,800,0.808,345,1325,1670,870,378,566,813,4143
6986,2018-1-11,Memphis Grizzlies,40,9625,1436,3235,0.444,377,1076,0.35,1059,2159,0.491,714,906,0.788,354,1247,1601,828,293,539,922,3963
6987,2018-1-11,Sacramento Kings,40,9625,1524,3400,0.448,343,899,0.382,1181,2501,0.472,503,696,0.723,379,1231,1610,825,324,547,784,3894
6988,2018-1-12,Golden State Warriors,42,10130,1830,3605,0.508,491,1259,0.39,1339,2346,0.571,710,873,0.813,358,1522,1880,1288,351,653,841,4861
6989,2018-1-12,Houston Rockets,40,9650,1575,3406,0.462,633,1739,0.364,942,1667,0.565,818,1030,0.794,380,1382,1762,904,351,579,828,4601
6990,2018-1-12,Toronto Raptors,40,9650,1650,3496,0.472,453,1283,0.353,1197,2213,0.541,729,909,0.802,384,1343,1727,914,342,514,884,4482
6991,2018-1-12,New Orleans Pelicans,40,9675,1653,3380,0.489,442,1180,0.375,1211,2200,0.55,674,887,0.76,326,1375,1701,1056,290,611,787,4422
6992,2018-1-12,Cleveland Cavaliers,41,9865,1616,3421,0.472,506,1345,0.376,1110,2076,0.535,768,951,0.808,346,1363,1709,958,292,563,760,4506
6993,2018-1-12,Philadelphia 76ers,39,9460,1565,3391,0.462,414,1155,0.358,1151,2236,0.515,684,903,0.757,436,1419,1855,1016,330,673,917,4228
6994,2018-1-12,Minnesota Timberwolves,43,10395,1737,3655,0.475,343,977,0.351,1394,2678,0.521,841,1057,0.796,449,1353,1802,973,385,529,775,4658
6995,2018-1-12,Denver Nuggets,41,9915,1643,3539,0.464,454,1251,0.363,1189,2288,0.52,660,892,0.74,472,1376,1848,974,316,614,716,4400
6996,2018-1-12,Indiana Pacers,41,9890,1693,3522,0.481,387,1022,0.379,1306,2500,0.522,626,815,0.768,378,1339,1717,930,321,541,767,4399
6997,2018-1-12,Los Angeles Clippers,41,9865,1590,3477,0.457,427,1190,0.359,1163,2287,0.509,775,1028,0.754,428,1356,1784,867,315,584,859,4382
6998,2018-1-12,Los Angeles Lakers,41,9990,1663,3666,0.454,376,1144,0.329,1287,2522,0.51,664,964,0.689,461,1443,1904,961,350,668,907,4366
6999,2018-1-12,Washington Wizards,41,9890,1623,3512,0.462,399,1080,0.369,1224,2432,0.503,717,948,0.756,400,1376,1776,938,317,548,887,4362
7000,2018-1-12,Milwaukee Bucks,40,9650,1587,3260,0.487,342,975,0.351,1245,2285,0.545,723,945,0.765,306,1239,1545,913,333,514,901,4239
7001,2018-1-12,Brooklyn Nets,41,9890,1555,3563,0.436,486,1392,0.349,1069,2171,0.492,746,978,0.763,416,1457,1873,912,266,614,840,4342
7002,2018-1-12,Phoenix Suns,42,10105,1621,3655,0.444,378,1116,0.339,1243,2539,0.49,820,1084,0.756,472,1421,1893,871,286,637,932,4440
7003,2018-1-12,Charlotte Hornets,39,9410,1489,3379,0.441,352,994,0.354,1137,2385,0.477,772,1066,0.724,409,1401,1810,809,259,498,710,4102
7004,2018-1-12,Orlando Magic,42,10105,1657,3640,0.455,436,1236,0.353,1221,2404,0.508,656,873,0.751,368,1384,1752,972,298,599,838,4406
7005,2018-1-12,Oklahoma City Thunder,42,10180,1646,3636,0.453,432,1213,0.356,1214,2423,0.501,661,932,0.709,495,1347,1842,880,396,580,860,4385
7006,2018-1-12,Atlanta Hawks,41,9865,1580,3489,0.453,446,1185,0.376,1134,2304,0.492,656,833,0.788,399,1261,1660,970,347,615,811,4262
7007,2018-1-12,New York Knicks,41,9940,1640,3527,0.465,312,871,0.358,1328,2656,0.5,654,820,0.798,441,1397,1838,921,285,611,858,4246
7008,2018-1-12,Portland Trail Blazers,41,9890,1584,3516,0.451,385,1032,0.373,1199,2484,0.483,689,872,0.79,400,1430,1830,772,279,566,819,4242
7009,2018-1-12,Boston Celtics,44,10585,1665,3697,0.45,504,1369,0.368,1161,2328,0.499,698,919,0.76,401,1558,1959,970,335,580,880,4532
7010,2018-1-12,Dallas Mavericks,43,10345,1643,3634,0.452,508,1372,0.37,1135,2262,0.502,616,796,0.774,324,1413,1737,977,288,516,834,4410
7011,2018-1-12,Chicago Bulls,42,10205,1629,3710,0.439,452,1258,0.359,1177,2452,0.48,585,777,0.753,389,1485,1874,988,293,552,798,4295
7012,2018-1-12,Detroit Pistons,40,9600,1543,3434,0.449,429,1129,0.38,1114,2305,0.483,573,761,0.753,404,1282,1686,875,308,527,735,4088
7013,2018-1-12,San Antonio Spurs,43,10320,1646,3595,0.458,383,1048,0.365,1263,2547,0.496,675,870,0.776,432,1476,1908,943,311,582,733,4350
7014,2018-1-12,Miami Heat,41,9890,1543,3387,0.456,469,1283,0.366,1074,2104,0.51,584,762,0.766,349,1358,1707,872,296,585,820,4139
7015,2018-1-12,Utah Jazz,41,9865,1522,3389,0.449,453,1234,0.367,1069,2155,0.496,646,800,0.808,345,1325,1670,870,378,566,813,4143
7016,2018-1-12,Memphis Grizzlies,40,9625,1436,3235,0.444,377,1076,0.35,1059,2159,0.491,714,906,0.788,354,1247,1601,828,293,539,922,3963
7017,2018-1-12,Sacramento Kings,41,9865,1566,3485,0.449,351,925,0.379,1215,2560,0.475,526,724,0.727,389,1265,1654,848,333,562,809,4009
7018,2018-1-13,Golden State Warriors,43,10370,1874,3684,0.509,496,1274,0.389,1378,2410,0.572,725,891,0.814,368,1555,1923,1316,358,664,854,4969
7019,2018-1-13,Houston Rockets,41,9890,1614,3500,0.461,648,1786,0.363,966,1714,0.564,837,1052,0.796,394,1421,1815,922,362,590,842,4713
7020,2018-1-13,Toronto Raptors,40,9650,1650,3496,0.472,453,1283,0.353,1197,2213,0.541,729,909,0.802,384,1343,1727,914,342,514,884,4482
7021,2018-1-13,New Orleans Pelicans,41,9915,1698,3462,0.49,449,1199,0.374,1249,2263,0.552,696,910,0.765,335,1409,1744,1082,297,629,803,4541
7022,2018-1-13,Cleveland Cavaliers,42,10105,1653,3506,0.471,513,1379,0.372,1140,2127,0.536,782,970,0.806,355,1400,1755,977,304,574,775,4601
7023,2018-1-13,Minnesota Timberwolves,44,10635,1786,3750,0.476,353,1004,0.352,1433,2746,0.522,851,1073,0.793,465,1380,1845,1006,397,541,787,4776
7024,2018-1-13,Philadelphia 76ers,39,9460,1565,3391,0.462,414,1155,0.358,1151,2236,0.515,684,903,0.757,436,1419,1855,1016,330,673,917,4228
7025,2018-1-13,Indiana Pacers,42,10130,1732,3607,0.48,397,1043,0.381,1335,2564,0.521,635,827,0.768,384,1377,1761,946,326,555,785,4496
7026,2018-1-13,Los Angeles Clippers,41,9865,1590,3477,0.457,427,1190,0.359,1163,2287,0.509,775,1028,0.754,428,1356,1784,867,315,584,859,4382
7027,2018-1-13,Washington Wizards,42,10130,1677,3607,0.465,403,1096,0.368,1274,2511,0.507,730,967,0.755,414,1403,1817,964,326,559,909,4487
7028,2018-1-13,Denver Nuggets,42,10155,1670,3609,0.463,461,1273,0.362,1209,2336,0.518,686,924,0.742,484,1411,1895,989,324,628,734,4487
7029,2018-1-13,Los Angeles Lakers,41,9990,1663,3666,0.454,376,1144,0.329,1287,2522,0.51,664,964,0.689,461,1443,1904,961,350,668,907,4366
7030,2018-1-13,Brooklyn Nets,42,10130,1595,3650,0.437,499,1426,0.35,1096,2224,0.493,763,1004,0.76,429,1487,1916,941,274,628,864,4452
7031,2018-1-13,Milwaukee Bucks,41,9890,1623,3345,0.485,353,1003,0.352,1270,2342,0.542,734,957,0.767,314,1264,1578,934,342,526,921,4333
7032,2018-1-13,Phoenix Suns,43,10345,1658,3735,0.444,392,1149,0.341,1266,2586,0.49,827,1093,0.757,476,1455,1931,898,291,656,951,4535
7033,2018-1-13,Orlando Magic,43,10345,1698,3720,0.456,448,1265,0.354,1250,2455,0.509,681,904,0.753,380,1412,1792,1004,305,614,859,4525
7034,2018-1-13,Charlotte Hornets,40,9650,1521,3457,0.44,361,1021,0.354,1160,2436,0.476,798,1100,0.725,417,1439,1856,826,267,510,729,4201
7035,2018-1-13,Oklahoma City Thunder,42,10180,1646,3636,0.453,432,1213,0.356,1214,2423,0.501,661,932,0.709,495,1347,1842,880,396,580,860,4385
7036,2018-1-13,Atlanta Hawks,42,10105,1617,3569,0.453,457,1213,0.377,1160,2356,0.492,676,859,0.787,407,1299,1706,991,353,633,836,4367
7037,2018-1-13,Portland Trail Blazers,42,10130,1629,3617,0.45,397,1074,0.37,1232,2543,0.484,700,886,0.79,414,1455,1869,796,292,577,841,4355
7038,2018-1-13,New York Knicks,42,10180,1685,3610,0.467,324,895,0.362,1361,2715,0.501,660,829,0.796,450,1424,1874,946,291,627,875,4354
7039,2018-1-13,Boston Celtics,44,10585,1665,3697,0.45,504,1369,0.368,1161,2328,0.499,698,919,0.76,401,1558,1959,970,335,580,880,4532
7040,2018-1-13,Dallas Mavericks,43,10345,1643,3634,0.452,508,1372,0.37,1135,2262,0.502,616,796,0.774,324,1413,1737,977,288,516,834,4410
7041,2018-1-13,Chicago Bulls,42,10205,1629,3710,0.439,452,1258,0.359,1177,2452,0.48,585,777,0.753,389,1485,1874,988,293,552,798,4295
7042,2018-1-13,Detroit Pistons,40,9600,1543,3434,0.449,429,1129,0.38,1114,2305,0.483,573,761,0.753,404,1282,1686,875,308,527,735,4088
7043,2018-1-13,San Antonio Spurs,43,10320,1646,3595,0.458,383,1048,0.365,1263,2547,0.496,675,870,0.776,432,1476,1908,943,311,582,733,4350
7044,2018-1-13,Miami Heat,41,9890,1543,3387,0.456,469,1283,0.366,1074,2104,0.51,584,762,0.766,349,1358,1707,872,296,585,820,4139
7045,2018-1-13,Utah Jazz,42,10105,1550,3466,0.447,465,1269,0.366,1085,2197,0.494,666,823,0.809,353,1362,1715,889,383,580,839,4231
7046,2018-1-13,Memphis Grizzlies,41,9865,1466,3312,0.443,384,1100,0.349,1082,2212,0.489,725,920,0.788,362,1275,1637,845,301,553,950,4041
7047,2018-1-13,Sacramento Kings,41,9865,1566,3485,0.449,351,925,0.379,1215,2560,0.475,526,724,0.727,389,1265,1654,848,333,562,809,4009
7048,2018-1-14,Golden State Warriors,44,10610,1921,3765,0.51,505,1298,0.389,1416,2467,0.574,749,919,0.815,371,1582,1953,1344,362,670,874,5096
7049,2018-1-14,Houston Rockets,41,9890,1614,3500,0.461,648,1786,0.363,966,1714,0.564,837,1052,0.796,394,1421,1815,922,362,590,842,4713
7050,2018-1-14,Toronto Raptors,41,9890,1695,3589,0.472,461,1308,0.352,1234,2281,0.541,756,941,0.803,398,1373,1771,936,345,524,907,4607
7051,2018-1-14,New Orleans Pelicans,41,9915,1698,3462,0.49,449,1199,0.374,1249,2263,0.552,696,910,0.765,335,1409,1744,1082,297,629,803,4541
7052,2018-1-14,Cleveland Cavaliers,42,10105,1653,3506,0.471,513,1379,0.372,1140,2127,0.536,782,970,0.806,355,1400,1755,977,304,574,775,4601
7053,2018-1-14,Minnesota Timberwolves,44,10635,1786,3750,0.476,353,1004,0.352,1433,2746,0.522,851,1073,0.793,465,1380,1845,1006,397,541,787,4776
7054,2018-1-14,Philadelphia 76ers,39,9460,1565,3391,0.462,414,1155,0.358,1151,2236,0.515,684,903,0.757,436,1419,1855,1016,330,673,917,4228
7055,2018-1-14,Los Angeles Clippers,42,10105,1636,3559,0.46,439,1221,0.36,1197,2338,0.512,797,1054,0.756,433,1390,1823,896,326,599,881,4508
7056,2018-1-14,Washington Wizards,43,10395,1723,3700,0.466,413,1119,0.369,1310,2581,0.508,747,990,0.755,420,1444,1864,995,336,574,928,4606
7057,2018-1-14,Indiana Pacers,42,10130,1732,3607,0.48,397,1043,0.381,1335,2564,0.521,635,827,0.768,384,1377,1761,946,326,555,785,4496
7058,2018-1-14,Los Angeles Lakers,42,10255,1706,3761,0.454,384,1170,0.328,1322,2591,0.51,677,982,0.689,472,1491,1963,985,354,682,938,4473
7059,2018-1-14,Brooklyn Nets,43,10395,1637,3749,0.437,511,1469,0.348,1126,2280,0.494,780,1024,0.762,442,1521,1963,969,280,643,886,4565
7060,2018-1-14,Denver Nuggets,43,10395,1699,3692,0.46,468,1301,0.36,1231,2391,0.515,701,941,0.745,495,1441,1936,1007,333,643,750,4567
7061,2018-1-14,Milwaukee Bucks,41,9890,1623,3345,0.485,353,1003,0.352,1270,2342,0.542,734,957,0.767,314,1264,1578,934,342,526,921,4333
7062,2018-1-14,Phoenix Suns,43,10345,1658,3735,0.444,392,1149,0.341,1266,2586,0.49,827,1093,0.757,476,1455,1931,898,291,656,951,4535
7063,2018-1-14,Orlando Magic,43,10345,1698,3720,0.456,448,1265,0.354,1250,2455,0.509,681,904,0.753,380,1412,1792,1004,305,614,859,4525
7064,2018-1-14,Charlotte Hornets,41,9890,1554,3540,0.439,370,1049,0.353,1184,2491,0.475,814,1123,0.725,426,1480,1906,842,270,524,744,4292
7065,2018-1-14,Oklahoma City Thunder,43,10420,1685,3733,0.451,440,1239,0.355,1245,2494,0.499,676,952,0.71,514,1385,1899,897,404,589,882,4486
7066,2018-1-14,Atlanta Hawks,42,10105,1617,3569,0.453,457,1213,0.377,1160,2356,0.492,676,859,0.787,407,1299,1706,991,353,633,836,4367
7067,2018-1-14,Portland Trail Blazers,42,10130,1629,3617,0.45,397,1074,0.37,1232,2543,0.484,700,886,0.79,414,1455,1869,796,292,577,841,4355
7068,2018-1-14,New York Knicks,42,10180,1685,3610,0.467,324,895,0.362,1361,2715,0.501,660,829,0.796,450,1424,1874,946,291,627,875,4354
7069,2018-1-14,Boston Celtics,44,10585,1665,3697,0.45,504,1369,0.368,1161,2328,0.499,698,919,0.76,401,1558,1959,970,335,580,880,4532
7070,2018-1-14,Dallas Mavericks,44,10610,1677,3724,0.45,519,1415,0.367,1158,2309,0.502,638,824,0.774,328,1448,1776,997,293,524,851,4511
7071,2018-1-14,Chicago Bulls,43,10445,1671,3797,0.44,469,1294,0.362,1202,2503,0.48,591,786,0.752,395,1519,1914,1015,303,566,809,4402
7072,2018-1-14,Detroit Pistons,41,9840,1584,3526,0.449,441,1158,0.381,1143,2368,0.483,584,775,0.754,417,1314,1731,903,316,539,746,4193
7073,2018-1-14,San Antonio Spurs,44,10560,1687,3674,0.459,397,1075,0.369,1290,2599,0.496,691,888,0.778,438,1513,1951,966,320,597,750,4462
7074,2018-1-14,Miami Heat,41,9890,1543,3387,0.456,469,1283,0.366,1074,2104,0.51,584,762,0.766,349,1358,1707,872,296,585,820,4139
7075,2018-1-14,Utah Jazz,42,10105,1550,3466,0.447,465,1269,0.366,1085,2197,0.494,666,823,0.809,353,1362,1715,889,383,580,839,4231
7076,2018-1-14,Memphis Grizzlies,41,9865,1466,3312,0.443,384,1100,0.349,1082,2212,0.489,725,920,0.788,362,1275,1637,845,301,553,950,4041
7077,2018-1-14,Sacramento Kings,42,10105,1609,3570,0.451,357,942,0.379,1252,2628,0.476,539,746,0.723,399,1292,1691,874,345,578,833,4114
7078,2018-1-15,Golden State Warriors,44,10610,1921,3765,0.51,505,1298,0.389,1416,2467,0.574,749,919,0.815,371,1582,1953,1344,362,670,874,5096
7079,2018-1-15,Houston Rockets,41,9890,1614,3500,0.461,648,1786,0.363,966,1714,0.564,837,1052,0.796,394,1421,1815,922,362,590,842,4713
7080,2018-1-15,Toronto Raptors,41,9890,1695,3589,0.472,461,1308,0.352,1234,2281,0.541,756,941,0.803,398,1373,1771,936,345,524,907,4607
7081,2018-1-15,New Orleans Pelicans,42,10180,1743,3557,0.49,458,1231,0.372,1285,2326,0.552,720,944,0.763,347,1443,1790,1101,314,648,820,4664
7082,2018-1-15,Cleveland Cavaliers,42,10105,1653,3506,0.471,513,1379,0.372,1140,2127,0.536,782,970,0.806,355,1400,1755,977,304,574,775,4601
7083,2018-1-15,Minnesota Timberwolves,45,10875,1829,3830,0.478,360,1023,0.352,1469,2807,0.523,878,1106,0.794,472,1411,1883,1027,409,552,804,4896
7084,2018-1-15,Philadelphia 76ers,39,9460,1565,3391,0.462,414,1155,0.358,1151,2236,0.515,684,903,0.757,436,1419,1855,1016,330,673,917,4228
7085,2018-1-15,Los Angeles Clippers,42,10105,1636,3559,0.46,439,1221,0.36,1197,2338,0.512,797,1054,0.756,433,1390,1823,896,326,599,881,4508
7086,2018-1-15,Indiana Pacers,43,10370,1780,3695,0.482,408,1066,0.383,1372,2629,0.522,648,841,0.771,392,1411,1803,966,335,561,807,4616
7087,2018-1-15,Washington Wizards,43,10395,1723,3700,0.466,413,1119,0.369,1310,2581,0.508,747,990,0.755,420,1444,1864,995,336,574,928,4606
7088,2018-1-15,Los Angeles Lakers,42,10255,1706,3761,0.454,384,1170,0.328,1322,2591,0.51,677,982,0.689,472,1491,1963,985,354,682,938,4473
7089,2018-1-15,Brooklyn Nets,43,10395,1637,3749,0.437,511,1469,0.348,1126,2280,0.494,780,1024,0.762,442,1521,1963,969,280,643,886,4565
7090,2018-1-15,Denver Nuggets,43,10395,1699,3692,0.46,468,1301,0.36,1231,2391,0.515,701,941,0.745,495,1441,1936,1007,333,643,750,4567
7091,2018-1-15,Phoenix Suns,44,10585,1693,3820,0.443,401,1186,0.338,1292,2634,0.491,845,1117,0.756,490,1486,1976,918,293,668,967,4632
7092,2018-1-15,Orlando Magic,43,10345,1698,3720,0.456,448,1265,0.354,1250,2455,0.509,681,904,0.753,380,1412,1792,1004,305,614,859,4525
7093,2018-1-15,Milwaukee Bucks,42,10130,1648,3424,0.481,357,1031,0.346,1291,2393,0.539,759,984,0.771,322,1296,1618,943,350,541,944,4412
7094,2018-1-15,Charlotte Hornets,41,9890,1554,3540,0.439,370,1049,0.353,1184,2491,0.475,814,1123,0.725,426,1480,1906,842,270,524,744,4292
7095,2018-1-15,Oklahoma City Thunder,43,10420,1685,3733,0.451,440,1239,0.355,1245,2494,0.499,676,952,0.71,514,1385,1899,897,404,589,882,4486
7096,2018-1-15,Atlanta Hawks,42,10105,1617,3569,0.453,457,1213,0.377,1160,2356,0.492,676,859,0.787,407,1299,1706,991,353,633,836,4367
7097,2018-1-15,New York Knicks,43,10445,1731,3707,0.467,336,929,0.362,1395,2778,0.502,674,847,0.796,460,1458,1918,974,303,649,902,4472
7098,2018-1-15,Portland Trail Blazers,43,10370,1668,3696,0.451,408,1099,0.371,1260,2597,0.485,714,903,0.791,422,1485,1907,815,298,594,868,4458
7099,2018-1-15,Boston Celtics,44,10585,1665,3697,0.45,504,1369,0.368,1161,2328,0.499,698,919,0.76,401,1558,1959,970,335,580,880,4532
7100,2018-1-15,Dallas Mavericks,44,10610,1677,3724,0.45,519,1415,0.367,1158,2309,0.502,638,824,0.774,328,1448,1776,997,293,524,851,4511
7101,2018-1-15,Chicago Bulls,43,10445,1671,3797,0.44,469,1294,0.362,1202,2503,0.48,591,786,0.752,395,1519,1914,1015,303,566,809,4402
7102,2018-1-15,Detroit Pistons,41,9840,1584,3526,0.449,441,1158,0.381,1143,2368,0.483,584,775,0.754,417,1314,1731,903,316,539,746,4193
7103,2018-1-15,San Antonio Spurs,44,10560,1687,3674,0.459,397,1075,0.369,1290,2599,0.496,691,888,0.778,438,1513,1951,966,320,597,750,4462
7104,2018-1-15,Miami Heat,42,10130,1578,3463,0.456,480,1312,0.366,1098,2151,0.51,600,782,0.767,352,1404,1756,895,304,598,838,4236
7105,2018-1-15,Utah Jazz,42,10105,1550,3466,0.447,465,1269,0.366,1085,2197,0.494,666,823,0.809,353,1362,1715,889,383,580,839,4231
7106,2018-1-15,Memphis Grizzlies,41,9865,1466,3312,0.443,384,1100,0.349,1082,2212,0.489,725,920,0.788,362,1275,1637,845,301,553,950,4041
7107,2018-1-15,Sacramento Kings,42,10105,1609,3570,0.451,357,942,0.379,1252,2628,0.476,539,746,0.723,399,1292,1691,874,345,578,833,4114
7108,2018-1-16,Golden State Warriors,45,10850,1962,3850,0.51,517,1330,0.389,1445,2520,0.573,773,949,0.815,384,1617,2001,1377,370,686,897,5214
7109,2018-1-16,Houston Rockets,42,10130,1652,3594,0.46,661,1830,0.361,991,1764,0.562,850,1068,0.796,407,1445,1852,943,371,602,863,4815
7110,2018-1-16,Toronto Raptors,42,10130,1733,3684,0.47,470,1340,0.351,1263,2344,0.539,782,971,0.805,410,1405,1815,956,353,539,938,4718
7111,2018-1-16,New Orleans Pelicans,42,10180,1743,3557,0.49,458,1231,0.372,1285,2326,0.552,720,944,0.763,347,1443,1790,1101,314,648,820,4664
7112,2018-1-16,Cleveland Cavaliers,43,10345,1696,3600,0.471,520,1407,0.37,1176,2193,0.536,797,992,0.803,367,1431,1798,1003,313,589,797,4709
7113,2018-1-16,Minnesota Timberwolves,45,10875,1829,3830,0.478,360,1023,0.352,1469,2807,0.523,878,1106,0.794,472,1411,1883,1027,409,552,804,4896
7114,2018-1-16,Philadelphia 76ers,40,9700,1605,3472,0.462,420,1180,0.356,1185,2292,0.517,715,941,0.76,446,1457,1903,1038,338,694,945,4345
7115,2018-1-16,Los Angeles Clippers,43,10345,1680,3638,0.462,449,1246,0.36,1231,2392,0.515,812,1074,0.756,437,1427,1864,926,332,617,898,4621
7116,2018-1-16,Indiana Pacers,44,10610,1821,3772,0.483,422,1092,0.386,1399,2680,0.522,661,856,0.772,400,1446,1846,992,342,575,825,4725
7117,2018-1-16,Washington Wizards,44,10635,1755,3776,0.465,419,1140,0.368,1336,2636,0.507,772,1021,0.756,431,1472,1903,1014,346,597,950,4701
7118,2018-1-16,Los Angeles Lakers,43,10495,1744,3857,0.452,396,1205,0.329,1348,2652,0.508,703,1013,0.694,484,1523,2007,1010,365,695,961,4587
7119,2018-1-16,Denver Nuggets,43,10395,1699,3692,0.46,468,1301,0.36,1231,2391,0.515,701,941,0.745,495,1441,1936,1007,333,643,750,4567
7120,2018-1-16,Brooklyn Nets,44,10635,1669,3836,0.435,522,1501,0.348,1147,2335,0.491,809,1060,0.763,453,1554,2007,985,285,654,909,4669
7121,2018-1-16,Phoenix Suns,44,10585,1693,3820,0.443,401,1186,0.338,1292,2634,0.491,845,1117,0.756,490,1486,1976,918,293,668,967,4632
7122,2018-1-16,Orlando Magic,43,10345,1698,3720,0.456,448,1265,0.354,1250,2455,0.509,681,904,0.753,380,1412,1792,1004,305,614,859,4525
7123,2018-1-16,Milwaukee Bucks,43,10370,1686,3505,0.481,365,1047,0.349,1321,2458,0.537,779,1013,0.769,337,1325,1662,964,364,558,969,4516
7124,2018-1-16,Charlotte Hornets,42,10130,1597,3624,0.441,380,1070,0.355,1217,2554,0.477,836,1156,0.723,435,1520,1955,863,279,539,755,4410
7125,2018-1-16,New York Knicks,44,10685,1773,3789,0.468,345,945,0.365,1428,2844,0.502,700,884,0.792,468,1501,1969,1001,308,658,926,4591
7126,2018-1-16,Oklahoma City Thunder,44,10660,1721,3819,0.451,449,1269,0.354,1272,2550,0.499,690,982,0.703,532,1426,1958,917,414,607,901,4581
7127,2018-1-16,Atlanta Hawks,43,10345,1657,3655,0.453,466,1238,0.376,1191,2417,0.493,689,873,0.789,418,1338,1756,1014,361,648,859,4469
7128,2018-1-16,Portland Trail Blazers,43,10370,1668,3696,0.451,408,1099,0.371,1260,2597,0.485,714,903,0.791,422,1485,1907,815,298,594,868,4458
7129,2018-1-16,Boston Celtics,44,10585,1665,3697,0.45,504,1369,0.368,1161,2328,0.499,698,919,0.76,401,1558,1959,970,335,580,880,4532
7130,2018-1-16,Chicago Bulls,44,10685,1713,3885,0.441,485,1333,0.364,1228,2552,0.481,610,808,0.755,402,1557,1959,1042,309,575,832,4521
7131,2018-1-16,Dallas Mavericks,44,10610,1677,3724,0.45,519,1415,0.367,1158,2309,0.502,638,824,0.774,328,1448,1776,997,293,524,851,4511
7132,2018-1-16,Detroit Pistons,42,10080,1626,3612,0.45,456,1187,0.384,1170,2425,0.482,592,786,0.753,420,1349,1769,930,326,555,770,4300
7133,2018-1-16,San Antonio Spurs,45,10800,1724,3761,0.458,405,1097,0.369,1319,2664,0.495,708,908,0.78,446,1542,1988,990,332,606,763,4561
7134,2018-1-16,Miami Heat,43,10370,1618,3547,0.456,492,1348,0.365,1126,2199,0.512,619,806,0.768,356,1440,1796,930,309,612,857,4347
7135,2018-1-16,Utah Jazz,43,10345,1586,3547,0.447,474,1302,0.364,1112,2245,0.495,679,840,0.808,362,1391,1753,900,394,593,851,4325
7136,2018-1-16,Memphis Grizzlies,42,10105,1508,3394,0.444,394,1122,0.351,1114,2272,0.49,754,954,0.79,368,1317,1685,869,309,571,976,4164
7137,2018-1-16,Sacramento Kings,43,10345,1642,3654,0.449,364,972,0.374,1278,2682,0.477,554,771,0.719,405,1323,1728,896,358,591,861,4202
7138,2018-1-17,Golden State Warriors,45,10850,1962,3850,0.51,517,1330,0.389,1445,2520,0.573,773,949,0.815,384,1617,2001,1377,370,686,897,5214
7139,2018-1-17,Houston Rockets,42,10130,1652,3594,0.46,661,1830,0.361,991,1764,0.562,850,1068,0.796,407,1445,1852,943,371,602,863,4815
7140,2018-1-17,Toronto Raptors,42,10130,1733,3684,0.47,470,1340,0.351,1263,2344,0.539,782,971,0.805,410,1405,1815,956,353,539,938,4718
7141,2018-1-17,New Orleans Pelicans,43,10445,1788,3657,0.489,465,1258,0.37,1323,2399,0.551,739,969,0.763,360,1485,1845,1129,325,663,834,4780
7142,2018-1-17,Cleveland Cavaliers,43,10345,1696,3600,0.471,520,1407,0.37,1176,2193,0.536,797,992,0.803,367,1431,1798,1003,313,589,797,4709
7143,2018-1-17,Minnesota Timberwolves,46,11115,1872,3928,0.477,367,1039,0.353,1505,2889,0.521,887,1116,0.795,483,1437,1920,1046,419,559,825,4998
7144,2018-1-17,Philadelphia 76ers,40,9700,1605,3472,0.462,420,1180,0.356,1185,2292,0.517,715,941,0.76,446,1457,1903,1038,338,694,945,4345
7145,2018-1-17,Los Angeles Clippers,43,10345,1680,3638,0.462,449,1246,0.36,1231,2392,0.515,812,1074,0.756,437,1427,1864,926,332,617,898,4621
7146,2018-1-17,Indiana Pacers,44,10610,1821,3772,0.483,422,1092,0.386,1399,2680,0.522,661,856,0.772,400,1446,1846,992,342,575,825,4725
7147,2018-1-17,Washington Wizards,44,10635,1755,3776,0.465,419,1140,0.368,1336,2636,0.507,772,1021,0.756,431,1472,1903,1014,346,597,950,4701
7148,2018-1-17,Los Angeles Lakers,43,10495,1744,3857,0.452,396,1205,0.329,1348,2652,0.508,703,1013,0.694,484,1523,2007,1010,365,695,961,4587
7149,2018-1-17,Denver Nuggets,44,10635,1739,3778,0.46,476,1327,0.359,1263,2451,0.515,718,967,0.743,510,1473,1983,1030,343,661,773,4672
7150,2018-1-17,Brooklyn Nets,44,10635,1669,3836,0.435,522,1501,0.348,1147,2335,0.491,809,1060,0.763,453,1554,2007,985,285,654,909,4669
7151,2018-1-17,Phoenix Suns,45,10825,1730,3909,0.443,417,1227,0.34,1313,2682,0.49,866,1139,0.76,502,1517,2019,939,299,681,982,4743
7152,2018-1-17,Orlando Magic,44,10585,1738,3810,0.456,459,1296,0.354,1279,2514,0.509,698,923,0.756,395,1448,1843,1028,309,630,874,4633
7153,2018-1-17,Milwaukee Bucks,43,10370,1686,3505,0.481,365,1047,0.349,1321,2458,0.537,779,1013,0.769,337,1325,1662,964,364,558,969,4516
7154,2018-1-17,Charlotte Hornets,42,10130,1597,3624,0.441,380,1070,0.355,1217,2554,0.477,836,1156,0.723,435,1520,1955,863,279,539,755,4410
7155,2018-1-17,New York Knicks,44,10685,1773,3789,0.468,345,945,0.365,1428,2844,0.502,700,884,0.792,468,1501,1969,1001,308,658,926,4591
7156,2018-1-17,Oklahoma City Thunder,44,10660,1721,3819,0.451,449,1269,0.354,1272,2550,0.499,690,982,0.703,532,1426,1958,917,414,607,901,4581
7157,2018-1-17,Portland Trail Blazers,44,10610,1714,3787,0.453,425,1134,0.375,1289,2653,0.486,723,913,0.792,431,1519,1950,836,305,603,884,4576
7158,2018-1-17,Atlanta Hawks,43,10345,1657,3655,0.453,466,1238,0.376,1191,2417,0.493,689,873,0.789,418,1338,1756,1014,361,648,859,4469
7159,2018-1-17,Boston Celtics,45,10850,1705,3798,0.449,523,1419,0.369,1182,2379,0.497,712,935,0.761,413,1599,2012,997,342,598,904,4645
7160,2018-1-17,Chicago Bulls,44,10685,1713,3885,0.441,485,1333,0.364,1228,2552,0.481,610,808,0.755,402,1557,1959,1042,309,575,832,4521
7161,2018-1-17,Dallas Mavericks,45,10850,1715,3802,0.451,527,1442,0.365,1188,2360,0.503,656,846,0.775,333,1478,1811,1014,303,540,875,4613
7162,2018-1-17,Detroit Pistons,42,10080,1626,3612,0.45,456,1187,0.384,1170,2425,0.482,592,786,0.753,420,1349,1769,930,326,555,770,4300
7163,2018-1-17,San Antonio Spurs,45,10800,1724,3761,0.458,405,1097,0.369,1319,2664,0.495,708,908,0.78,446,1542,1988,990,332,606,763,4561
7164,2018-1-17,Miami Heat,43,10370,1618,3547,0.456,492,1348,0.365,1126,2199,0.512,619,806,0.768,356,1440,1796,930,309,612,857,4347
7165,2018-1-17,Utah Jazz,43,10345,1586,3547,0.447,474,1302,0.364,1112,2245,0.495,679,840,0.808,362,1391,1753,900,394,593,851,4325
7166,2018-1-17,Memphis Grizzlies,42,10105,1508,3394,0.444,394,1122,0.351,1114,2272,0.49,754,954,0.79,368,1317,1685,869,309,571,976,4164
7167,2018-1-17,Sacramento Kings,43,10345,1642,3654,0.449,364,972,0.374,1278,2682,0.477,554,771,0.719,405,1323,1728,896,358,591,861,4202
7168,2018-1-18,Golden State Warriors,46,11090,2004,3934,0.509,530,1363,0.389,1474,2571,0.573,795,974,0.816,389,1661,2050,1401,375,701,913,5333
7169,2018-1-18,Houston Rockets,42,10130,1652,3594,0.46,661,1830,0.361,991,1764,0.562,850,1068,0.796,407,1445,1852,943,371,602,863,4815
7170,2018-1-18,Toronto Raptors,43,10370,1767,3764,0.469,481,1371,0.351,1286,2393,0.537,799,994,0.804,422,1442,1864,980,359,559,958,4814
7171,2018-1-18,New Orleans Pelicans,44,10685,1823,3737,0.488,475,1285,0.37,1348,2452,0.55,752,988,0.761,369,1519,1888,1156,330,675,854,4873
7172,2018-1-18,Cleveland Cavaliers,43,10345,1696,3600,0.471,520,1407,0.37,1176,2193,0.536,797,992,0.803,367,1431,1798,1003,313,589,797,4709
7173,2018-1-18,Minnesota Timberwolves,46,11115,1872,3928,0.477,367,1039,0.353,1505,2889,0.521,887,1116,0.795,483,1437,1920,1046,419,559,825,4998
7174,2018-1-18,Philadelphia 76ers,40,9700,1605,3472,0.462,420,1180,0.356,1185,2292,0.517,715,941,0.76,446,1457,1903,1038,338,694,945,4345
7175,2018-1-18,Los Angeles Clippers,44,10585,1720,3725,0.462,459,1276,0.36,1261,2449,0.515,831,1105,0.752,454,1458,1912,948,342,637,914,4730
7176,2018-1-18,Indiana Pacers,44,10610,1821,3772,0.483,422,1092,0.386,1399,2680,0.522,661,856,0.772,400,1446,1846,992,342,575,825,4725
7177,2018-1-18,Washington Wizards,45,10875,1795,3858,0.465,432,1163,0.371,1363,2695,0.506,788,1044,0.755,438,1505,1943,1045,349,613,973,4810
7178,2018-1-18,Los Angeles Lakers,44,10735,1782,3938,0.453,406,1231,0.33,1376,2707,0.508,707,1017,0.695,490,1547,2037,1035,374,711,976,4677
7179,2018-1-18,Denver Nuggets,45,10875,1781,3875,0.46,481,1352,0.356,1300,2523,0.515,733,985,0.744,530,1507,2037,1053,356,680,798,4776
7180,2018-1-18,Brooklyn Nets,45,10875,1704,3919,0.435,535,1537,0.348,1169,2382,0.491,821,1078,0.762,459,1595,2054,1008,288,668,937,4764
7181,2018-1-18,Charlotte Hornets,43,10370,1645,3722,0.442,395,1101,0.359,1250,2621,0.477,858,1182,0.726,448,1556,2004,890,289,548,773,4543
7182,2018-1-18,Phoenix Suns,45,10825,1730,3909,0.443,417,1227,0.34,1313,2682,0.49,866,1139,0.76,502,1517,2019,939,299,681,982,4743
7183,2018-1-18,Orlando Magic,44,10585,1738,3810,0.456,459,1296,0.354,1279,2514,0.509,698,923,0.756,395,1448,1843,1028,309,630,874,4633
7184,2018-1-18,Milwaukee Bucks,44,10610,1719,3581,0.48,376,1075,0.35,1343,2506,0.536,803,1045,0.768,342,1358,1700,987,370,567,994,4617
7185,2018-1-18,Oklahoma City Thunder,45,10900,1767,3914,0.451,461,1304,0.354,1306,2610,0.5,700,994,0.704,553,1459,2012,939,424,623,915,4695
7186,2018-1-18,New York Knicks,45,10925,1808,3871,0.467,352,972,0.362,1456,2899,0.502,722,907,0.796,480,1534,2014,1023,313,672,941,4690
7187,2018-1-18,Portland Trail Blazers,44,10610,1714,3787,0.453,425,1134,0.375,1289,2653,0.486,723,913,0.792,431,1519,1950,836,305,603,884,4576
7188,2018-1-18,Atlanta Hawks,44,10585,1694,3744,0.452,476,1278,0.372,1218,2466,0.494,699,886,0.789,430,1369,1799,1046,366,658,881,4563
7189,2018-1-18,Boston Celtics,45,10850,1705,3798,0.449,523,1419,0.369,1182,2379,0.497,712,935,0.761,413,1599,2012,997,342,598,904,4645
7190,2018-1-18,Chicago Bulls,45,10925,1758,3991,0.44,495,1372,0.361,1263,2619,0.482,622,821,0.758,416,1592,2008,1066,319,586,851,4633
7191,2018-1-18,Dallas Mavericks,45,10850,1715,3802,0.451,527,1442,0.365,1188,2360,0.503,656,846,0.775,333,1478,1811,1014,303,540,875,4613
7192,2018-1-18,Detroit Pistons,43,10320,1663,3700,0.449,466,1215,0.384,1197,2485,0.482,599,801,0.748,431,1380,1811,952,340,569,790,4391
7193,2018-1-18,San Antonio Spurs,46,11040,1758,3843,0.457,414,1116,0.371,1344,2727,0.493,731,939,0.778,453,1577,2030,1014,340,615,783,4661
7194,2018-1-18,Miami Heat,44,10610,1656,3629,0.456,502,1372,0.366,1154,2257,0.511,639,833,0.767,366,1476,1842,958,313,627,885,4453
7195,2018-1-18,Utah Jazz,44,10585,1632,3628,0.45,486,1331,0.365,1146,2297,0.499,695,860,0.808,368,1414,1782,926,409,603,871,4445
7196,2018-1-18,Memphis Grizzlies,43,10345,1549,3485,0.444,404,1150,0.351,1145,2335,0.49,767,971,0.79,383,1346,1729,892,318,582,995,4269
7197,2018-1-18,Sacramento Kings,44,10585,1680,3726,0.451,377,993,0.38,1303,2733,0.477,570,791,0.721,413,1351,1764,915,367,610,882,4307
7198,2018-1-19,Golden State Warriors,46,11090,2004,3934,0.509,530,1363,0.389,1474,2571,0.573,795,974,0.816,389,1661,2050,1401,375,701,913,5333
7199,2018-1-19,Houston Rockets,43,10370,1694,3682,0.46,678,1869,0.363,1016,1813,0.56,865,1085,0.797,418,1479,1897,967,382,611,878,4931
7200,2018-1-19,Toronto Raptors,43,10370,1767,3764,0.469,481,1371,0.351,1286,2393,0.537,799,994,0.804,422,1442,1864,980,359,559,958,4814
7201,2018-1-19,New Orleans Pelicans,44,10685,1823,3737,0.488,475,1285,0.37,1348,2452,0.55,752,988,0.761,369,1519,1888,1156,330,675,854,4873
7202,2018-1-19,Cleveland Cavaliers,44,10585,1734,3685,0.471,530,1441,0.368,1204,2244,0.537,815,1019,0.8,381,1463,1844,1025,321,609,818,4813
7203,2018-1-19,Minnesota Timberwolves,47,11355,1910,4009,0.476,375,1063,0.353,1535,2946,0.521,901,1137,0.792,491,1469,1960,1070,427,570,841,5096
7204,2018-1-19,Philadelphia 76ers,41,9940,1639,3545,0.462,426,1197,0.356,1213,2348,0.517,730,958,0.762,454,1490,1944,1056,348,716,965,4434
7205,2018-1-19,Los Angeles Clippers,44,10585,1720,3725,0.462,459,1276,0.36,1261,2449,0.515,831,1105,0.752,454,1458,1912,948,342,637,914,4730
7206,2018-1-19,Washington Wizards,45,10875,1795,3858,0.465,432,1163,0.371,1363,2695,0.506,788,1044,0.755,438,1505,1943,1045,349,613,973,4810
7207,2018-1-19,Indiana Pacers,45,10850,1857,3863,0.481,429,1118,0.384,1428,2745,0.52,668,869,0.769,410,1482,1892,1009,346,583,841,4811
7208,2018-1-19,Los Angeles Lakers,44,10735,1782,3938,0.453,406,1231,0.33,1376,2707,0.508,707,1017,0.695,490,1547,2037,1035,374,711,976,4677
7209,2018-1-19,Denver Nuggets,45,10875,1781,3875,0.46,481,1352,0.356,1300,2523,0.515,733,985,0.744,530,1507,2037,1053,356,680,798,4776
7210,2018-1-19,Brooklyn Nets,45,10875,1704,3919,0.435,535,1537,0.348,1169,2382,0.491,821,1078,0.762,459,1595,2054,1008,288,668,937,4764
7211,2018-1-19,Charlotte Hornets,43,10370,1645,3722,0.442,395,1101,0.359,1250,2621,0.477,858,1182,0.726,448,1556,2004,890,289,548,773,4543
7212,2018-1-19,Phoenix Suns,45,10825,1730,3909,0.443,417,1227,0.34,1313,2682,0.49,866,1139,0.76,502,1517,2019,939,299,681,982,4743
7213,2018-1-19,Orlando Magic,45,10825,1779,3898,0.456,464,1318,0.352,1315,2580,0.51,714,944,0.756,404,1481,1885,1053,321,644,896,4736
7214,2018-1-19,Milwaukee Bucks,44,10610,1719,3581,0.48,376,1075,0.35,1343,2506,0.536,803,1045,0.768,342,1358,1700,987,370,567,994,4617
7215,2018-1-19,Oklahoma City Thunder,45,10900,1767,3914,0.451,461,1304,0.354,1306,2610,0.5,700,994,0.704,553,1459,2012,939,424,623,915,4695
7216,2018-1-19,New York Knicks,45,10925,1808,3871,0.467,352,972,0.362,1456,2899,0.502,722,907,0.796,480,1534,2014,1023,313,672,941,4690
7217,2018-1-19,Portland Trail Blazers,45,10850,1751,3881,0.451,435,1166,0.373,1316,2715,0.485,739,929,0.795,445,1562,2007,853,311,614,895,4676
7218,2018-1-19,Atlanta Hawks,44,10585,1694,3744,0.452,476,1278,0.372,1218,2466,0.494,699,886,0.789,430,1369,1799,1046,366,658,881,4563
7219,2018-1-19,Chicago Bulls,45,10925,1758,3991,0.44,495,1372,0.361,1263,2619,0.482,622,821,0.758,416,1592,2008,1066,319,586,851,4633
7220,2018-1-19,Boston Celtics,46,11090,1735,3872,0.448,530,1448,0.366,1205,2424,0.497,725,952,0.762,416,1627,2043,1010,349,617,924,4725
7221,2018-1-19,Dallas Mavericks,45,10850,1715,3802,0.451,527,1442,0.365,1188,2360,0.503,656,846,0.775,333,1478,1811,1014,303,540,875,4613
7222,2018-1-19,Detroit Pistons,43,10320,1663,3700,0.449,466,1215,0.384,1197,2485,0.482,599,801,0.748,431,1380,1811,952,340,569,790,4391
7223,2018-1-19,San Antonio Spurs,46,11040,1758,3843,0.457,414,1116,0.371,1344,2727,0.493,731,939,0.778,453,1577,2030,1014,340,615,783,4661
7224,2018-1-19,Miami Heat,44,10610,1656,3629,0.456,502,1372,0.366,1154,2257,0.511,639,833,0.767,366,1476,1842,958,313,627,885,4453
7225,2018-1-19,Utah Jazz,44,10585,1632,3628,0.45,486,1331,0.365,1146,2297,0.499,695,860,0.808,368,1414,1782,926,409,603,871,4445
7226,2018-1-19,Memphis Grizzlies,43,10345,1549,3485,0.444,404,1150,0.351,1145,2335,0.49,767,971,0.79,383,1346,1729,892,318,582,995,4269
7227,2018-1-19,Sacramento Kings,44,10585,1680,3726,0.451,377,993,0.38,1303,2733,0.477,570,791,0.721,413,1351,1764,915,367,610,882,4307
7228,2018-1-20,Golden State Warriors,46,11090,2004,3934,0.509,530,1363,0.389,1474,2571,0.573,795,974,0.816,389,1661,2050,1401,375,701,913,5333
7229,2018-1-20,Houston Rockets,43,10370,1694,3682,0.46,678,1869,0.363,1016,1813,0.56,865,1085,0.797,418,1479,1897,967,382,611,878,4931
7230,2018-1-20,Toronto Raptors,44,10610,1801,3849,0.468,490,1397,0.351,1311,2452,0.535,808,1008,0.802,431,1483,1914,996,367,572,977,4900
7231,2018-1-20,New Orleans Pelicans,44,10685,1823,3737,0.488,475,1285,0.37,1348,2452,0.55,752,988,0.761,369,1519,1888,1156,330,675,854,4873
7232,2018-1-20,Cleveland Cavaliers,44,10585,1734,3685,0.471,530,1441,0.368,1204,2244,0.537,815,1019,0.8,381,1463,1844,1025,321,609,818,4813
7233,2018-1-20,Minnesota Timberwolves,47,11355,1910,4009,0.476,375,1063,0.353,1535,2946,0.521,901,1137,0.792,491,1469,1960,1070,427,570,841,5096
7234,2018-1-20,Philadelphia 76ers,41,9940,1639,3545,0.462,426,1197,0.356,1213,2348,0.517,730,958,0.762,454,1490,1944,1056,348,716,965,4434
7235,2018-1-20,Los Angeles Clippers,44,10585,1720,3725,0.462,459,1276,0.36,1261,2449,0.515,831,1105,0.752,454,1458,1912,948,342,637,914,4730
7236,2018-1-20,Washington Wizards,46,11115,1836,3940,0.466,448,1198,0.374,1388,2742,0.506,812,1071,0.758,446,1531,1977,1073,359,626,993,4932
7237,2018-1-20,Indiana Pacers,46,11090,1894,3960,0.478,431,1143,0.377,1463,2817,0.519,678,882,0.769,422,1514,1936,1024,355,592,859,4897
7238,2018-1-20,Los Angeles Lakers,45,10975,1826,4018,0.454,415,1259,0.33,1411,2759,0.511,709,1031,0.688,496,1588,2084,1061,381,725,993,4776
7239,2018-1-20,Denver Nuggets,46,11115,1816,3953,0.459,495,1388,0.357,1321,2565,0.515,749,1006,0.745,537,1542,2079,1076,363,696,818,4876
7240,2018-1-20,Brooklyn Nets,46,11115,1740,3995,0.436,544,1569,0.347,1196,2426,0.493,841,1104,0.762,469,1629,2098,1028,293,682,955,4865
7241,2018-1-20,Charlotte Hornets,43,10370,1645,3722,0.442,395,1101,0.359,1250,2621,0.477,858,1182,0.726,448,1556,2004,890,289,548,773,4543
7242,2018-1-20,Phoenix Suns,46,11065,1770,3990,0.444,431,1260,0.342,1339,2730,0.49,880,1159,0.759,506,1550,2056,967,308,692,1003,4851
7243,2018-1-20,Orlando Magic,45,10825,1779,3898,0.456,464,1318,0.352,1315,2580,0.51,714,944,0.756,404,1481,1885,1053,321,644,896,4736
7244,2018-1-20,Milwaukee Bucks,44,10610,1719,3581,0.48,376,1075,0.35,1343,2506,0.536,803,1045,0.768,342,1358,1700,987,370,567,994,4617
7245,2018-1-20,New York Knicks,46,11165,1852,3960,0.468,363,992,0.366,1489,2968,0.502,740,930,0.796,487,1563,2050,1046,319,684,967,4807
7246,2018-1-20,Oklahoma City Thunder,45,10900,1767,3914,0.451,461,1304,0.354,1306,2610,0.5,700,994,0.704,553,1459,2012,939,424,623,915,4695
7247,2018-1-20,Portland Trail Blazers,45,10850,1751,3881,0.451,435,1166,0.373,1316,2715,0.485,739,929,0.795,445,1562,2007,853,311,614,895,4676
7248,2018-1-20,Atlanta Hawks,44,10585,1694,3744,0.452,476,1278,0.372,1218,2466,0.494,699,886,0.789,430,1369,1799,1046,366,658,881,4563
7249,2018-1-20,Chicago Bulls,45,10925,1758,3991,0.44,495,1372,0.361,1263,2619,0.482,622,821,0.758,416,1592,2008,1066,319,586,851,4633
7250,2018-1-20,Boston Celtics,46,11090,1735,3872,0.448,530,1448,0.366,1205,2424,0.497,725,952,0.762,416,1627,2043,1010,349,617,924,4725
7251,2018-1-20,Dallas Mavericks,45,10850,1715,3802,0.451,527,1442,0.365,1188,2360,0.503,656,846,0.775,333,1478,1811,1014,303,540,875,4613
7252,2018-1-20,Detroit Pistons,44,10560,1703,3780,0.451,476,1245,0.382,1227,2535,0.484,621,827,0.751,438,1408,1846,977,348,583,812,4503
7253,2018-1-20,Utah Jazz,45,10825,1674,3719,0.45,497,1362,0.365,1177,2357,0.499,715,890,0.803,383,1451,1834,945,413,620,891,4560
7254,2018-1-20,Miami Heat,45,10850,1691,3713,0.455,509,1394,0.365,1182,2319,0.51,657,858,0.766,378,1507,1885,980,320,638,907,4548
7255,2018-1-20,San Antonio Spurs,47,11280,1789,3934,0.455,419,1136,0.369,1370,2798,0.49,747,959,0.779,470,1616,2086,1032,349,627,796,4744
7256,2018-1-20,Memphis Grizzlies,44,10585,1588,3573,0.444,414,1184,0.35,1174,2389,0.491,785,994,0.79,397,1381,1778,916,330,595,1012,4375
7257,2018-1-20,Sacramento Kings,45,10825,1712,3806,0.45,388,1020,0.38,1324,2786,0.475,583,809,0.721,424,1384,1808,933,377,631,902,4395
7258,2018-1-21,Golden State Warriors,47,11330,2044,4016,0.509,547,1399,0.391,1497,2617,0.572,806,989,0.815,393,1690,2083,1432,383,720,937,5441
7259,2018-1-21,Houston Rockets,44,10610,1735,3769,0.46,692,1906,0.363,1043,1863,0.56,885,1114,0.794,430,1513,1943,986,396,626,896,5047
7260,2018-1-21,Toronto Raptors,45,10850,1840,3932,0.468,502,1430,0.351,1338,2502,0.535,827,1029,0.804,439,1510,1949,1019,374,585,1007,5009
7261,2018-1-21,New Orleans Pelicans,45,10925,1862,3815,0.488,482,1312,0.367,1380,2503,0.551,778,1020,0.763,375,1554,1929,1179,336,685,869,4984
7262,2018-1-21,Cleveland Cavaliers,45,10825,1780,3774,0.472,540,1478,0.365,1240,2296,0.54,837,1046,0.8,384,1488,1872,1057,328,624,836,4937
7263,2018-1-21,Minnesota Timberwolves,48,11595,1948,4090,0.476,382,1079,0.354,1566,3011,0.52,933,1179,0.791,506,1498,2004,1091,431,581,861,5211
7264,2018-1-21,Philadelphia 76ers,42,10180,1684,3630,0.464,436,1222,0.357,1248,2408,0.518,746,977,0.764,465,1524,1989,1088,357,732,983,4550
7265,2018-1-21,Los Angeles Clippers,45,10825,1756,3807,0.461,470,1312,0.358,1286,2495,0.515,861,1143,0.753,461,1485,1946,966,359,651,938,4843
7266,2018-1-21,Washington Wizards,46,11115,1836,3940,0.466,448,1198,0.374,1388,2742,0.506,812,1071,0.758,446,1531,1977,1073,359,626,993,4932
7267,2018-1-21,Indiana Pacers,46,11090,1894,3960,0.478,431,1143,0.377,1463,2817,0.519,678,882,0.769,422,1514,1936,1024,355,592,859,4897
7268,2018-1-21,Los Angeles Lakers,45,10975,1826,4018,0.454,415,1259,0.33,1411,2759,0.511,709,1031,0.688,496,1588,2084,1061,381,725,993,4776
7269,2018-1-21,Denver Nuggets,46,11115,1816,3953,0.459,495,1388,0.357,1321,2565,0.515,749,1006,0.745,537,1542,2079,1076,363,696,818,4876
7270,2018-1-21,Brooklyn Nets,46,11115,1740,3995,0.436,544,1569,0.347,1196,2426,0.493,841,1104,0.762,469,1629,2098,1028,293,682,955,4865
7271,2018-1-21,Charlotte Hornets,44,10610,1686,3812,0.442,402,1128,0.356,1284,2684,0.478,874,1203,0.727,456,1591,2047,912,298,555,785,4648
7272,2018-1-21,Phoenix Suns,46,11065,1770,3990,0.444,431,1260,0.342,1339,2730,0.49,880,1159,0.759,506,1550,2056,967,308,692,1003,4851
7273,2018-1-21,Oklahoma City Thunder,46,11140,1825,4014,0.455,475,1334,0.356,1350,2680,0.504,718,1022,0.703,569,1495,2064,976,433,636,938,4843
7274,2018-1-21,Orlando Magic,45,10825,1779,3898,0.456,464,1318,0.352,1315,2580,0.51,714,944,0.756,404,1481,1885,1053,321,644,896,4736
7275,2018-1-21,Milwaukee Bucks,45,10850,1752,3663,0.478,386,1107,0.349,1366,2556,0.534,821,1067,0.769,350,1385,1735,1007,380,584,1014,4711
7276,2018-1-21,New York Knicks,46,11165,1852,3960,0.468,363,992,0.366,1489,2968,0.502,740,930,0.796,487,1563,2050,1046,319,684,967,4807
7277,2018-1-21,Portland Trail Blazers,46,11090,1796,3967,0.453,453,1202,0.377,1343,2765,0.486,748,939,0.797,454,1593,2047,872,314,628,918,4793
7278,2018-1-21,Atlanta Hawks,45,10825,1729,3836,0.451,487,1326,0.367,1242,2510,0.495,715,909,0.787,439,1405,1844,1073,371,671,902,4660
7279,2018-1-21,Chicago Bulls,46,11165,1798,4071,0.442,509,1404,0.363,1289,2667,0.483,641,842,0.761,420,1636,2056,1097,327,602,874,4746
7280,2018-1-21,Boston Celtics,46,11090,1735,3872,0.448,530,1448,0.366,1205,2424,0.497,725,952,0.762,416,1627,2043,1010,349,617,924,4725
7281,2018-1-21,Dallas Mavericks,46,11090,1753,3885,0.451,537,1467,0.366,1216,2418,0.503,678,874,0.776,344,1504,1848,1033,312,549,896,4721
7282,2018-1-21,Detroit Pistons,44,10560,1703,3780,0.451,476,1245,0.382,1227,2535,0.484,621,827,0.751,438,1408,1846,977,348,583,812,4503
7283,2018-1-21,Utah Jazz,46,11065,1719,3801,0.452,508,1390,0.365,1211,2411,0.502,739,922,0.802,394,1496,1890,966,422,640,920,4685
7284,2018-1-21,Miami Heat,46,11090,1734,3800,0.456,522,1422,0.367,1212,2378,0.51,664,870,0.763,386,1546,1932,1008,325,652,924,4654
7285,2018-1-21,San Antonio Spurs,47,11280,1789,3934,0.455,419,1136,0.369,1370,2798,0.49,747,959,0.779,470,1616,2086,1032,349,627,796,4744
7286,2018-1-21,Memphis Grizzlies,45,10825,1625,3655,0.445,429,1219,0.352,1196,2436,0.491,800,1010,0.792,407,1415,1822,938,332,609,1041,4479
7287,2018-1-21,Sacramento Kings,45,10825,1712,3806,0.45,388,1020,0.38,1324,2786,0.475,583,809,0.721,424,1384,1808,933,377,631,902,4395
7288,2018-1-22,Golden State Warriors,47,11330,2044,4016,0.509,547,1399,0.391,1497,2617,0.572,806,989,0.815,393,1690,2083,1432,383,720,937,5441
7289,2018-1-22,Houston Rockets,44,10610,1735,3769,0.46,692,1906,0.363,1043,1863,0.56,885,1114,0.794,430,1513,1943,986,396,626,896,5047
7290,2018-1-22,Toronto Raptors,45,10850,1840,3932,0.468,502,1430,0.351,1338,2502,0.535,827,1029,0.804,439,1510,1949,1019,374,585,1007,5009
7291,2018-1-22,New Orleans Pelicans,45,10925,1862,3815,0.488,482,1312,0.367,1380,2503,0.551,778,1020,0.763,375,1554,1929,1179,336,685,869,4984
7292,2018-1-22,Cleveland Cavaliers,45,10825,1780,3774,0.472,540,1478,0.365,1240,2296,0.54,837,1046,0.8,384,1488,1872,1057,328,624,836,4937
7293,2018-1-22,Minnesota Timberwolves,48,11595,1948,4090,0.476,382,1079,0.354,1566,3011,0.52,933,1179,0.791,506,1498,2004,1091,431,581,861,5211
7294,2018-1-22,Philadelphia 76ers,42,10180,1684,3630,0.464,436,1222,0.357,1248,2408,0.518,746,977,0.764,465,1524,1989,1088,357,732,983,4550
7295,2018-1-22,Los Angeles Clippers,45,10825,1756,3807,0.461,470,1312,0.358,1286,2495,0.515,861,1143,0.753,461,1485,1946,966,359,651,938,4843
7296,2018-1-22,Washington Wizards,46,11115,1836,3940,0.466,448,1198,0.374,1388,2742,0.506,812,1071,0.758,446,1531,1977,1073,359,626,993,4932
7297,2018-1-22,Los Angeles Lakers,46,11215,1877,4109,0.457,425,1285,0.331,1452,2824,0.514,724,1052,0.688,508,1615,2123,1092,391,731,1011,4903
7298,2018-1-22,Indiana Pacers,47,11330,1931,4044,0.477,435,1162,0.374,1496,2882,0.519,694,899,0.772,429,1548,1977,1038,369,602,874,4991
7299,2018-1-22,Denver Nuggets,46,11115,1816,3953,0.459,495,1388,0.357,1321,2565,0.515,749,1006,0.745,537,1542,2079,1076,363,696,818,4876
7300,2018-1-22,Brooklyn Nets,47,11355,1777,4075,0.436,557,1600,0.348,1220,2475,0.493,855,1124,0.761,476,1668,2144,1051,294,697,973,4966
7301,2018-1-22,Charlotte Hornets,44,10610,1686,3812,0.442,402,1128,0.356,1284,2684,0.478,874,1203,0.727,456,1591,2047,912,298,555,785,4648
7302,2018-1-22,Phoenix Suns,46,11065,1770,3990,0.444,431,1260,0.342,1339,2730,0.49,880,1159,0.759,506,1550,2056,967,308,692,1003,4851
7303,2018-1-22,Oklahoma City Thunder,46,11140,1825,4014,0.455,475,1334,0.356,1350,2680,0.504,718,1022,0.703,569,1495,2064,976,433,636,938,4843
7304,2018-1-22,Orlando Magic,46,11065,1822,3990,0.457,470,1339,0.351,1352,2651,0.51,725,960,0.755,417,1512,1929,1073,328,654,915,4839
7305,2018-1-22,Milwaukee Bucks,45,10850,1752,3663,0.478,386,1107,0.349,1366,2556,0.534,821,1067,0.769,350,1385,1735,1007,380,584,1014,4711
7306,2018-1-22,New York Knicks,47,11405,1896,4041,0.469,375,1017,0.369,1521,3024,0.503,747,940,0.795,494,1589,2083,1078,322,701,987,4914
7307,2018-1-22,Portland Trail Blazers,46,11090,1796,3967,0.453,453,1202,0.377,1343,2765,0.486,748,939,0.797,454,1593,2047,872,314,628,918,4793
7308,2018-1-22,Atlanta Hawks,45,10825,1729,3836,0.451,487,1326,0.367,1242,2510,0.495,715,909,0.787,439,1405,1844,1073,371,671,902,4660
7309,2018-1-22,Chicago Bulls,46,11165,1798,4071,0.442,509,1404,0.363,1289,2667,0.483,641,842,0.761,420,1636,2056,1097,327,602,874,4746
7310,2018-1-22,Boston Celtics,47,11330,1772,3957,0.448,538,1475,0.365,1234,2482,0.497,738,966,0.764,427,1660,2087,1032,355,632,942,4820
7311,2018-1-22,Dallas Mavericks,46,11090,1753,3885,0.451,537,1467,0.366,1216,2418,0.503,678,874,0.776,344,1504,1848,1033,312,549,896,4721
7312,2018-1-22,Detroit Pistons,45,10800,1741,3870,0.45,485,1274,0.381,1256,2596,0.484,636,844,0.754,445,1444,1889,998,351,589,831,4603
7313,2018-1-22,Utah Jazz,46,11065,1719,3801,0.452,508,1390,0.365,1211,2411,0.502,739,922,0.802,394,1496,1890,966,422,640,920,4685
7314,2018-1-22,Miami Heat,46,11090,1734,3800,0.456,522,1422,0.367,1212,2378,0.51,664,870,0.763,386,1546,1932,1008,325,652,924,4654
7315,2018-1-22,San Antonio Spurs,48,11520,1824,4016,0.454,428,1170,0.366,1396,2846,0.491,754,971,0.777,480,1652,2132,1056,357,647,810,4830
7316,2018-1-22,Memphis Grizzlies,45,10825,1625,3655,0.445,429,1219,0.352,1196,2436,0.491,800,1010,0.792,407,1415,1822,938,332,609,1041,4479
7317,2018-1-22,Sacramento Kings,45,10825,1712,3806,0.45,388,1020,0.38,1324,2786,0.475,583,809,0.721,424,1384,1808,933,377,631,902,4395
7318,2018-1-23,Golden State Warriors,47,11330,2044,4016,0.509,547,1399,0.391,1497,2617,0.572,806,989,0.815,393,1690,2083,1432,383,720,937,5441
7319,2018-1-23,Houston Rockets,45,10850,1771,3850,0.46,707,1943,0.364,1064,1907,0.558,897,1132,0.792,438,1543,1981,1006,406,640,911,5146
7320,2018-1-23,Toronto Raptors,45,10850,1840,3932,0.468,502,1430,0.351,1338,2502,0.535,827,1029,0.804,439,1510,1949,1019,374,585,1007,5009
7321,2018-1-23,New Orleans Pelicans,46,11215,1909,3928,0.486,498,1356,0.367,1411,2572,0.549,800,1046,0.765,390,1594,1984,1211,350,698,897,5116
7322,2018-1-23,Cleveland Cavaliers,45,10825,1780,3774,0.472,540,1478,0.365,1240,2296,0.54,837,1046,0.8,384,1488,1872,1057,328,624,836,4937
7323,2018-1-23,Minnesota Timberwolves,49,11835,1991,4181,0.476,389,1101,0.353,1602,3080,0.52,966,1218,0.793,524,1527,2051,1111,436,594,883,5337
7324,2018-1-23,Philadelphia 76ers,43,10420,1716,3701,0.464,450,1253,0.359,1266,2448,0.517,769,1008,0.763,481,1556,2037,1109,359,755,1011,4651
7325,2018-1-23,Los Angeles Clippers,46,11065,1803,3891,0.463,479,1339,0.358,1324,2552,0.519,876,1165,0.752,469,1517,1986,997,363,668,965,4961
7326,2018-1-23,Los Angeles Lakers,46,11215,1877,4109,0.457,425,1285,0.331,1452,2824,0.514,724,1052,0.688,508,1615,2123,1092,391,731,1011,4903
7327,2018-1-23,Washington Wizards,47,11355,1862,4026,0.462,455,1230,0.37,1407,2796,0.503,828,1098,0.754,463,1561,2024,1088,366,638,1011,5007
7328,2018-1-23,Indiana Pacers,47,11330,1931,4044,0.477,435,1162,0.374,1496,2882,0.519,694,899,0.772,429,1548,1977,1038,369,602,874,4991
7329,2018-1-23,Denver Nuggets,47,11355,1850,4036,0.458,505,1418,0.356,1345,2618,0.514,775,1039,0.746,551,1577,2128,1099,370,711,838,4980
7330,2018-1-23,Charlotte Hornets,45,10850,1724,3898,0.442,418,1168,0.358,1306,2730,0.478,894,1228,0.728,467,1628,2095,934,302,570,799,4760
7331,2018-1-23,Brooklyn Nets,47,11355,1777,4075,0.436,557,1600,0.348,1220,2475,0.493,855,1124,0.761,476,1668,2144,1051,294,697,973,4966
7332,2018-1-23,Phoenix Suns,47,11305,1809,4069,0.445,440,1286,0.342,1369,2783,0.492,898,1179,0.762,515,1575,2090,998,320,713,1029,4956
7333,2018-1-23,Oklahoma City Thunder,46,11140,1825,4014,0.455,475,1334,0.356,1350,2680,0.504,718,1022,0.703,569,1495,2064,976,433,636,938,4843
7334,2018-1-23,Orlando Magic,46,11065,1822,3990,0.457,470,1339,0.351,1352,2651,0.51,725,960,0.755,417,1512,1929,1073,328,654,915,4839
7335,2018-1-23,Milwaukee Bucks,46,11090,1790,3734,0.479,391,1124,0.348,1399,2610,0.536,849,1104,0.769,358,1409,1767,1027,394,601,1036,4820
7336,2018-1-23,New York Knicks,47,11405,1896,4041,0.469,375,1017,0.369,1521,3024,0.503,747,940,0.795,494,1589,2083,1078,322,701,987,4914
7337,2018-1-23,Portland Trail Blazers,47,11330,1832,4052,0.452,461,1227,0.376,1371,2825,0.485,769,965,0.797,465,1626,2091,891,325,639,940,4894
7338,2018-1-23,Chicago Bulls,47,11455,1843,4163,0.443,517,1435,0.36,1326,2728,0.486,671,876,0.766,426,1684,2110,1128,335,626,906,4874
7339,2018-1-23,Atlanta Hawks,46,11065,1769,3919,0.451,499,1352,0.369,1270,2567,0.495,727,921,0.789,449,1439,1888,1097,379,688,926,4764
7340,2018-1-23,Boston Celtics,47,11330,1772,3957,0.448,538,1475,0.365,1234,2482,0.497,738,966,0.764,427,1660,2087,1032,355,632,942,4820
7341,2018-1-23,Dallas Mavericks,47,11330,1791,3972,0.451,547,1498,0.365,1244,2474,0.503,690,891,0.774,353,1547,1900,1053,321,560,917,4819
7342,2018-1-23,Detroit Pistons,45,10800,1741,3870,0.45,485,1274,0.381,1256,2596,0.484,636,844,0.754,445,1444,1889,998,351,589,831,4603
7343,2018-1-23,Utah Jazz,47,11305,1752,3877,0.452,512,1405,0.364,1240,2472,0.502,759,950,0.799,401,1528,1929,986,430,656,935,4775
7344,2018-1-23,Miami Heat,47,11330,1773,3882,0.457,529,1452,0.364,1244,2430,0.512,669,879,0.761,395,1579,1974,1026,332,668,942,4744
7345,2018-1-23,San Antonio Spurs,48,11520,1824,4016,0.454,428,1170,0.366,1396,2846,0.491,754,971,0.777,480,1652,2132,1056,357,647,810,4830
7346,2018-1-23,Memphis Grizzlies,46,11065,1658,3733,0.444,439,1245,0.353,1219,2488,0.49,829,1045,0.793,418,1436,1854,952,346,621,1067,4584
7347,2018-1-23,Sacramento Kings,46,11065,1755,3903,0.45,398,1042,0.382,1357,2861,0.474,594,824,0.721,434,1416,1850,960,385,638,924,4502
7348,2018-1-24,Golden State Warriors,48,11570,2090,4099,0.51,560,1429,0.392,1530,2670,0.573,824,1009,0.817,396,1723,2119,1472,389,732,953,5564
7349,2018-1-24,Houston Rockets,45,10850,1771,3850,0.46,707,1943,0.364,1064,1907,0.558,897,1132,0.792,438,1543,1981,1006,406,640,911,5146
7350,2018-1-24,Toronto Raptors,45,10850,1840,3932,0.468,502,1430,0.351,1338,2502,0.535,827,1029,0.804,439,1510,1949,1019,374,585,1007,5009
7351,2018-1-24,New Orleans Pelicans,46,11215,1909,3928,0.486,498,1356,0.367,1411,2572,0.549,800,1046,0.765,390,1594,1984,1211,350,698,897,5116
7352,2018-1-24,Cleveland Cavaliers,46,11065,1815,3846,0.472,546,1499,0.364,1269,2347,0.541,863,1077,0.801,390,1523,1913,1076,334,642,850,5039
7353,2018-1-24,Minnesota Timberwolves,49,11835,1991,4181,0.476,389,1101,0.353,1602,3080,0.52,966,1218,0.793,524,1527,2051,1111,436,594,883,5337
7354,2018-1-24,Philadelphia 76ers,43,10420,1716,3701,0.464,450,1253,0.359,1266,2448,0.517,769,1008,0.763,481,1556,2037,1109,359,755,1011,4651
7355,2018-1-24,Los Angeles Clippers,46,11065,1803,3891,0.463,479,1339,0.358,1324,2552,0.519,876,1165,0.752,469,1517,1986,997,363,668,965,4961
7356,2018-1-24,Los Angeles Lakers,47,11455,1917,4200,0.456,432,1311,0.33,1485,2889,0.514,745,1088,0.685,522,1652,2174,1110,397,741,1027,5011
7357,2018-1-24,Washington Wizards,47,11355,1862,4026,0.462,455,1230,0.37,1407,2796,0.503,828,1098,0.754,463,1561,2024,1088,366,638,1011,5007
7358,2018-1-24,Indiana Pacers,47,11330,1931,4044,0.477,435,1162,0.374,1496,2882,0.519,694,899,0.772,429,1548,1977,1038,369,602,874,4991
7359,2018-1-24,Denver Nuggets,47,11355,1850,4036,0.458,505,1418,0.356,1345,2618,0.514,775,1039,0.746,551,1577,2128,1099,370,711,838,4980
7360,2018-1-24,Charlotte Hornets,45,10850,1724,3898,0.442,418,1168,0.358,1306,2730,0.478,894,1228,0.728,467,1628,2095,934,302,570,799,4760
7361,2018-1-24,Brooklyn Nets,48,11595,1814,4154,0.437,573,1638,0.35,1241,2516,0.493,873,1149,0.76,484,1705,2189,1078,295,709,998,5074
7362,2018-1-24,Phoenix Suns,47,11305,1809,4069,0.445,440,1286,0.342,1369,2783,0.492,898,1179,0.762,515,1575,2090,998,320,713,1029,4956
7363,2018-1-24,Oklahoma City Thunder,47,11380,1865,4108,0.454,482,1359,0.355,1383,2749,0.503,740,1054,0.702,585,1529,2114,988,440,640,956,4952
7364,2018-1-24,Orlando Magic,47,11305,1858,4073,0.456,481,1370,0.351,1377,2703,0.509,741,979,0.757,428,1541,1969,1096,337,671,932,4938
7365,2018-1-24,Milwaukee Bucks,46,11090,1790,3734,0.479,391,1124,0.348,1399,2610,0.536,849,1104,0.769,358,1409,1767,1027,394,601,1036,4820
7366,2018-1-24,New York Knicks,48,11645,1939,4124,0.47,384,1039,0.37,1555,3085,0.504,764,959,0.797,500,1621,2121,1106,326,714,1007,5026
7367,2018-1-24,Portland Trail Blazers,47,11330,1832,4052,0.452,461,1227,0.376,1371,2825,0.485,769,965,0.797,465,1626,2091,891,325,639,940,4894
7368,2018-1-24,Chicago Bulls,47,11455,1843,4163,0.443,517,1435,0.36,1326,2728,0.486,671,876,0.766,426,1684,2110,1128,335,626,906,4874
7369,2018-1-24,Atlanta Hawks,46,11065,1769,3919,0.451,499,1352,0.369,1270,2567,0.495,727,921,0.789,449,1439,1888,1097,379,688,926,4764
7370,2018-1-24,Boston Celtics,48,11570,1814,4047,0.448,553,1519,0.364,1261,2528,0.499,746,976,0.764,434,1695,2129,1054,358,643,967,4927
7371,2018-1-24,Dallas Mavericks,47,11330,1791,3972,0.451,547,1498,0.365,1244,2474,0.503,690,891,0.774,353,1547,1900,1053,321,560,917,4819
7372,2018-1-24,Detroit Pistons,45,10800,1741,3870,0.45,485,1274,0.381,1256,2596,0.484,636,844,0.754,445,1444,1889,998,351,589,831,4603
7373,2018-1-24,Utah Jazz,47,11305,1752,3877,0.452,512,1405,0.364,1240,2472,0.502,759,950,0.799,401,1528,1929,986,430,656,935,4775
7374,2018-1-24,San Antonio Spurs,49,11760,1871,4110,0.455,436,1198,0.364,1435,2912,0.493,766,987,0.776,493,1684,2177,1079,368,656,829,4944
7375,2018-1-24,Miami Heat,47,11330,1773,3882,0.457,529,1452,0.364,1244,2430,0.512,669,879,0.761,395,1579,1974,1026,332,668,942,4744
7376,2018-1-24,Memphis Grizzlies,46,11065,1658,3733,0.444,439,1245,0.353,1219,2488,0.49,829,1045,0.793,418,1436,1854,952,346,621,1067,4584
7377,2018-1-24,Sacramento Kings,47,11305,1798,3990,0.451,406,1068,0.38,1392,2922,0.476,605,837,0.723,445,1449,1894,984,394,652,939,4607
7378,2018-1-25,Golden State Warriors,48,11570,2090,4099,0.51,560,1429,0.392,1530,2670,0.573,824,1009,0.817,396,1723,2119,1472,389,732,953,5564
7379,2018-1-25,Houston Rockets,46,11090,1807,3932,0.46,728,1994,0.365,1079,1938,0.557,908,1155,0.786,445,1579,2024,1026,414,649,930,5250
7380,2018-1-25,Toronto Raptors,46,11090,1879,4021,0.467,516,1466,0.352,1363,2555,0.533,843,1054,0.8,451,1550,2001,1044,384,602,1029,5117
7381,2018-1-25,New Orleans Pelicans,47,11455,1948,4015,0.485,507,1382,0.367,1441,2633,0.547,814,1064,0.765,398,1628,2026,1237,356,713,916,5217
7382,2018-1-25,Cleveland Cavaliers,46,11065,1815,3846,0.472,546,1499,0.364,1269,2347,0.541,863,1077,0.801,390,1523,1913,1076,334,642,850,5039
7383,2018-1-25,Minnesota Timberwolves,50,12075,2036,4265,0.477,395,1117,0.354,1641,3148,0.521,984,1240,0.794,529,1555,2084,1131,443,600,897,5451
7384,2018-1-25,Philadelphia 76ers,44,10660,1758,3782,0.465,466,1285,0.363,1292,2497,0.517,784,1028,0.763,487,1598,2085,1140,365,769,1031,4766
7385,2018-1-25,Los Angeles Clippers,47,11305,1838,3970,0.463,484,1360,0.356,1354,2610,0.519,903,1204,0.75,479,1547,2026,1023,369,687,980,5063
7386,2018-1-25,Los Angeles Lakers,47,11455,1917,4200,0.456,432,1311,0.33,1485,2889,0.514,745,1088,0.685,522,1652,2174,1110,397,741,1027,5011
7387,2018-1-25,Washington Wizards,47,11355,1862,4026,0.462,455,1230,0.37,1407,2796,0.503,828,1098,0.754,463,1561,2024,1088,366,638,1011,5007
7388,2018-1-25,Indiana Pacers,48,11570,1976,4124,0.479,444,1186,0.374,1532,2938,0.521,711,924,0.769,432,1584,2016,1070,380,614,898,5107
7389,2018-1-25,Denver Nuggets,47,11355,1850,4036,0.458,505,1418,0.356,1345,2618,0.514,775,1039,0.746,551,1577,2128,1099,370,711,838,4980
7390,2018-1-25,Brooklyn Nets,48,11595,1814,4154,0.437,573,1638,0.35,1241,2516,0.493,873,1149,0.76,484,1705,2189,1078,295,709,998,5074
7391,2018-1-25,Charlotte Hornets,46,11090,1760,3983,0.442,424,1189,0.357,1336,2794,0.478,912,1259,0.724,477,1667,2144,950,307,584,822,4856
7392,2018-1-25,Phoenix Suns,48,11545,1844,4153,0.444,449,1321,0.34,1395,2832,0.493,920,1208,0.762,525,1607,2132,1020,323,729,1055,5057
7393,2018-1-25,Oklahoma City Thunder,47,11380,1865,4108,0.454,482,1359,0.355,1383,2749,0.503,740,1054,0.702,585,1529,2114,988,440,640,956,4952
7394,2018-1-25,Orlando Magic,47,11305,1858,4073,0.456,481,1370,0.351,1377,2703,0.509,741,979,0.757,428,1541,1969,1096,337,671,932,4938
7395,2018-1-25,Milwaukee Bucks,46,11090,1790,3734,0.479,391,1124,0.348,1399,2610,0.536,849,1104,0.769,358,1409,1767,1027,394,601,1036,4820
7396,2018-1-25,New York Knicks,48,11645,1939,4124,0.47,384,1039,0.37,1555,3085,0.504,764,959,0.797,500,1621,2121,1106,326,714,1007,5026
7397,2018-1-25,Portland Trail Blazers,48,11570,1877,4134,0.454,478,1258,0.38,1399,2876,0.486,785,986,0.796,471,1657,2128,915,329,649,956,5017
7398,2018-1-25,Chicago Bulls,48,11695,1879,4257,0.441,528,1472,0.359,1351,2785,0.485,689,898,0.767,436,1717,2153,1148,343,637,921,4975
7399,2018-1-25,Atlanta Hawks,47,11305,1806,4013,0.45,506,1373,0.369,1300,2640,0.492,739,938,0.788,461,1474,1935,1116,387,704,947,4857
7400,2018-1-25,Boston Celtics,49,11810,1853,4140,0.448,567,1559,0.364,1286,2581,0.498,767,998,0.769,444,1732,2176,1079,368,656,995,5040
7401,2018-1-25,Dallas Mavericks,48,11570,1826,4054,0.45,562,1533,0.367,1264,2521,0.501,702,909,0.772,362,1587,1949,1077,326,573,938,4916
7402,2018-1-25,Detroit Pistons,46,11065,1779,3967,0.448,492,1305,0.377,1287,2662,0.483,648,862,0.752,460,1486,1946,1021,361,608,847,4698
7403,2018-1-25,Utah Jazz,48,11570,1790,3973,0.451,522,1436,0.364,1268,2537,0.5,771,966,0.798,410,1563,1973,1010,441,670,950,4873
7404,2018-1-25,San Antonio Spurs,50,12000,1909,4192,0.455,446,1222,0.365,1463,2970,0.493,788,1012,0.779,504,1718,2222,1108,377,669,848,5052
7405,2018-1-25,Miami Heat,47,11330,1773,3882,0.457,529,1452,0.364,1244,2430,0.512,669,879,0.761,395,1579,1974,1026,332,668,942,4744
7406,2018-1-25,Memphis Grizzlies,47,11305,1694,3816,0.444,441,1263,0.349,1253,2553,0.491,840,1059,0.793,427,1468,1895,971,353,638,1092,4669
7407,2018-1-25,Sacramento Kings,47,11305,1798,3990,0.451,406,1068,0.38,1392,2922,0.476,605,837,0.723,445,1449,1894,984,394,652,939,4607
7408,2018-1-26,Golden State Warriors,49,11810,2138,4188,0.511,581,1466,0.396,1557,2722,0.572,833,1024,0.813,407,1759,2166,1509,398,747,970,5690
7409,2018-1-26,Houston Rockets,46,11090,1807,3932,0.46,728,1994,0.365,1079,1938,0.557,908,1155,0.786,445,1579,2024,1026,414,649,930,5250
7410,2018-1-26,Toronto Raptors,46,11090,1879,4021,0.467,516,1466,0.352,1363,2555,0.533,843,1054,0.8,451,1550,2001,1044,384,602,1029,5117
7411,2018-1-26,New Orleans Pelicans,47,11455,1948,4015,0.485,507,1382,0.367,1441,2633,0.547,814,1064,0.765,398,1628,2026,1237,356,713,916,5217
7412,2018-1-26,Cleveland Cavaliers,46,11065,1815,3846,0.472,546,1499,0.364,1269,2347,0.541,863,1077,0.801,390,1523,1913,1076,334,642,850,5039
7413,2018-1-26,Minnesota Timberwolves,51,12315,2082,4366,0.477,401,1137,0.353,1681,3229,0.521,999,1258,0.794,542,1585,2127,1156,452,610,912,5564
7414,2018-1-26,Philadelphia 76ers,44,10660,1758,3782,0.465,466,1285,0.363,1292,2497,0.517,784,1028,0.763,487,1598,2085,1140,365,769,1031,4766
7415,2018-1-26,Los Angeles Clippers,47,11305,1838,3970,0.463,484,1360,0.356,1354,2610,0.519,903,1204,0.75,479,1547,2026,1023,369,687,980,5063
7416,2018-1-26,Los Angeles Lakers,47,11455,1917,4200,0.456,432,1311,0.33,1485,2889,0.514,745,1088,0.685,522,1652,2174,1110,397,741,1027,5011
7417,2018-1-26,Washington Wizards,48,11595,1904,4112,0.463,471,1265,0.372,1433,2847,0.503,840,1114,0.754,475,1588,2063,1113,376,661,1036,5119
7418,2018-1-26,Denver Nuggets,48,11595,1898,4116,0.461,519,1446,0.359,1379,2670,0.516,795,1063,0.748,553,1607,2160,1135,373,724,858,5110
7419,2018-1-26,Indiana Pacers,48,11570,1976,4124,0.479,444,1186,0.374,1532,2938,0.521,711,924,0.769,432,1584,2016,1070,380,614,898,5107
7420,2018-1-26,Brooklyn Nets,48,11595,1814,4154,0.437,573,1638,0.35,1241,2516,0.493,873,1149,0.76,484,1705,2189,1078,295,709,998,5074
7421,2018-1-26,Oklahoma City Thunder,48,11620,1910,4195,0.455,491,1386,0.354,1419,2809,0.505,762,1083,0.704,598,1556,2154,1006,456,654,971,5073
7422,2018-1-26,Charlotte Hornets,46,11090,1760,3983,0.442,424,1189,0.357,1336,2794,0.478,912,1259,0.724,477,1667,2144,950,307,584,822,4856
7423,2018-1-26,Phoenix Suns,48,11545,1844,4153,0.444,449,1321,0.34,1395,2832,0.493,920,1208,0.762,525,1607,2132,1020,323,729,1055,5057
7424,2018-1-26,Orlando Magic,47,11305,1858,4073,0.456,481,1370,0.351,1377,2703,0.509,741,979,0.757,428,1541,1969,1096,337,671,932,4938
7425,2018-1-26,New York Knicks,49,11885,1984,4206,0.472,392,1060,0.37,1592,3146,0.506,784,983,0.798,503,1651,2154,1138,335,724,1027,5144
7426,2018-1-26,Milwaukee Bucks,46,11090,1790,3734,0.479,391,1124,0.348,1399,2610,0.536,849,1104,0.769,358,1409,1767,1027,394,601,1036,4820
7427,2018-1-26,Portland Trail Blazers,48,11570,1877,4134,0.454,478,1258,0.38,1399,2876,0.486,785,986,0.796,471,1657,2128,915,329,649,956,5017
7428,2018-1-26,Chicago Bulls,48,11695,1879,4257,0.441,528,1472,0.359,1351,2785,0.485,689,898,0.767,436,1717,2153,1148,343,637,921,4975
7429,2018-1-26,Atlanta Hawks,47,11305,1806,4013,0.45,506,1373,0.369,1300,2640,0.492,739,938,0.788,461,1474,1935,1116,387,704,947,4857
7430,2018-1-26,Boston Celtics,49,11810,1853,4140,0.448,567,1559,0.364,1286,2581,0.498,767,998,0.769,444,1732,2176,1079,368,656,995,5040
7431,2018-1-26,Dallas Mavericks,48,11570,1826,4054,0.45,562,1533,0.367,1264,2521,0.501,702,909,0.772,362,1587,1949,1077,326,573,938,4916
7432,2018-1-26,Detroit Pistons,46,11065,1779,3967,0.448,492,1305,0.377,1287,2662,0.483,648,862,0.752,460,1486,1946,1021,361,608,847,4698
7433,2018-1-26,Utah Jazz,48,11570,1790,3973,0.451,522,1436,0.364,1268,2537,0.5,771,966,0.798,410,1563,1973,1010,441,670,950,4873
7434,2018-1-26,San Antonio Spurs,50,12000,1909,4192,0.455,446,1222,0.365,1463,2970,0.493,788,1012,0.779,504,1718,2222,1108,377,669,848,5052
7435,2018-1-26,Miami Heat,48,11570,1804,3964,0.455,541,1486,0.364,1263,2478,0.51,683,897,0.761,402,1618,2020,1045,340,681,961,4832
7436,2018-1-26,Memphis Grizzlies,47,11305,1694,3816,0.444,441,1263,0.349,1253,2553,0.491,840,1059,0.793,427,1468,1895,971,353,638,1092,4669
7437,2018-1-26,Sacramento Kings,48,11545,1836,4071,0.451,411,1080,0.381,1425,2991,0.476,613,851,0.72,450,1482,1932,1001,397,665,960,4696
7438,2018-1-27,Golden State Warriors,49,11810,2138,4188,0.511,581,1466,0.396,1557,2722,0.572,833,1024,0.813,407,1759,2166,1509,398,747,970,5690
7439,2018-1-27,Houston Rockets,47,11330,1843,4010,0.46,740,2030,0.365,1103,1980,0.557,937,1190,0.787,447,1612,2059,1048,424,661,953,5363
7440,2018-1-27,New Orleans Pelicans,48,11695,1992,4097,0.486,518,1409,0.368,1474,2688,0.548,830,1085,0.765,404,1664,2068,1273,364,728,942,5332
7441,2018-1-27,Toronto Raptors,47,11330,1916,4116,0.466,523,1493,0.35,1393,2623,0.531,855,1071,0.798,467,1586,2053,1067,394,613,1047,5210
7442,2018-1-27,Cleveland Cavaliers,47,11305,1861,3928,0.474,559,1536,0.364,1302,2392,0.544,873,1090,0.801,398,1559,1957,1103,347,662,861,5154
7443,2018-1-27,Minnesota Timberwolves,51,12315,2082,4366,0.477,401,1137,0.353,1681,3229,0.521,999,1258,0.794,542,1585,2127,1156,452,610,912,5564
7444,2018-1-27,Philadelphia 76ers,45,10900,1796,3861,0.465,475,1306,0.364,1321,2555,0.517,796,1046,0.761,499,1636,2135,1163,370,778,1051,4863
7445,2018-1-27,Los Angeles Clippers,48,11545,1877,4050,0.463,494,1387,0.356,1383,2663,0.519,924,1233,0.749,482,1580,2062,1046,384,697,1000,5172
7446,2018-1-27,Los Angeles Lakers,48,11695,1958,4291,0.456,437,1335,0.327,1521,2956,0.515,766,1116,0.686,532,1690,2222,1133,403,750,1050,5119
7447,2018-1-27,Washington Wizards,48,11595,1904,4112,0.463,471,1265,0.372,1433,2847,0.503,840,1114,0.754,475,1588,2063,1113,376,661,1036,5119
7448,2018-1-27,Denver Nuggets,48,11595,1898,4116,0.461,519,1446,0.359,1379,2670,0.516,795,1063,0.748,553,1607,2160,1135,373,724,858,5110
7449,2018-1-27,Indiana Pacers,49,11810,2019,4215,0.479,457,1217,0.376,1562,2998,0.521,720,935,0.77,440,1613,2053,1097,393,630,913,5215
7450,2018-1-27,Charlotte Hornets,47,11330,1800,4071,0.442,437,1223,0.357,1363,2848,0.479,940,1291,0.728,488,1699,2187,975,320,595,847,4977
7451,2018-1-27,Oklahoma City Thunder,48,11620,1910,4195,0.455,491,1386,0.354,1419,2809,0.505,762,1083,0.704,598,1556,2154,1006,456,654,971,5073
7452,2018-1-27,Brooklyn Nets,49,11835,1847,4243,0.435,581,1672,0.347,1266,2571,0.492,890,1169,0.761,495,1739,2234,1096,300,723,1017,5165
7453,2018-1-27,Orlando Magic,47,11305,1858,4073,0.456,481,1370,0.351,1377,2703,0.509,741,979,0.757,428,1541,1969,1096,337,671,932,4938
7454,2018-1-27,Milwaukee Bucks,47,11330,1833,3817,0.48,403,1147,0.351,1430,2670,0.536,867,1124,0.771,361,1450,1811,1055,403,610,1053,4936
7455,2018-1-27,New York Knicks,50,12125,2025,4291,0.472,401,1085,0.37,1624,3206,0.507,800,1005,0.796,513,1690,2203,1163,342,740,1047,5251
7456,2018-1-27,Phoenix Suns,49,11785,1877,4247,0.442,460,1354,0.34,1417,2893,0.49,928,1221,0.76,537,1637,2174,1035,329,743,1079,5142
7457,2018-1-27,Portland Trail Blazers,49,11810,1916,4213,0.455,488,1288,0.379,1428,2925,0.488,804,1009,0.797,481,1701,2182,935,333,663,973,5124
7458,2018-1-27,Chicago Bulls,49,11935,1914,4350,0.44,545,1508,0.361,1369,2842,0.482,705,922,0.765,452,1754,2206,1169,346,650,946,5078
7459,2018-1-27,Atlanta Hawks,48,11545,1843,4092,0.45,521,1403,0.371,1322,2689,0.492,760,963,0.789,467,1507,1974,1139,393,724,973,4967
7460,2018-1-27,Boston Celtics,49,11810,1853,4140,0.448,567,1559,0.364,1286,2581,0.498,767,998,0.769,444,1732,2176,1079,368,656,995,5040
7461,2018-1-27,Dallas Mavericks,49,11810,1861,4143,0.449,572,1563,0.366,1289,2580,0.5,715,926,0.772,370,1616,1986,1094,335,578,957,5009
7462,2018-1-27,Detroit Pistons,46,11065,1779,3967,0.448,492,1305,0.377,1287,2662,0.483,648,862,0.752,460,1486,1946,1021,361,608,847,4698
7463,2018-1-27,Utah Jazz,49,11810,1826,4060,0.45,532,1457,0.365,1294,2603,0.497,786,987,0.796,420,1600,2020,1030,448,683,966,4970
7464,2018-1-27,Miami Heat,48,11570,1804,3964,0.455,541,1486,0.364,1263,2478,0.51,683,897,0.761,402,1618,2020,1045,340,681,961,4832
7465,2018-1-27,San Antonio Spurs,51,12240,1939,4267,0.454,449,1246,0.36,1490,3021,0.493,803,1030,0.78,509,1749,2258,1128,383,678,862,5130
7466,2018-1-27,Memphis Grizzlies,48,11545,1733,3897,0.445,449,1290,0.348,1284,2607,0.493,854,1077,0.793,435,1503,1938,1002,354,657,1116,4769
7467,2018-1-27,Sacramento Kings,48,11545,1836,4071,0.451,411,1080,0.381,1425,2991,0.476,613,851,0.72,450,1482,1932,1001,397,665,960,4696
7468,2018-1-28,Golden State Warriors,50,12050,2176,4272,0.509,591,1493,0.396,1585,2779,0.57,856,1050,0.815,417,1792,2209,1528,407,758,987,5799
7469,2018-1-28,Houston Rockets,47,11330,1843,4010,0.46,740,2030,0.365,1103,1980,0.557,937,1190,0.787,447,1612,2059,1048,424,661,953,5363
7470,2018-1-28,New Orleans Pelicans,48,11695,1992,4097,0.486,518,1409,0.368,1474,2688,0.548,830,1085,0.765,404,1664,2068,1273,364,728,942,5332
7471,2018-1-28,Toronto Raptors,47,11330,1916,4116,0.466,523,1493,0.35,1393,2623,0.531,855,1071,0.798,467,1586,2053,1067,394,613,1047,5210
7472,2018-1-28,Cleveland Cavaliers,47,11305,1861,3928,0.474,559,1536,0.364,1302,2392,0.544,873,1090,0.801,398,1559,1957,1103,347,662,861,5154
7473,2018-1-28,Minnesota Timberwolves,52,12555,2124,4462,0.476,405,1158,0.35,1719,3304,0.52,1022,1284,0.796,558,1618,2176,1176,461,615,924,5675
7474,2018-1-28,Philadelphia 76ers,45,10900,1796,3861,0.465,475,1306,0.364,1321,2555,0.517,796,1046,0.761,499,1636,2135,1163,370,778,1051,4863
7475,2018-1-28,Los Angeles Clippers,48,11545,1877,4050,0.463,494,1387,0.356,1383,2663,0.519,924,1233,0.749,482,1580,2062,1046,384,697,1000,5172
7476,2018-1-28,Washington Wizards,49,11835,1953,4197,0.465,489,1297,0.377,1464,2900,0.505,853,1128,0.756,482,1619,2101,1153,383,673,1057,5248
7477,2018-1-28,Los Angeles Lakers,48,11695,1958,4291,0.456,437,1335,0.327,1521,2956,0.515,766,1116,0.686,532,1690,2222,1133,403,750,1050,5119
7478,2018-1-28,Indiana Pacers,50,12050,2066,4302,0.48,462,1235,0.374,1604,3067,0.523,735,954,0.77,449,1642,2091,1122,402,639,937,5329
7479,2018-1-28,Denver Nuggets,49,11835,1932,4197,0.46,531,1479,0.359,1401,2718,0.515,806,1078,0.748,562,1651,2213,1158,379,738,879,5201
7480,2018-1-28,Oklahoma City Thunder,49,11860,1955,4288,0.456,505,1419,0.356,1450,2869,0.505,779,1106,0.704,611,1586,2197,1029,465,663,991,5194
7481,2018-1-28,Charlotte Hornets,48,11570,1829,4155,0.44,442,1247,0.354,1387,2908,0.477,968,1326,0.73,500,1733,2233,987,326,602,862,5068
7482,2018-1-28,Orlando Magic,48,11545,1900,4150,0.458,489,1395,0.351,1411,2755,0.512,761,1011,0.753,441,1568,2009,1117,343,685,950,5050
7483,2018-1-28,Brooklyn Nets,50,12075,1885,4325,0.436,590,1702,0.347,1295,2623,0.494,902,1184,0.762,506,1771,2277,1118,303,738,1036,5262
7484,2018-1-28,Milwaukee Bucks,47,11330,1833,3817,0.48,403,1147,0.351,1430,2670,0.536,867,1124,0.771,361,1450,1811,1055,403,610,1053,4936
7485,2018-1-28,New York Knicks,50,12125,2025,4291,0.472,401,1085,0.37,1624,3206,0.507,800,1005,0.796,513,1690,2203,1163,342,740,1047,5251
7486,2018-1-28,Phoenix Suns,49,11785,1877,4247,0.442,460,1354,0.34,1417,2893,0.49,928,1221,0.76,537,1637,2174,1035,329,743,1079,5142
7487,2018-1-28,Portland Trail Blazers,49,11810,1916,4213,0.455,488,1288,0.379,1428,2925,0.488,804,1009,0.797,481,1701,2182,935,333,663,973,5124
7488,2018-1-28,Chicago Bulls,49,11935,1914,4350,0.44,545,1508,0.361,1369,2842,0.482,705,922,0.765,452,1754,2206,1169,346,650,946,5078
7489,2018-1-28,Atlanta Hawks,49,11785,1881,4180,0.45,533,1446,0.369,1348,2734,0.493,776,984,0.789,478,1528,2006,1163,395,736,988,5071
7490,2018-1-28,Boston Celtics,50,12050,1890,4225,0.447,581,1587,0.366,1309,2638,0.496,784,1022,0.767,455,1766,2221,1096,374,670,1018,5145
7491,2018-1-28,Detroit Pistons,47,11305,1818,4051,0.449,504,1338,0.377,1314,2713,0.484,666,886,0.752,473,1516,1989,1045,365,624,867,4806
7492,2018-1-28,Dallas Mavericks,50,12050,1895,4228,0.448,583,1594,0.366,1312,2634,0.498,725,945,0.767,378,1651,2029,1111,343,586,972,5098
7493,2018-1-28,Utah Jazz,49,11810,1826,4060,0.45,532,1457,0.365,1294,2603,0.497,786,987,0.796,420,1600,2020,1030,448,683,966,4970
7494,2018-1-28,San Antonio Spurs,51,12240,1939,4267,0.454,449,1246,0.36,1490,3021,0.493,803,1030,0.78,509,1749,2258,1128,383,678,862,5130
7495,2018-1-28,Miami Heat,49,11810,1842,4049,0.455,549,1512,0.363,1293,2537,0.51,694,915,0.758,413,1658,2071,1070,344,693,985,4927
7496,2018-1-28,Memphis Grizzlies,48,11545,1733,3897,0.445,449,1290,0.348,1284,2607,0.493,854,1077,0.793,435,1503,1938,1002,354,657,1116,4769
7497,2018-1-28,Sacramento Kings,48,11545,1836,4071,0.451,411,1080,0.381,1425,2991,0.476,613,851,0.72,450,1482,1932,1001,397,665,960,4696
7498,2018-1-29,Golden State Warriors,50,12050,2176,4272,0.509,591,1493,0.396,1585,2779,0.57,856,1050,0.815,417,1792,2209,1528,407,758,987,5799
7499,2018-1-29,Houston Rockets,48,11570,1875,4082,0.459,751,2067,0.363,1124,2015,0.558,975,1239,0.787,452,1650,2102,1065,432,673,974,5476
7500,2018-1-29,Toronto Raptors,48,11570,1962,4208,0.466,535,1524,0.351,1427,2684,0.532,874,1096,0.797,479,1627,2106,1090,398,627,1070,5333
7501,2018-1-29,New Orleans Pelicans,49,11935,2030,4182,0.485,527,1444,0.365,1503,2738,0.549,848,1110,0.764,411,1704,2115,1296,373,743,962,5435
7502,2018-1-29,Cleveland Cavaliers,48,11545,1903,4011,0.474,574,1571,0.365,1329,2440,0.545,895,1116,0.802,402,1600,2002,1130,349,672,875,5275
7503,2018-1-29,Minnesota Timberwolves,52,12555,2124,4462,0.476,405,1158,0.35,1719,3304,0.52,1022,1284,0.796,558,1618,2176,1176,461,615,924,5675
7504,2018-1-29,Philadelphia 76ers,46,11140,1834,3937,0.466,486,1335,0.364,1348,2602,0.518,821,1077,0.762,511,1664,2175,1182,377,792,1077,4975
7505,2018-1-29,Los Angeles Clippers,49,11785,1922,4146,0.464,503,1415,0.355,1419,2731,0.52,937,1251,0.749,493,1619,2112,1075,391,709,1019,5284
7506,2018-1-29,Washington Wizards,49,11835,1953,4197,0.465,489,1297,0.377,1464,2900,0.505,853,1128,0.756,482,1619,2101,1153,383,673,1057,5248
7507,2018-1-29,Los Angeles Lakers,49,11935,1998,4382,0.456,445,1360,0.327,1553,3022,0.514,789,1149,0.687,545,1721,2266,1155,412,764,1071,5230
7508,2018-1-29,Indiana Pacers,50,12050,2066,4302,0.48,462,1235,0.374,1604,3067,0.523,735,954,0.77,449,1642,2091,1122,402,639,937,5329
7509,2018-1-29,Oklahoma City Thunder,50,12100,2000,4380,0.457,515,1452,0.355,1485,2928,0.507,801,1136,0.705,628,1610,2238,1050,472,673,1016,5316
7510,2018-1-29,Denver Nuggets,49,11835,1932,4197,0.46,531,1479,0.359,1401,2718,0.515,806,1078,0.748,562,1651,2213,1158,379,738,879,5201
7511,2018-1-29,Charlotte Hornets,48,11570,1829,4155,0.44,442,1247,0.354,1387,2908,0.477,968,1326,0.73,500,1733,2233,987,326,602,862,5068
7512,2018-1-29,Orlando Magic,48,11545,1900,4150,0.458,489,1395,0.351,1411,2755,0.512,761,1011,0.753,441,1568,2009,1117,343,685,950,5050
7513,2018-1-29,Brooklyn Nets,50,12075,1885,4325,0.436,590,1702,0.347,1295,2623,0.494,902,1184,0.762,506,1771,2277,1118,303,738,1036,5262
7514,2018-1-29,Milwaukee Bucks,48,11570,1874,3894,0.481,416,1175,0.354,1458,2719,0.536,882,1149,0.768,368,1486,1854,1083,414,624,1069,5046
7515,2018-1-29,New York Knicks,50,12125,2025,4291,0.472,401,1085,0.37,1624,3206,0.507,800,1005,0.796,513,1690,2203,1163,342,740,1047,5251
7516,2018-1-29,Phoenix Suns,50,12025,1913,4332,0.442,468,1387,0.337,1445,2945,0.491,950,1247,0.762,544,1673,2217,1052,336,755,1108,5244
7517,2018-1-29,Portland Trail Blazers,49,11810,1916,4213,0.455,488,1288,0.379,1428,2925,0.488,804,1009,0.797,481,1701,2182,935,333,663,973,5124
7518,2018-1-29,Atlanta Hawks,49,11785,1881,4180,0.45,533,1446,0.369,1348,2734,0.493,776,984,0.789,478,1528,2006,1163,395,736,988,5071
7519,2018-1-29,Chicago Bulls,50,12175,1950,4437,0.439,557,1542,0.361,1393,2895,0.481,717,937,0.765,462,1785,2247,1194,354,666,964,5174
7520,2018-1-29,Boston Celtics,50,12050,1890,4225,0.447,581,1587,0.366,1309,2638,0.496,784,1022,0.767,455,1766,2221,1096,374,670,1018,5145
7521,2018-1-29,Detroit Pistons,48,11545,1858,4146,0.448,518,1374,0.377,1340,2772,0.483,676,899,0.752,480,1552,2032,1076,370,630,890,4910
7522,2018-1-29,Dallas Mavericks,50,12050,1895,4228,0.448,583,1594,0.366,1312,2634,0.498,725,945,0.767,378,1651,2029,1111,343,586,972,5098
7523,2018-1-29,Utah Jazz,49,11810,1826,4060,0.45,532,1457,0.365,1294,2603,0.497,786,987,0.796,420,1600,2020,1030,448,683,966,4970
7524,2018-1-29,San Antonio Spurs,52,12480,1984,4357,0.455,460,1271,0.362,1524,3086,0.494,815,1047,0.778,522,1788,2310,1161,387,685,875,5243
7525,2018-1-29,Miami Heat,49,11810,1842,4049,0.455,549,1512,0.363,1293,2537,0.51,694,915,0.758,413,1658,2071,1070,344,693,985,4927
7526,2018-1-29,Memphis Grizzlies,48,11545,1733,3897,0.445,449,1290,0.348,1284,2607,0.493,854,1077,0.793,435,1503,1938,1002,354,657,1116,4769
7527,2018-1-29,Sacramento Kings,49,11785,1871,4153,0.451,429,1114,0.385,1442,3039,0.474,623,862,0.723,456,1510,1966,1022,402,674,980,4794
7528,2018-1-30,Golden State Warriors,50,12050,2176,4272,0.509,591,1493,0.396,1585,2779,0.57,856,1050,0.815,417,1792,2209,1528,407,758,987,5799
7529,2018-1-30,Houston Rockets,48,11570,1875,4082,0.459,751,2067,0.363,1124,2015,0.558,975,1239,0.787,452,1650,2102,1065,432,673,974,5476
7530,2018-1-30,Toronto Raptors,48,11570,1962,4208,0.466,535,1524,0.351,1427,2684,0.532,874,1096,0.797,479,1627,2106,1090,398,627,1070,5333
7531,2018-1-30,New Orleans Pelicans,49,11935,2030,4182,0.485,527,1444,0.365,1503,2738,0.549,848,1110,0.764,411,1704,2115,1296,373,743,962,5435
7532,2018-1-30,Cleveland Cavaliers,48,11545,1903,4011,0.474,574,1571,0.365,1329,2440,0.545,895,1116,0.802,402,1600,2002,1130,349,672,875,5275
7533,2018-1-30,Minnesota Timberwolves,53,12795,2163,4545,0.476,412,1177,0.35,1751,3368,0.52,1037,1302,0.796,565,1646,2211,1200,476,628,942,5775
7534,2018-1-30,Philadelphia 76ers,47,11380,1870,4019,0.465,488,1361,0.359,1382,2658,0.52,842,1100,0.765,521,1697,2218,1204,382,806,1094,5070
7535,2018-1-30,Los Angeles Clippers,49,11785,1922,4146,0.464,503,1415,0.355,1419,2731,0.52,937,1251,0.749,493,1619,2112,1075,391,709,1019,5284
7536,2018-1-30,Washington Wizards,49,11835,1953,4197,0.465,489,1297,0.377,1464,2900,0.505,853,1128,0.756,482,1619,2101,1153,383,673,1057,5248
7537,2018-1-30,Los Angeles Lakers,49,11935,1998,4382,0.456,445,1360,0.327,1553,3022,0.514,789,1149,0.687,545,1721,2266,1155,412,764,1071,5230
7538,2018-1-30,Indiana Pacers,51,12290,2111,4385,0.481,468,1256,0.373,1643,3129,0.525,744,965,0.771,455,1674,2129,1150,409,651,956,5434
7539,2018-1-30,Oklahoma City Thunder,50,12100,2000,4380,0.457,515,1452,0.355,1485,2928,0.507,801,1136,0.705,628,1610,2238,1050,472,673,1016,5316
7540,2018-1-30,Denver Nuggets,50,12075,1974,4290,0.46,541,1512,0.358,1433,2778,0.516,822,1099,0.748,577,1683,2260,1189,383,748,893,5311
7541,2018-1-30,Charlotte Hornets,49,11810,1866,4238,0.44,451,1278,0.353,1415,2960,0.478,981,1346,0.729,511,1762,2273,1005,331,618,876,5164
7542,2018-1-30,Milwaukee Bucks,49,11810,1912,3974,0.481,427,1203,0.355,1485,2771,0.536,902,1171,0.77,376,1520,1896,1109,420,633,1088,5153
7543,2018-1-30,Orlando Magic,48,11545,1900,4150,0.458,489,1395,0.351,1411,2755,0.512,761,1011,0.753,441,1568,2009,1117,343,685,950,5050
7544,2018-1-30,Brooklyn Nets,50,12075,1885,4325,0.436,590,1702,0.347,1295,2623,0.494,902,1184,0.762,506,1771,2277,1118,303,738,1036,5262
7545,2018-1-30,Phoenix Suns,51,12265,1951,4414,0.442,475,1410,0.337,1476,3004,0.491,976,1283,0.761,559,1695,2254,1072,347,774,1128,5353
7546,2018-1-30,New York Knicks,50,12125,2025,4291,0.472,401,1085,0.37,1624,3206,0.507,800,1005,0.796,513,1690,2203,1163,342,740,1047,5251
7547,2018-1-30,Portland Trail Blazers,49,11810,1916,4213,0.455,488,1288,0.379,1428,2925,0.488,804,1009,0.797,481,1701,2182,935,333,663,973,5124
7548,2018-1-30,Atlanta Hawks,50,12025,1920,4259,0.451,546,1480,0.369,1374,2779,0.494,790,1000,0.79,486,1564,2050,1190,403,757,1006,5176
7549,2018-1-30,Chicago Bulls,50,12175,1950,4437,0.439,557,1542,0.361,1393,2895,0.481,717,937,0.765,462,1785,2247,1194,354,666,964,5174
7550,2018-1-30,Boston Celtics,51,12290,1933,4316,0.448,598,1623,0.368,1335,2693,0.496,792,1032,0.767,465,1796,2261,1124,378,679,1037,5256
7551,2018-1-30,Detroit Pistons,48,11545,1858,4146,0.448,518,1374,0.377,1340,2772,0.483,676,899,0.752,480,1552,2032,1076,370,630,890,4910
7552,2018-1-30,Dallas Mavericks,51,12290,1928,4314,0.447,591,1623,0.364,1337,2691,0.497,739,961,0.769,389,1680,2069,1131,353,598,994,5186
7553,2018-1-30,Utah Jazz,49,11810,1826,4060,0.45,532,1457,0.365,1294,2603,0.497,786,987,0.796,420,1600,2020,1030,448,683,966,4970
7554,2018-1-30,San Antonio Spurs,52,12480,1984,4357,0.455,460,1271,0.362,1524,3086,0.494,815,1047,0.778,522,1788,2310,1161,387,685,875,5243
7555,2018-1-30,Miami Heat,50,12050,1876,4124,0.455,561,1543,0.364,1315,2581,0.509,709,934,0.759,424,1688,2112,1093,353,709,1004,5022
7556,2018-1-30,Memphis Grizzlies,49,11785,1780,3980,0.447,460,1312,0.351,1320,2668,0.495,869,1095,0.794,447,1529,1976,1031,361,677,1143,4889
7557,2018-1-30,Sacramento Kings,49,11785,1871,4153,0.451,429,1114,0.385,1442,3039,0.474,623,862,0.723,456,1510,1966,1022,402,674,980,4794
7558,2018-2-1,Golden State Warriors,51,12290,2215,4357,0.508,596,1518,0.393,1619,2839,0.57,872,1071,0.814,428,1818,2246,1555,417,777,1003,5898
7559,2018-2-1,Houston Rockets,49,11810,1914,4159,0.46,764,2102,0.363,1150,2057,0.559,998,1267,0.788,460,1682,2142,1082,437,685,989,5590
7560,2018-2-1,Toronto Raptors,49,11810,2001,4289,0.467,544,1553,0.35,1457,2736,0.533,896,1122,0.799,488,1657,2145,1118,401,635,1088,5442
7561,2018-2-1,New Orleans Pelicans,50,12175,2069,4259,0.486,536,1469,0.365,1533,2790,0.549,864,1132,0.763,413,1738,2151,1322,380,758,980,5538
7562,2018-2-1,Cleveland Cavaliers,50,12025,1969,4175,0.472,593,1632,0.363,1376,2543,0.541,949,1186,0.8,416,1672,2088,1172,360,703,917,5480
7563,2018-2-1,Minnesota Timberwolves,54,13035,2205,4630,0.476,417,1189,0.351,1788,3441,0.52,1052,1326,0.793,575,1676,2251,1221,480,636,961,5879
7564,2018-2-1,Philadelphia 76ers,48,11620,1906,4095,0.465,495,1379,0.359,1411,2716,0.52,871,1134,0.768,527,1724,2251,1221,389,814,1115,5178
7565,2018-2-1,Los Angeles Clippers,50,12025,1957,4231,0.463,509,1437,0.354,1448,2794,0.518,957,1277,0.749,502,1660,2162,1097,396,722,1036,5380
7566,2018-2-1,Washington Wizards,50,12075,1987,4286,0.464,496,1322,0.375,1491,2964,0.503,880,1157,0.761,489,1655,2144,1180,391,685,1085,5350
7567,2018-2-1,Los Angeles Lakers,50,12175,2037,4465,0.456,449,1380,0.325,1588,3085,0.515,812,1179,0.689,556,1753,2309,1173,419,780,1089,5335
7568,2018-2-1,Indiana Pacers,52,12530,2148,4455,0.482,478,1282,0.373,1670,3173,0.526,765,996,0.768,463,1699,2162,1170,425,665,971,5539
7569,2018-2-1,Denver Nuggets,51,12315,2014,4376,0.46,551,1535,0.359,1463,2841,0.515,836,1113,0.751,587,1711,2298,1211,394,761,907,5415
7570,2018-2-1,Oklahoma City Thunder,51,12340,2030,4460,0.455,524,1484,0.353,1506,2976,0.506,828,1170,0.708,642,1648,2290,1069,479,693,1040,5412
7571,2018-2-1,Orlando Magic,50,12025,1986,4314,0.46,522,1458,0.358,1464,2856,0.513,790,1050,0.752,452,1625,2077,1171,362,709,995,5284
7572,2018-2-1,Charlotte Hornets,50,12050,1912,4328,0.442,468,1310,0.357,1444,3018,0.478,995,1364,0.729,523,1792,2315,1034,337,628,897,5287
7573,2018-2-1,Brooklyn Nets,52,12555,1960,4489,0.437,612,1771,0.346,1348,2718,0.496,941,1228,0.766,526,1839,2365,1152,312,766,1083,5473
7574,2018-2-1,Milwaukee Bucks,49,11810,1912,3974,0.481,427,1203,0.355,1485,2771,0.536,902,1171,0.77,376,1520,1896,1109,420,633,1088,5153
7575,2018-2-1,Portland Trail Blazers,51,12290,1998,4393,0.455,516,1350,0.382,1482,3043,0.487,840,1051,0.799,504,1785,2289,977,348,692,1013,5352
7576,2018-2-1,Phoenix Suns,52,12505,1991,4497,0.443,486,1440,0.338,1505,3057,0.492,987,1298,0.76,567,1734,2301,1095,356,791,1157,5455
7577,2018-2-1,New York Knicks,52,12605,2092,4467,0.468,417,1128,0.37,1675,3339,0.502,834,1051,0.794,534,1760,2294,1201,352,765,1077,5435
7578,2018-2-1,Atlanta Hawks,51,12265,1959,4336,0.452,558,1512,0.369,1401,2824,0.496,810,1022,0.793,490,1589,2079,1216,408,766,1022,5286
7579,2018-2-1,Chicago Bulls,51,12415,1991,4536,0.439,570,1576,0.362,1421,2960,0.48,730,959,0.761,474,1809,2283,1213,364,672,980,5282
7580,2018-2-1,Boston Celtics,52,12530,1973,4399,0.449,609,1649,0.369,1364,2750,0.496,804,1052,0.764,470,1840,2310,1151,386,688,1059,5359
7581,2018-2-1,Detroit Pistons,49,11785,1907,4239,0.45,527,1397,0.377,1380,2842,0.486,694,927,0.749,488,1591,2079,1106,382,640,917,5035
7582,2018-2-1,Utah Jazz,50,12050,1879,4151,0.453,546,1485,0.368,1333,2666,0.5,795,1001,0.794,427,1635,2062,1055,464,694,988,5099
7583,2018-2-1,Dallas Mavericks,52,12530,1960,4402,0.445,601,1659,0.362,1359,2743,0.495,753,987,0.763,404,1714,2118,1149,364,610,1012,5274
7584,2018-2-1,San Antonio Spurs,53,12720,2030,4449,0.456,469,1295,0.362,1561,3154,0.495,820,1052,0.779,535,1818,2353,1194,391,701,890,5349
7585,2018-2-1,Miami Heat,51,12290,1912,4207,0.454,564,1571,0.359,1348,2636,0.511,723,959,0.754,430,1734,2164,1110,361,728,1029,5111
7586,2018-2-1,Memphis Grizzlies,50,12025,1819,4062,0.448,472,1338,0.353,1347,2724,0.494,880,1110,0.793,461,1556,2017,1051,371,695,1164,4990
7587,2018-2-1,Sacramento Kings,50,12025,1917,4250,0.451,439,1140,0.385,1478,3110,0.475,635,876,0.725,470,1545,2015,1044,409,688,1001,4908
7588,2018-2-2,Golden State Warriors,51,12290,2215,4357,0.508,596,1518,0.393,1619,2839,0.57,872,1071,0.814,428,1818,2246,1555,417,777,1003,5898
7589,2018-2-2,Houston Rockets,50,12050,1951,4242,0.46,778,2144,0.363,1173,2098,0.559,1012,1284,0.788,467,1713,2180,1102,447,694,1005,5692
7590,2018-2-2,Toronto Raptors,50,12050,2045,4372,0.468,556,1582,0.351,1489,2790,0.534,915,1146,0.798,496,1681,2177,1138,408,653,1114,5561
7591,2018-2-2,New Orleans Pelicans,50,12175,2069,4259,0.486,536,1469,0.365,1533,2790,0.549,864,1132,0.763,413,1738,2151,1322,380,758,980,5538
7592,2018-2-2,Cleveland Cavaliers,50,12025,1969,4175,0.472,593,1632,0.363,1376,2543,0.541,949,1186,0.8,416,1672,2088,1172,360,703,917,5480
7593,2018-2-2,Minnesota Timberwolves,55,13275,2247,4708,0.477,424,1208,0.351,1823,3500,0.521,1069,1346,0.794,579,1711,2290,1248,488,649,976,5987
7594,2018-2-2,Philadelphia 76ers,48,11620,1906,4095,0.465,495,1379,0.359,1411,2716,0.52,871,1134,0.768,527,1724,2251,1221,389,814,1115,5178
7595,2018-2-2,Los Angeles Clippers,50,12025,1957,4231,0.463,509,1437,0.354,1448,2794,0.518,957,1277,0.749,502,1660,2162,1097,396,722,1036,5380
7596,2018-2-2,Washington Wizards,51,12315,2031,4371,0.465,506,1352,0.374,1525,3019,0.505,904,1183,0.764,501,1687,2188,1210,401,701,1106,5472
7597,2018-2-2,Los Angeles Lakers,50,12175,2037,4465,0.456,449,1380,0.325,1588,3085,0.515,812,1179,0.689,556,1753,2309,1173,419,780,1089,5335
7598,2018-2-2,Denver Nuggets,52,12555,2064,4473,0.461,566,1573,0.36,1498,2900,0.517,848,1130,0.75,596,1745,2341,1243,397,772,924,5542
7599,2018-2-2,Oklahoma City Thunder,52,12580,2081,4558,0.457,533,1512,0.353,1548,3046,0.508,841,1187,0.709,651,1679,2330,1103,484,700,1058,5536
7600,2018-2-2,Indiana Pacers,52,12530,2148,4455,0.482,478,1282,0.373,1670,3173,0.526,765,996,0.768,463,1699,2162,1170,425,665,971,5539
7601,2018-2-2,Orlando Magic,50,12025,1986,4314,0.46,522,1458,0.358,1464,2856,0.513,790,1050,0.752,452,1625,2077,1171,362,709,995,5284
7602,2018-2-2,Charlotte Hornets,50,12050,1912,4328,0.442,468,1310,0.357,1444,3018,0.478,995,1364,0.729,523,1792,2315,1034,337,628,897,5287
7603,2018-2-2,Brooklyn Nets,52,12555,1960,4489,0.437,612,1771,0.346,1348,2718,0.496,941,1228,0.766,526,1839,2365,1152,312,766,1083,5473
7604,2018-2-2,Portland Trail Blazers,51,12290,1998,4393,0.455,516,1350,0.382,1482,3043,0.487,840,1051,0.799,504,1785,2289,977,348,692,1013,5352
7605,2018-2-2,Phoenix Suns,52,12505,1991,4497,0.443,486,1440,0.338,1505,3057,0.492,987,1298,0.76,567,1734,2301,1095,356,791,1157,5455
7606,2018-2-2,Milwaukee Bucks,50,12050,1944,4059,0.479,433,1232,0.351,1511,2827,0.534,921,1196,0.77,391,1548,1939,1128,426,648,1109,5242
7607,2018-2-2,New York Knicks,52,12605,2092,4467,0.468,417,1128,0.37,1675,3339,0.502,834,1051,0.794,534,1760,2294,1201,352,765,1077,5435
7608,2018-2-2,Atlanta Hawks,51,12265,1959,4336,0.452,558,1512,0.369,1401,2824,0.496,810,1022,0.793,490,1589,2079,1216,408,766,1022,5286
7609,2018-2-2,Chicago Bulls,51,12415,1991,4536,0.439,570,1576,0.362,1421,2960,0.48,730,959,0.761,474,1809,2283,1213,364,672,980,5282
7610,2018-2-2,Boston Celtics,52,12530,1973,4399,0.449,609,1649,0.369,1364,2750,0.496,804,1052,0.764,470,1840,2310,1151,386,688,1059,5359
7611,2018-2-2,Detroit Pistons,50,12025,1942,4315,0.45,534,1422,0.376,1408,2893,0.487,721,964,0.748,492,1628,2120,1126,390,647,936,5139
7612,2018-2-2,Utah Jazz,50,12050,1879,4151,0.453,546,1485,0.368,1333,2666,0.5,795,1001,0.794,427,1635,2062,1055,464,694,988,5099
7613,2018-2-2,Dallas Mavericks,52,12530,1960,4402,0.445,601,1659,0.362,1359,2743,0.495,753,987,0.763,404,1714,2118,1149,364,610,1012,5274
7614,2018-2-2,San Antonio Spurs,54,12960,2065,4532,0.456,475,1319,0.36,1590,3213,0.495,835,1069,0.781,544,1855,2399,1215,398,717,902,5440
7615,2018-2-2,Miami Heat,51,12290,1912,4207,0.454,564,1571,0.359,1348,2636,0.511,723,959,0.754,430,1734,2164,1110,361,728,1029,5111
7616,2018-2-2,Memphis Grizzlies,51,12265,1859,4158,0.447,480,1369,0.351,1379,2789,0.494,894,1124,0.795,471,1595,2066,1073,374,704,1188,5092
7617,2018-2-2,Sacramento Kings,50,12025,1917,4250,0.451,439,1140,0.385,1478,3110,0.475,635,876,0.725,470,1545,2015,1044,409,688,1001,4908
7618,2018-2-3,Golden State Warriors,52,12530,2259,4437,0.509,613,1551,0.395,1646,2886,0.57,886,1087,0.815,435,1862,2297,1580,425,802,1022,6017
7619,2018-2-3,Houston Rockets,50,12050,1951,4242,0.46,778,2144,0.363,1173,2098,0.559,1012,1284,0.788,467,1713,2180,1102,447,694,1005,5692
7620,2018-2-3,Toronto Raptors,51,12290,2091,4471,0.468,575,1622,0.355,1516,2849,0.532,934,1167,0.8,513,1706,2219,1159,413,659,1137,5691
7621,2018-2-3,New Orleans Pelicans,51,12415,2115,4349,0.486,549,1493,0.368,1566,2856,0.548,873,1145,0.762,418,1774,2192,1352,390,774,1000,5652
7622,2018-2-3,Cleveland Cavaliers,50,12025,1969,4175,0.472,593,1632,0.363,1376,2543,0.541,949,1186,0.8,416,1672,2088,1172,360,703,917,5480
7623,2018-2-3,Minnesota Timberwolves,55,13275,2247,4708,0.477,424,1208,0.351,1823,3500,0.521,1069,1346,0.794,579,1711,2290,1248,488,649,976,5987
7624,2018-2-3,Philadelphia 76ers,49,11860,1948,4180,0.466,503,1403,0.359,1445,2777,0.52,882,1149,0.768,536,1754,2290,1249,398,824,1138,5281
7625,2018-2-3,Los Angeles Clippers,50,12025,1957,4231,0.463,509,1437,0.354,1448,2794,0.518,957,1277,0.749,502,1660,2162,1097,396,722,1036,5380
7626,2018-2-3,Washington Wizards,51,12315,2031,4371,0.465,506,1352,0.374,1525,3019,0.505,904,1183,0.764,501,1687,2188,1210,401,701,1106,5472
7627,2018-2-3,Indiana Pacers,53,12770,2192,4542,0.483,490,1311,0.374,1702,3231,0.527,791,1024,0.772,470,1723,2193,1191,435,676,996,5665
7628,2018-2-3,Los Angeles Lakers,51,12415,2076,4557,0.456,459,1406,0.326,1617,3151,0.513,826,1199,0.689,574,1791,2365,1194,424,795,1107,5437
7629,2018-2-3,Denver Nuggets,52,12555,2064,4473,0.461,566,1573,0.36,1498,2900,0.517,848,1130,0.75,596,1745,2341,1243,397,772,924,5542
7630,2018-2-3,Charlotte Hornets,51,12290,1956,4411,0.443,483,1343,0.36,1473,3068,0.48,1025,1398,0.733,534,1824,2358,1061,342,643,918,5420
7631,2018-2-3,Oklahoma City Thunder,53,12820,2118,4655,0.455,542,1548,0.35,1576,3107,0.507,858,1207,0.711,666,1716,2382,1127,490,716,1076,5636
7632,2018-2-3,Orlando Magic,50,12025,1986,4314,0.46,522,1458,0.358,1464,2856,0.513,790,1050,0.752,452,1625,2077,1171,362,709,995,5284
7633,2018-2-3,Brooklyn Nets,53,12795,1997,4571,0.437,621,1800,0.345,1376,2771,0.497,957,1251,0.765,531,1872,2403,1172,319,777,1101,5572
7634,2018-2-3,Portland Trail Blazers,52,12530,2035,4466,0.456,523,1371,0.381,1512,3095,0.489,864,1084,0.797,508,1817,2325,997,352,702,1028,5457
7635,2018-2-3,Phoenix Suns,53,12745,2027,4584,0.442,495,1473,0.336,1532,3111,0.492,1003,1317,0.762,573,1760,2333,1114,363,803,1182,5552
7636,2018-2-3,Milwaukee Bucks,51,12290,1977,4135,0.478,440,1256,0.35,1537,2879,0.534,940,1222,0.769,395,1580,1975,1146,436,659,1130,5334
7637,2018-2-3,New York Knicks,53,12845,2128,4556,0.467,422,1153,0.366,1706,3403,0.501,847,1068,0.793,552,1799,2351,1225,359,783,1098,5525
7638,2018-2-3,Atlanta Hawks,52,12505,1993,4416,0.451,569,1543,0.369,1424,2873,0.496,841,1056,0.796,494,1621,2115,1237,414,778,1040,5396
7639,2018-2-3,Chicago Bulls,51,12415,1991,4536,0.439,570,1576,0.362,1421,2960,0.48,730,959,0.761,474,1809,2283,1213,364,672,980,5282
7640,2018-2-3,Boston Celtics,53,12770,2018,4488,0.45,620,1673,0.371,1398,2815,0.497,822,1072,0.767,477,1875,2352,1177,394,699,1082,5478
7641,2018-2-3,Detroit Pistons,50,12025,1942,4315,0.45,534,1422,0.376,1408,2893,0.487,721,964,0.748,492,1628,2120,1126,390,647,936,5139
7642,2018-2-3,Utah Jazz,51,12290,1930,4241,0.455,561,1514,0.371,1369,2727,0.502,807,1018,0.793,436,1677,2113,1085,471,705,1009,5228
7643,2018-2-3,Dallas Mavericks,52,12530,1960,4402,0.445,601,1659,0.362,1359,2743,0.495,753,987,0.763,404,1714,2118,1149,364,610,1012,5274
7644,2018-2-3,San Antonio Spurs,54,12960,2065,4532,0.456,475,1319,0.36,1590,3213,0.495,835,1069,0.781,544,1855,2399,1215,398,717,902,5440
7645,2018-2-3,Miami Heat,52,12530,1946,4294,0.453,576,1608,0.358,1370,2686,0.51,740,985,0.751,446,1767,2213,1130,364,739,1045,5208
7646,2018-2-3,Memphis Grizzlies,51,12265,1859,4158,0.447,480,1369,0.351,1379,2789,0.494,894,1124,0.795,471,1595,2066,1073,374,704,1188,5092
7647,2018-2-3,Sacramento Kings,51,12265,1959,4345,0.451,449,1165,0.385,1510,3180,0.475,645,891,0.724,476,1572,2048,1066,425,698,1015,5012
7648,2018-2-4,Golden State Warriors,53,12770,2302,4523,0.509,621,1582,0.393,1681,2941,0.572,900,1110,0.811,446,1893,2339,1608,434,815,1045,6125
7649,2018-2-4,Houston Rockets,51,12290,1995,4335,0.46,797,2195,0.363,1198,2140,0.56,1025,1300,0.788,473,1760,2233,1130,453,702,1024,5812
7650,2018-2-4,Toronto Raptors,51,12290,2091,4471,0.468,575,1622,0.355,1516,2849,0.532,934,1167,0.8,513,1706,2219,1159,413,659,1137,5691
7651,2018-2-4,New Orleans Pelicans,52,12655,2157,4450,0.485,557,1526,0.365,1600,2924,0.547,888,1162,0.764,436,1807,2243,1375,399,787,1011,5759
7652,2018-2-4,Cleveland Cavaliers,51,12265,2003,4262,0.47,601,1662,0.362,1402,2600,0.539,961,1202,0.8,421,1714,2135,1194,364,714,933,5568
7653,2018-2-4,Minnesota Timberwolves,56,13515,2295,4803,0.478,434,1229,0.353,1861,3574,0.521,1081,1362,0.794,591,1749,2340,1269,497,661,989,6105
7654,2018-2-4,Los Angeles Clippers,51,12265,1997,4319,0.462,518,1462,0.354,1479,2857,0.518,981,1305,0.752,512,1704,2216,1120,400,735,1054,5493
7655,2018-2-4,Philadelphia 76ers,50,12100,1981,4267,0.464,513,1435,0.357,1468,2832,0.518,898,1173,0.766,551,1788,2339,1270,406,842,1159,5373
7656,2018-2-4,Washington Wizards,52,12555,2077,4456,0.466,513,1378,0.372,1564,3078,0.508,920,1201,0.766,513,1713,2226,1245,415,715,1125,5587
7657,2018-2-4,Indiana Pacers,54,13010,2227,4621,0.482,499,1338,0.373,1728,3283,0.526,812,1049,0.774,476,1759,2235,1216,450,689,1015,5765
7658,2018-2-4,Denver Nuggets,53,12795,2103,4564,0.461,578,1602,0.361,1525,2962,0.515,873,1159,0.753,612,1777,2389,1271,404,787,941,5657
7659,2018-2-4,Los Angeles Lakers,51,12415,2076,4557,0.456,459,1406,0.326,1617,3151,0.513,826,1199,0.689,574,1791,2365,1194,424,795,1107,5437
7660,2018-2-4,Charlotte Hornets,51,12290,1956,4411,0.443,483,1343,0.36,1473,3068,0.48,1025,1398,0.733,534,1824,2358,1061,342,643,918,5420
7661,2018-2-4,Oklahoma City Thunder,53,12820,2118,4655,0.455,542,1548,0.35,1576,3107,0.507,858,1207,0.711,666,1716,2382,1127,490,716,1076,5636
7662,2018-2-4,Orlando Magic,51,12265,2020,4391,0.46,532,1490,0.357,1488,2901,0.513,810,1072,0.756,462,1650,2112,1188,374,729,1010,5382
7663,2018-2-4,Brooklyn Nets,53,12795,1997,4571,0.437,621,1800,0.345,1376,2771,0.497,957,1251,0.765,531,1872,2403,1172,319,777,1101,5572
7664,2018-2-4,Portland Trail Blazers,52,12530,2035,4466,0.456,523,1371,0.381,1512,3095,0.489,864,1084,0.797,508,1817,2325,997,352,702,1028,5457
7665,2018-2-4,Phoenix Suns,53,12745,2027,4584,0.442,495,1473,0.336,1532,3111,0.492,1003,1317,0.762,573,1760,2333,1114,363,803,1182,5552
7666,2018-2-4,Milwaukee Bucks,51,12290,1977,4135,0.478,440,1256,0.35,1537,2879,0.534,940,1222,0.769,395,1580,1975,1146,436,659,1130,5334
7667,2018-2-4,New York Knicks,53,12845,2128,4556,0.467,422,1153,0.366,1706,3403,0.501,847,1068,0.793,552,1799,2351,1225,359,783,1098,5525
7668,2018-2-4,Atlanta Hawks,52,12505,1993,4416,0.451,569,1543,0.369,1424,2873,0.496,841,1056,0.796,494,1621,2115,1237,414,778,1040,5396
7669,2018-2-4,Chicago Bulls,52,12655,2026,4633,0.437,582,1613,0.361,1444,3020,0.478,751,980,0.766,487,1844,2331,1235,370,683,1000,5385
7670,2018-2-4,Boston Celtics,53,12770,2018,4488,0.45,620,1673,0.371,1398,2815,0.497,822,1072,0.767,477,1875,2352,1177,394,699,1082,5478
7671,2018-2-4,Detroit Pistons,51,12265,1986,4399,0.451,543,1448,0.375,1443,2951,0.489,735,981,0.749,505,1664,2169,1149,397,664,948,5250
7672,2018-2-4,Utah Jazz,52,12530,1969,4310,0.457,573,1537,0.373,1396,2773,0.503,837,1054,0.794,441,1709,2150,1111,477,722,1028,5348
7673,2018-2-4,Dallas Mavericks,53,12770,2001,4485,0.446,614,1700,0.361,1387,2785,0.498,764,1001,0.763,413,1741,2154,1177,372,623,1024,5380
7674,2018-2-4,San Antonio Spurs,55,13200,2109,4623,0.456,485,1345,0.361,1624,3278,0.495,848,1087,0.78,555,1880,2435,1240,407,729,929,5551
7675,2018-2-4,Miami Heat,53,12770,1990,4385,0.454,590,1644,0.359,1400,2741,0.511,745,992,0.751,453,1793,2246,1160,377,750,1059,5315
7676,2018-2-4,Memphis Grizzlies,51,12265,1859,4158,0.447,480,1369,0.351,1379,2789,0.494,894,1124,0.795,471,1595,2066,1073,374,704,1188,5092
7677,2018-2-4,Sacramento Kings,52,12505,2002,4427,0.452,457,1192,0.383,1545,3235,0.478,650,897,0.725,483,1597,2080,1089,436,714,1036,5111
7678,2018-2-5,Golden State Warriors,53,12770,2302,4523,0.509,621,1582,0.393,1681,2941,0.572,900,1110,0.811,446,1893,2339,1608,434,815,1045,6125
7679,2018-2-5,Houston Rockets,51,12290,1995,4335,0.46,797,2195,0.363,1198,2140,0.56,1025,1300,0.788,473,1760,2233,1130,453,702,1024,5812
7680,2018-2-5,Toronto Raptors,52,12530,2132,4560,0.468,581,1657,0.351,1551,2903,0.534,947,1182,0.801,523,1740,2263,1180,426,670,1157,5792
7681,2018-2-5,New Orleans Pelicans,52,12655,2157,4450,0.485,557,1526,0.365,1600,2924,0.547,888,1162,0.764,436,1807,2243,1375,399,787,1011,5759
7682,2018-2-5,Cleveland Cavaliers,51,12265,2003,4262,0.47,601,1662,0.362,1402,2600,0.539,961,1202,0.8,421,1714,2135,1194,364,714,933,5568
7683,2018-2-5,Minnesota Timberwolves,56,13515,2295,4803,0.478,434,1229,0.353,1861,3574,0.521,1081,1362,0.794,591,1749,2340,1269,497,661,989,6105
7684,2018-2-5,Los Angeles Clippers,51,12265,1997,4319,0.462,518,1462,0.354,1479,2857,0.518,981,1305,0.752,512,1704,2216,1120,400,735,1054,5493
7685,2018-2-5,Philadelphia 76ers,50,12100,1981,4267,0.464,513,1435,0.357,1468,2832,0.518,898,1173,0.766,551,1788,2339,1270,406,842,1159,5373
7686,2018-2-5,Washington Wizards,52,12555,2077,4456,0.466,513,1378,0.372,1564,3078,0.508,920,1201,0.766,513,1713,2226,1245,415,715,1125,5587
7687,2018-2-5,Indiana Pacers,54,13010,2227,4621,0.482,499,1338,0.373,1728,3283,0.526,812,1049,0.774,476,1759,2235,1216,450,689,1015,5765
7688,2018-2-5,Denver Nuggets,53,12795,2103,4564,0.461,578,1602,0.361,1525,2962,0.515,873,1159,0.753,612,1777,2389,1271,404,787,941,5657
7689,2018-2-5,Los Angeles Lakers,52,12655,2118,4643,0.456,472,1436,0.329,1646,3207,0.513,837,1217,0.688,582,1823,2405,1218,430,814,1127,5545
7690,2018-2-5,Charlotte Hornets,52,12530,1996,4507,0.443,493,1381,0.357,1503,3126,0.481,1050,1427,0.736,547,1854,2401,1085,354,651,935,5535
7691,2018-2-5,Oklahoma City Thunder,54,13060,2158,4744,0.455,549,1573,0.349,1609,3171,0.507,875,1232,0.71,679,1749,2428,1144,503,733,1094,5740
7692,2018-2-5,Orlando Magic,51,12265,2020,4391,0.46,532,1490,0.357,1488,2901,0.513,810,1072,0.756,462,1650,2112,1188,374,729,1010,5382
7693,2018-2-5,Brooklyn Nets,54,13035,2034,4661,0.436,630,1829,0.344,1404,2832,0.496,968,1265,0.765,542,1897,2439,1197,324,786,1120,5666
7694,2018-2-5,Phoenix Suns,54,12985,2068,4661,0.444,510,1502,0.34,1558,3159,0.493,1016,1330,0.764,575,1797,2372,1138,367,822,1207,5662
7695,2018-2-5,Portland Trail Blazers,53,12770,2071,4557,0.454,536,1402,0.382,1535,3155,0.487,875,1098,0.797,518,1853,2371,1018,356,710,1045,5553
7696,2018-2-5,Milwaukee Bucks,52,12530,2019,4216,0.479,448,1275,0.351,1571,2941,0.534,957,1243,0.77,409,1620,2029,1165,439,672,1146,5443
7697,2018-2-5,New York Knicks,54,13085,2169,4650,0.466,427,1176,0.363,1742,3474,0.501,856,1083,0.79,568,1831,2399,1241,369,798,1114,5621
7698,2018-2-5,Atlanta Hawks,53,12745,2028,4503,0.45,584,1576,0.371,1444,2927,0.493,855,1075,0.795,507,1652,2159,1262,420,794,1052,5495
7699,2018-2-5,Chicago Bulls,52,12655,2026,4633,0.437,582,1613,0.361,1444,3020,0.478,751,980,0.766,487,1844,2331,1235,370,683,1000,5385
7700,2018-2-5,Boston Celtics,54,13010,2053,4573,0.449,635,1709,0.372,1418,2864,0.495,834,1089,0.766,486,1917,2403,1201,397,710,1098,5575
7701,2018-2-5,Detroit Pistons,51,12265,1986,4399,0.451,543,1448,0.375,1443,2951,0.489,735,981,0.749,505,1664,2169,1149,397,664,948,5250
7702,2018-2-5,Utah Jazz,52,12530,1969,4310,0.457,573,1537,0.373,1396,2773,0.503,837,1054,0.794,441,1709,2150,1111,477,722,1028,5348
7703,2018-2-5,Dallas Mavericks,53,12770,2001,4485,0.446,614,1700,0.361,1387,2785,0.498,764,1001,0.763,413,1741,2154,1177,372,623,1024,5380
7704,2018-2-5,San Antonio Spurs,55,13200,2109,4623,0.456,485,1345,0.361,1624,3278,0.495,848,1087,0.78,555,1880,2435,1240,407,729,929,5551
7705,2018-2-5,Miami Heat,53,12770,1990,4385,0.454,590,1644,0.359,1400,2741,0.511,745,992,0.751,453,1793,2246,1160,377,750,1059,5315
7706,2018-2-5,Memphis Grizzlies,52,12505,1888,4239,0.445,488,1394,0.35,1400,2845,0.492,914,1147,0.797,484,1627,2111,1090,381,723,1211,5178
7707,2018-2-5,Sacramento Kings,52,12505,2002,4427,0.452,457,1192,0.383,1545,3235,0.478,650,897,0.725,483,1597,2080,1089,436,714,1036,5111
7708,2018-2-6,Golden State Warriors,53,12770,2302,4523,0.509,621,1582,0.393,1681,2941,0.572,900,1110,0.811,446,1893,2339,1608,434,815,1045,6125
7709,2018-2-6,Houston Rockets,51,12290,1995,4335,0.46,797,2195,0.363,1198,2140,0.56,1025,1300,0.788,473,1760,2233,1130,453,702,1024,5812
7710,2018-2-6,Toronto Raptors,52,12530,2132,4560,0.468,581,1657,0.351,1551,2903,0.534,947,1182,0.801,523,1740,2263,1180,426,670,1157,5792
7711,2018-2-6,New Orleans Pelicans,53,12895,2204,4543,0.485,565,1548,0.365,1639,2995,0.547,895,1175,0.762,442,1831,2273,1399,409,801,1026,5868
7712,2018-2-6,Cleveland Cavaliers,51,12265,2003,4262,0.47,601,1662,0.362,1402,2600,0.539,961,1202,0.8,421,1714,2135,1194,364,714,933,5568
7713,2018-2-6,Minnesota Timberwolves,56,13515,2295,4803,0.478,434,1229,0.353,1861,3574,0.521,1081,1362,0.794,591,1749,2340,1269,497,661,989,6105
7714,2018-2-6,Los Angeles Clippers,52,12505,2039,4406,0.463,528,1489,0.355,1511,2917,0.518,991,1317,0.752,517,1738,2255,1148,410,748,1070,5597
7715,2018-2-6,Washington Wizards,53,12795,2122,4538,0.468,520,1403,0.371,1602,3135,0.511,934,1218,0.767,520,1749,2269,1274,423,729,1148,5698
7716,2018-2-6,Philadelphia 76ers,50,12100,1981,4267,0.464,513,1435,0.357,1468,2832,0.518,898,1173,0.766,551,1788,2339,1270,406,842,1159,5373
7717,2018-2-6,Denver Nuggets,54,13035,2149,4645,0.463,596,1636,0.364,1553,3009,0.516,884,1172,0.754,617,1813,2430,1301,414,798,956,5778
7718,2018-2-6,Indiana Pacers,55,13250,2264,4701,0.482,511,1367,0.374,1753,3334,0.526,828,1074,0.771,484,1786,2270,1235,456,705,1033,5867
7719,2018-2-6,Los Angeles Lakers,52,12655,2118,4643,0.456,472,1436,0.329,1646,3207,0.513,837,1217,0.688,582,1823,2405,1218,430,814,1127,5545
7720,2018-2-6,Charlotte Hornets,53,12770,2035,4584,0.444,504,1407,0.358,1531,3177,0.482,1065,1451,0.734,552,1885,2437,1106,361,661,951,5639
7721,2018-2-6,Oklahoma City Thunder,54,13060,2158,4744,0.455,549,1573,0.349,1609,3171,0.507,875,1232,0.71,679,1749,2428,1144,503,733,1094,5740
7722,2018-2-6,Orlando Magic,52,12505,2061,4475,0.461,545,1520,0.359,1516,2955,0.513,826,1091,0.757,467,1684,2151,1213,382,740,1036,5493
7723,2018-2-6,Brooklyn Nets,54,13035,2034,4661,0.436,630,1829,0.344,1404,2832,0.496,968,1265,0.765,542,1897,2439,1197,324,786,1120,5666
7724,2018-2-6,Phoenix Suns,54,12985,2068,4661,0.444,510,1502,0.34,1558,3159,0.493,1016,1330,0.764,575,1797,2372,1138,367,822,1207,5662
7725,2018-2-6,Milwaukee Bucks,52,12530,2019,4216,0.479,448,1275,0.351,1571,2941,0.534,957,1243,0.77,409,1620,2029,1165,439,672,1146,5443
7726,2018-2-6,Portland Trail Blazers,54,13010,2108,4651,0.453,546,1435,0.38,1562,3216,0.486,882,1106,0.797,531,1885,2416,1036,365,723,1059,5644
7727,2018-2-6,New York Knicks,54,13085,2169,4650,0.466,427,1176,0.363,1742,3474,0.501,856,1083,0.79,568,1831,2399,1241,369,798,1114,5621
7728,2018-2-6,Atlanta Hawks,53,12745,2028,4503,0.45,584,1576,0.371,1444,2927,0.493,855,1075,0.795,507,1652,2159,1262,420,794,1052,5495
7729,2018-2-6,Chicago Bulls,53,12895,2058,4713,0.437,596,1649,0.361,1462,3064,0.477,771,1004,0.768,496,1881,2377,1255,376,695,1021,5483
7730,2018-2-6,Utah Jazz,53,12770,2021,4399,0.459,587,1558,0.377,1434,2841,0.505,852,1071,0.796,450,1745,2195,1140,483,735,1046,5481
7731,2018-2-6,Boston Celtics,54,13010,2053,4573,0.449,635,1709,0.372,1418,2864,0.495,834,1089,0.766,486,1917,2403,1201,397,710,1098,5575
7732,2018-2-6,Detroit Pistons,52,12505,2030,4487,0.452,558,1478,0.378,1472,3009,0.489,743,993,0.748,515,1705,2220,1185,404,678,962,5361
7733,2018-2-6,Dallas Mavericks,54,13010,2034,4565,0.446,631,1742,0.362,1403,2823,0.497,782,1021,0.766,420,1772,2192,1199,377,643,1047,5481
7734,2018-2-6,San Antonio Spurs,55,13200,2109,4623,0.456,485,1345,0.361,1624,3278,0.495,848,1087,0.78,555,1880,2435,1240,407,729,929,5551
7735,2018-2-6,Miami Heat,54,13010,2030,4478,0.453,593,1667,0.356,1437,2811,0.511,771,1027,0.751,470,1829,2299,1181,382,762,1078,5424
7736,2018-2-6,Memphis Grizzlies,52,12505,1888,4239,0.445,488,1394,0.35,1400,2845,0.492,914,1147,0.797,484,1627,2111,1090,381,723,1211,5178
7737,2018-2-6,Sacramento Kings,53,12745,2039,4511,0.452,468,1224,0.382,1571,3287,0.478,669,922,0.726,492,1633,2125,1111,441,725,1053,5215
7738,2018-2-7,Golden State Warriors,54,13010,2339,4599,0.509,629,1610,0.391,1710,2989,0.572,923,1141,0.809,456,1928,2384,1635,441,840,1069,6230
7739,2018-2-7,Houston Rockets,52,12530,2040,4416,0.462,813,2228,0.365,1227,2188,0.561,1042,1321,0.789,481,1792,2273,1146,460,713,1038,5935
7740,2018-2-7,Toronto Raptors,53,12770,2172,4640,0.468,598,1693,0.353,1574,2947,0.534,961,1199,0.802,528,1775,2303,1209,436,685,1175,5903
7741,2018-2-7,New Orleans Pelicans,53,12895,2204,4543,0.485,565,1548,0.365,1639,2995,0.547,895,1175,0.762,442,1831,2273,1399,409,801,1026,5868
7742,2018-2-7,Cleveland Cavaliers,52,12505,2039,4346,0.469,613,1699,0.361,1426,2647,0.539,975,1222,0.798,430,1741,2171,1213,368,728,957,5666
7743,2018-2-7,Minnesota Timberwolves,56,13515,2295,4803,0.478,434,1229,0.353,1861,3574,0.521,1081,1362,0.794,591,1749,2340,1269,497,661,989,6105
7744,2018-2-7,Los Angeles Clippers,52,12505,2039,4406,0.463,528,1489,0.355,1511,2917,0.518,991,1317,0.752,517,1738,2255,1148,410,748,1070,5597
7745,2018-2-7,Philadelphia 76ers,51,12340,2026,4349,0.466,527,1463,0.36,1499,2886,0.519,909,1187,0.766,563,1821,2384,1297,415,859,1173,5488
7746,2018-2-7,Washington Wizards,54,13035,2163,4631,0.467,527,1430,0.369,1636,3201,0.511,947,1236,0.766,536,1772,2308,1297,437,740,1166,5800
7747,2018-2-7,Denver Nuggets,54,13035,2149,4645,0.463,596,1636,0.364,1553,3009,0.516,884,1172,0.754,617,1813,2430,1301,414,798,956,5778
7748,2018-2-7,Los Angeles Lakers,53,12895,2157,4726,0.456,483,1462,0.33,1674,3264,0.513,860,1243,0.692,594,1867,2461,1237,437,828,1148,5657
7749,2018-2-7,Indiana Pacers,55,13250,2264,4701,0.482,511,1367,0.374,1753,3334,0.526,828,1074,0.771,484,1786,2270,1235,456,705,1033,5867
7750,2018-2-7,Oklahoma City Thunder,55,13300,2202,4837,0.455,561,1604,0.35,1641,3233,0.508,900,1265,0.711,689,1779,2468,1161,517,745,1122,5865
7751,2018-2-7,Charlotte Hornets,53,12770,2035,4584,0.444,504,1407,0.358,1531,3177,0.482,1065,1451,0.734,552,1885,2437,1106,361,661,951,5639
7752,2018-2-7,Orlando Magic,53,12745,2107,4563,0.462,551,1542,0.357,1556,3021,0.515,844,1118,0.755,479,1722,2201,1240,389,752,1052,5609
7753,2018-2-7,Brooklyn Nets,55,13275,2075,4746,0.437,646,1864,0.347,1429,2882,0.496,983,1282,0.767,552,1924,2476,1221,332,797,1137,5779
7754,2018-2-7,Milwaukee Bucks,53,12770,2056,4298,0.478,456,1301,0.35,1600,2997,0.534,978,1270,0.77,417,1655,2072,1188,450,686,1163,5546
7755,2018-2-7,Phoenix Suns,55,13225,2104,4755,0.442,518,1531,0.338,1586,3224,0.492,1029,1353,0.761,591,1829,2420,1162,371,833,1225,5755
7756,2018-2-7,Portland Trail Blazers,54,13010,2108,4651,0.453,546,1435,0.38,1562,3216,0.486,882,1106,0.797,531,1885,2416,1036,365,723,1059,5644
7757,2018-2-7,Atlanta Hawks,54,12985,2070,4586,0.451,592,1601,0.37,1478,2985,0.495,871,1096,0.795,515,1680,2195,1291,433,807,1068,5603
7758,2018-2-7,New York Knicks,55,13325,2206,4739,0.465,432,1199,0.36,1774,3540,0.501,866,1098,0.789,579,1867,2446,1261,374,815,1133,5710
7759,2018-2-7,Chicago Bulls,53,12895,2058,4713,0.437,596,1649,0.361,1462,3064,0.477,771,1004,0.768,496,1881,2377,1255,376,695,1021,5483
7760,2018-2-7,Utah Jazz,53,12770,2021,4399,0.459,587,1558,0.377,1434,2841,0.505,852,1071,0.796,450,1745,2195,1140,483,735,1046,5481
7761,2018-2-7,Detroit Pistons,52,12505,2030,4487,0.452,558,1478,0.378,1472,3009,0.489,743,993,0.748,515,1705,2220,1185,404,678,962,5361
7762,2018-2-7,Boston Celtics,55,13250,2086,4656,0.448,645,1732,0.372,1441,2924,0.493,849,1109,0.766,495,1946,2441,1222,400,727,1117,5666
7763,2018-2-7,Dallas Mavericks,54,13010,2034,4565,0.446,631,1742,0.362,1403,2823,0.497,782,1021,0.766,420,1772,2192,1199,377,643,1047,5481
7764,2018-2-7,San Antonio Spurs,55,13200,2109,4623,0.456,485,1345,0.361,1624,3278,0.495,848,1087,0.78,555,1880,2435,1240,407,729,929,5551
7765,2018-2-7,Miami Heat,54,13010,2030,4478,0.453,593,1667,0.356,1437,2811,0.511,771,1027,0.751,470,1829,2299,1181,382,762,1078,5424
7766,2018-2-7,Memphis Grizzlies,53,12745,1922,4318,0.445,492,1416,0.347,1430,2902,0.493,924,1160,0.797,493,1655,2148,1113,388,748,1235,5260
7767,2018-2-7,Sacramento Kings,53,12745,2039,4511,0.452,468,1224,0.382,1571,3287,0.478,669,922,0.726,492,1633,2125,1111,441,725,1053,5215
7768,2018-2-8,Golden State Warriors,54,13010,2339,4599,0.509,629,1610,0.391,1710,2989,0.572,923,1141,0.809,456,1928,2384,1635,441,840,1069,6230
7769,2018-2-8,Houston Rockets,53,12770,2078,4490,0.463,825,2259,0.365,1253,2231,0.562,1063,1347,0.789,485,1823,2308,1162,468,722,1054,6044
7770,2018-2-8,Toronto Raptors,53,12770,2172,4640,0.468,598,1693,0.353,1574,2947,0.534,961,1199,0.802,528,1775,2303,1209,436,685,1175,5903
7771,2018-2-8,New Orleans Pelicans,53,12895,2204,4543,0.485,565,1548,0.365,1639,2995,0.547,895,1175,0.762,442,1831,2273,1399,409,801,1026,5868
7772,2018-2-8,Cleveland Cavaliers,53,12770,2091,4434,0.472,634,1740,0.364,1457,2694,0.541,990,1245,0.795,437,1775,2212,1246,373,743,978,5806
7773,2018-2-8,Minnesota Timberwolves,57,13780,2349,4896,0.48,453,1262,0.359,1896,3634,0.522,1092,1374,0.795,595,1780,2375,1302,504,672,1008,6243
7774,2018-2-8,Los Angeles Clippers,52,12505,2039,4406,0.463,528,1489,0.355,1511,2917,0.518,991,1317,0.752,517,1738,2255,1148,410,748,1070,5597
7775,2018-2-8,Philadelphia 76ers,51,12340,2026,4349,0.466,527,1463,0.36,1499,2886,0.519,909,1187,0.766,563,1821,2384,1297,415,859,1173,5488
7776,2018-2-8,Washington Wizards,54,13035,2163,4631,0.467,527,1430,0.369,1636,3201,0.511,947,1236,0.766,536,1772,2308,1297,437,740,1166,5800
7777,2018-2-8,Denver Nuggets,54,13035,2149,4645,0.463,596,1636,0.364,1553,3009,0.516,884,1172,0.754,617,1813,2430,1301,414,798,956,5778
7778,2018-2-8,Los Angeles Lakers,53,12895,2157,4726,0.456,483,1462,0.33,1674,3264,0.513,860,1243,0.692,594,1867,2461,1237,437,828,1148,5657
7779,2018-2-8,Indiana Pacers,55,13250,2264,4701,0.482,511,1367,0.374,1753,3334,0.526,828,1074,0.771,484,1786,2270,1235,456,705,1033,5867
7780,2018-2-8,Oklahoma City Thunder,55,13300,2202,4837,0.455,561,1604,0.35,1641,3233,0.508,900,1265,0.711,689,1779,2468,1161,517,745,1122,5865
7781,2018-2-8,Charlotte Hornets,53,12770,2035,4584,0.444,504,1407,0.358,1531,3177,0.482,1065,1451,0.734,552,1885,2437,1106,361,661,951,5639
7782,2018-2-8,Orlando Magic,53,12745,2107,4563,0.462,551,1542,0.357,1556,3021,0.515,844,1118,0.755,479,1722,2201,1240,389,752,1052,5609
7783,2018-2-8,Brooklyn Nets,56,13515,2114,4836,0.437,663,1915,0.346,1451,2921,0.497,994,1294,0.768,560,1966,2526,1254,336,816,1157,5885
7784,2018-2-8,Milwaukee Bucks,53,12770,2056,4298,0.478,456,1301,0.35,1600,2997,0.534,978,1270,0.77,417,1655,2072,1188,450,686,1163,5546
7785,2018-2-8,Portland Trail Blazers,54,13010,2108,4651,0.453,546,1435,0.38,1562,3216,0.486,882,1106,0.797,531,1885,2416,1036,365,723,1059,5644
7786,2018-2-8,Phoenix Suns,56,13465,2137,4852,0.44,521,1563,0.333,1616,3289,0.491,1041,1371,0.759,602,1862,2464,1177,379,844,1248,5836
7787,2018-2-8,Atlanta Hawks,54,12985,2070,4586,0.451,592,1601,0.37,1478,2985,0.495,871,1096,0.795,515,1680,2195,1291,433,807,1068,5603
7788,2018-2-8,New York Knicks,55,13325,2206,4739,0.465,432,1199,0.36,1774,3540,0.501,866,1098,0.789,579,1867,2446,1261,374,815,1133,5710
7789,2018-2-8,Chicago Bulls,53,12895,2058,4713,0.437,596,1649,0.361,1462,3064,0.477,771,1004,0.768,496,1881,2377,1255,376,695,1021,5483
7790,2018-2-8,Detroit Pistons,53,12745,2074,4579,0.453,567,1502,0.377,1507,3077,0.49,761,1018,0.748,523,1743,2266,1205,414,685,974,5476
7791,2018-2-8,Utah Jazz,54,13010,2050,4468,0.459,593,1580,0.375,1457,2888,0.505,880,1104,0.797,459,1779,2238,1154,489,754,1062,5573
7792,2018-2-8,Boston Celtics,55,13250,2086,4656,0.448,645,1732,0.372,1441,2924,0.493,849,1109,0.766,495,1946,2441,1222,400,727,1117,5666
7793,2018-2-8,Dallas Mavericks,54,13010,2034,4565,0.446,631,1742,0.362,1403,2823,0.497,782,1021,0.766,420,1772,2192,1199,377,643,1047,5481
7794,2018-2-8,San Antonio Spurs,56,13440,2155,4716,0.457,501,1377,0.364,1654,3339,0.495,869,1114,0.78,569,1928,2497,1266,413,741,946,5680
7795,2018-2-8,Miami Heat,55,13250,2069,4566,0.453,606,1699,0.357,1463,2867,0.51,781,1039,0.752,485,1855,2340,1204,385,775,1095,5525
7796,2018-2-8,Memphis Grizzlies,54,12985,1956,4399,0.445,500,1439,0.347,1456,2960,0.492,936,1176,0.796,502,1682,2184,1131,400,763,1261,5348
7797,2018-2-8,Sacramento Kings,53,12745,2039,4511,0.452,468,1224,0.382,1571,3287,0.478,669,922,0.726,492,1633,2125,1111,441,725,1053,5215
7798,2018-2-9,Golden State Warriors,55,13250,2384,4687,0.509,643,1639,0.392,1741,3048,0.571,940,1161,0.81,474,1961,2435,1672,447,856,1087,6351
7799,2018-2-9,Houston Rockets,53,12770,2078,4490,0.463,825,2259,0.365,1253,2231,0.562,1063,1347,0.789,485,1823,2308,1162,468,722,1054,6044
7800,2018-2-9,Toronto Raptors,54,13010,2215,4735,0.468,614,1736,0.354,1601,2999,0.534,972,1213,0.801,537,1818,2355,1240,447,693,1192,6016
7801,2018-2-9,New Orleans Pelicans,53,12895,2204,4543,0.485,565,1548,0.365,1639,2995,0.547,895,1175,0.762,442,1831,2273,1399,409,801,1026,5868
7802,2018-2-9,Cleveland Cavaliers,53,12770,2091,4434,0.472,634,1740,0.364,1457,2694,0.541,990,1245,0.795,437,1775,2212,1246,373,743,978,5806
7803,2018-2-9,Minnesota Timberwolves,57,13780,2349,4896,0.48,453,1262,0.359,1896,3634,0.522,1092,1374,0.795,595,1780,2375,1302,504,672,1008,6243
7804,2018-2-9,Los Angeles Clippers,52,12505,2039,4406,0.463,528,1489,0.355,1511,2917,0.518,991,1317,0.752,517,1738,2255,1148,410,748,1070,5597
7805,2018-2-9,Philadelphia 76ers,51,12340,2026,4349,0.466,527,1463,0.36,1499,2886,0.519,909,1187,0.766,563,1821,2384,1297,415,859,1173,5488
7806,2018-2-9,Washington Wizards,55,13300,2201,4726,0.466,539,1456,0.37,1662,3270,0.508,963,1256,0.767,553,1807,2360,1325,448,760,1189,5904
7807,2018-2-9,Denver Nuggets,54,13035,2149,4645,0.463,596,1636,0.364,1553,3009,0.516,884,1172,0.754,617,1813,2430,1301,414,798,956,5778
7808,2018-2-9,Los Angeles Lakers,54,13135,2199,4822,0.456,493,1493,0.33,1706,3329,0.512,872,1256,0.694,607,1905,2512,1265,442,836,1167,5763
7809,2018-2-9,Indiana Pacers,55,13250,2264,4701,0.482,511,1367,0.374,1753,3334,0.526,828,1074,0.771,484,1786,2270,1235,456,705,1033,5867
7810,2018-2-9,Charlotte Hornets,54,13035,2073,4682,0.443,517,1440,0.359,1556,3242,0.48,1079,1468,0.735,559,1922,2481,1123,371,672,967,5742
7811,2018-2-9,Oklahoma City Thunder,56,13540,2234,4927,0.453,569,1638,0.347,1665,3289,0.506,909,1284,0.708,706,1812,2518,1177,523,758,1133,5946
7812,2018-2-9,Orlando Magic,54,12985,2143,4647,0.461,560,1571,0.356,1583,3076,0.515,863,1140,0.757,487,1750,2237,1260,399,765,1074,5709
7813,2018-2-9,Brooklyn Nets,56,13515,2114,4836,0.437,663,1915,0.346,1451,2921,0.497,994,1294,0.768,560,1966,2526,1254,336,816,1157,5885
7814,2018-2-9,Milwaukee Bucks,53,12770,2056,4298,0.478,456,1301,0.35,1600,2997,0.534,978,1270,0.77,417,1655,2072,1188,450,686,1163,5546
7815,2018-2-9,Portland Trail Blazers,55,13275,2149,4741,0.453,555,1466,0.379,1594,3275,0.487,900,1128,0.798,540,1933,2473,1054,372,740,1078,5753
7816,2018-2-9,Phoenix Suns,56,13465,2137,4852,0.44,521,1563,0.333,1616,3289,0.491,1041,1371,0.759,602,1862,2464,1177,379,844,1248,5836
7817,2018-2-9,Atlanta Hawks,55,13225,2107,4673,0.451,604,1631,0.37,1503,3042,0.494,883,1114,0.793,524,1717,2241,1316,437,824,1091,5701
7818,2018-2-9,Chicago Bulls,53,12895,2058,4713,0.437,596,1649,0.361,1462,3064,0.477,771,1004,0.768,496,1881,2377,1255,376,695,1021,5483
7819,2018-2-9,New York Knicks,56,13565,2239,4822,0.464,439,1226,0.358,1800,3596,0.501,881,1116,0.789,584,1905,2489,1280,378,830,1148,5798
7820,2018-2-9,Detroit Pistons,53,12745,2074,4579,0.453,567,1502,0.377,1507,3077,0.49,761,1018,0.748,523,1743,2266,1205,414,685,974,5476
7821,2018-2-9,Utah Jazz,54,13010,2050,4468,0.459,593,1580,0.375,1457,2888,0.505,880,1104,0.797,459,1779,2238,1154,489,754,1062,5573
7822,2018-2-9,Boston Celtics,56,13515,2125,4740,0.448,654,1758,0.372,1471,2982,0.493,872,1143,0.763,502,1984,2486,1238,409,745,1137,5776
7823,2018-2-9,Dallas Mavericks,55,13250,2074,4657,0.445,640,1779,0.36,1434,2878,0.498,796,1038,0.767,429,1797,2226,1218,392,653,1063,5584
7824,2018-2-9,San Antonio Spurs,56,13440,2155,4716,0.457,501,1377,0.364,1654,3339,0.495,869,1114,0.78,569,1928,2497,1266,413,741,946,5680
7825,2018-2-9,Miami Heat,55,13250,2069,4566,0.453,606,1699,0.357,1463,2867,0.51,781,1039,0.752,485,1855,2340,1204,385,775,1095,5525
7826,2018-2-9,Memphis Grizzlies,54,12985,1956,4399,0.445,500,1439,0.347,1456,2960,0.492,936,1176,0.796,502,1682,2184,1131,400,763,1261,5348
7827,2018-2-9,Sacramento Kings,53,12745,2039,4511,0.452,468,1224,0.382,1571,3287,0.478,669,922,0.726,492,1633,2125,1111,441,725,1053,5215
7828,2018-2-10,Golden State Warriors,55,13250,2384,4687,0.509,643,1639,0.392,1741,3048,0.571,940,1161,0.81,474,1961,2435,1672,447,856,1087,6351
7829,2018-2-10,Houston Rockets,54,13010,2121,4576,0.464,844,2300,0.367,1277,2276,0.561,1088,1381,0.788,496,1860,2356,1188,473,733,1070,6174
7830,2018-2-10,Toronto Raptors,54,13010,2215,4735,0.468,614,1736,0.354,1601,2999,0.534,972,1213,0.801,537,1818,2355,1240,447,693,1192,6016
7831,2018-2-10,New Orleans Pelicans,54,13135,2237,4638,0.482,573,1579,0.363,1664,3059,0.544,903,1191,0.758,450,1869,2319,1416,417,813,1038,5950
7832,2018-2-10,Cleveland Cavaliers,54,13010,2137,4520,0.473,649,1775,0.366,1488,2745,0.542,1006,1269,0.793,443,1812,2255,1277,381,752,995,5929
7833,2018-2-10,Minnesota Timberwolves,58,14020,2390,4983,0.48,461,1284,0.359,1929,3699,0.521,1115,1402,0.795,606,1815,2421,1321,512,685,1030,6356
7834,2018-2-10,Los Angeles Clippers,53,12745,2081,4497,0.463,538,1519,0.354,1543,2978,0.518,1005,1332,0.755,531,1781,2312,1171,416,757,1086,5705
7835,2018-2-10,Philadelphia 76ers,52,12580,2065,4442,0.465,541,1497,0.361,1524,2945,0.517,917,1196,0.767,571,1871,2442,1323,425,874,1189,5588
7836,2018-2-10,Washington Wizards,55,13300,2201,4726,0.466,539,1456,0.37,1662,3270,0.508,963,1256,0.767,553,1807,2360,1325,448,760,1189,5904
7837,2018-2-10,Denver Nuggets,55,13275,2191,4733,0.463,599,1664,0.36,1592,3069,0.519,901,1193,0.755,624,1845,2469,1326,421,808,976,5882
7838,2018-2-10,Los Angeles Lakers,54,13135,2199,4822,0.456,493,1493,0.33,1706,3329,0.512,872,1256,0.694,607,1905,2512,1265,442,836,1167,5763
7839,2018-2-10,Indiana Pacers,56,13490,2301,4784,0.481,516,1387,0.372,1785,3397,0.525,846,1096,0.772,497,1826,2323,1253,462,718,1053,5964
7840,2018-2-10,Oklahoma City Thunder,56,13540,2234,4927,0.453,569,1638,0.347,1665,3289,0.506,909,1284,0.708,706,1812,2518,1177,523,758,1133,5946
7841,2018-2-10,Charlotte Hornets,55,13275,2108,4767,0.442,526,1464,0.359,1582,3303,0.479,1094,1487,0.736,564,1950,2514,1140,379,679,985,5836
7842,2018-2-10,Orlando Magic,54,12985,2143,4647,0.461,560,1571,0.356,1583,3076,0.515,863,1140,0.757,487,1750,2237,1260,399,765,1074,5709
7843,2018-2-10,Brooklyn Nets,56,13515,2114,4836,0.437,663,1915,0.346,1451,2921,0.497,994,1294,0.768,560,1966,2526,1254,336,816,1157,5885
7844,2018-2-10,Portland Trail Blazers,56,13515,2192,4829,0.454,570,1501,0.38,1622,3328,0.487,917,1146,0.8,549,1969,2518,1072,382,751,1099,5871
7845,2018-2-10,Milwaukee Bucks,54,13010,2088,4374,0.477,462,1321,0.35,1626,3053,0.533,993,1287,0.772,419,1690,2109,1206,459,703,1183,5631
7846,2018-2-10,Phoenix Suns,56,13465,2137,4852,0.44,521,1563,0.333,1616,3289,0.491,1041,1371,0.759,602,1862,2464,1177,379,844,1248,5836
7847,2018-2-10,Atlanta Hawks,56,13465,2144,4756,0.451,620,1675,0.37,1524,3081,0.495,900,1133,0.794,530,1753,2283,1336,441,836,1109,5808
7848,2018-2-10,Chicago Bulls,54,13135,2099,4796,0.438,605,1675,0.361,1494,3121,0.479,794,1034,0.768,501,1915,2416,1277,381,706,1040,5597
7849,2018-2-10,New York Knicks,56,13565,2239,4822,0.464,439,1226,0.358,1800,3596,0.501,881,1116,0.789,584,1905,2489,1280,378,830,1148,5798
7850,2018-2-10,Utah Jazz,55,13250,2091,4552,0.459,603,1609,0.375,1488,2943,0.506,894,1121,0.798,466,1821,2287,1183,494,766,1079,5679
7851,2018-2-10,Detroit Pistons,54,12985,2110,4667,0.452,577,1533,0.376,1533,3134,0.489,774,1035,0.748,530,1776,2306,1227,419,694,990,5571
7852,2018-2-10,Boston Celtics,57,13755,2159,4829,0.447,661,1785,0.37,1498,3044,0.492,888,1163,0.764,514,2010,2524,1254,414,755,1158,5867
7853,2018-2-10,Dallas Mavericks,55,13250,2074,4657,0.445,640,1779,0.36,1434,2878,0.498,796,1038,0.767,429,1797,2226,1218,392,653,1063,5584
7854,2018-2-10,San Antonio Spurs,56,13440,2155,4716,0.457,501,1377,0.364,1654,3339,0.495,869,1114,0.78,569,1928,2497,1266,413,741,946,5680
7855,2018-2-10,Miami Heat,56,13490,2101,4654,0.451,616,1725,0.357,1485,2929,0.507,798,1057,0.755,498,1893,2391,1220,392,791,1116,5616
7856,2018-2-10,Memphis Grizzlies,54,12985,1956,4399,0.445,500,1439,0.347,1456,2960,0.492,936,1176,0.796,502,1682,2184,1131,400,763,1261,5348
7857,2018-2-10,Sacramento Kings,54,12985,2077,4601,0.451,477,1247,0.383,1600,3354,0.477,684,943,0.725,504,1664,2168,1136,446,737,1072,5315
7858,2018-2-11,Golden State Warriors,56,13490,2432,4772,0.51,655,1666,0.393,1777,3106,0.572,954,1176,0.811,485,1994,2479,1707,452,872,1105,6473
7859,2018-2-11,Houston Rockets,54,13010,2121,4576,0.464,844,2300,0.367,1277,2276,0.561,1088,1381,0.788,496,1860,2356,1188,473,733,1070,6174
7860,2018-2-11,Toronto Raptors,54,13010,2215,4735,0.468,614,1736,0.354,1601,2999,0.534,972,1213,0.801,537,1818,2355,1240,447,693,1192,6016
7861,2018-2-11,New Orleans Pelicans,55,13425,2289,4744,0.483,582,1603,0.363,1707,3141,0.543,928,1230,0.754,464,1914,2378,1439,427,828,1056,6088
7862,2018-2-11,Cleveland Cavaliers,54,13010,2137,4520,0.473,649,1775,0.366,1488,2745,0.542,1006,1269,0.793,443,1812,2255,1277,381,752,995,5929
7863,2018-2-11,Minnesota Timberwolves,58,14020,2390,4983,0.48,461,1284,0.359,1929,3699,0.521,1115,1402,0.795,606,1815,2421,1321,512,685,1030,6356
7864,2018-2-11,Los Angeles Clippers,54,12985,2119,4585,0.462,546,1551,0.352,1573,3034,0.518,1019,1355,0.752,542,1823,2365,1191,423,773,1102,5803
7865,2018-2-11,Philadelphia 76ers,53,12820,2108,4532,0.465,554,1530,0.362,1554,3002,0.518,930,1213,0.767,577,1910,2487,1355,437,886,1207,5700
7866,2018-2-11,Washington Wizards,56,13540,2239,4808,0.466,552,1494,0.369,1687,3314,0.509,975,1270,0.768,559,1842,2401,1356,456,773,1206,6005
7867,2018-2-11,Denver Nuggets,56,13515,2236,4821,0.464,612,1693,0.361,1624,3128,0.519,921,1215,0.758,630,1876,2506,1346,431,821,999,6005
7868,2018-2-11,Los Angeles Lakers,55,13375,2245,4906,0.458,509,1527,0.333,1736,3379,0.514,887,1278,0.694,616,1933,2549,1294,449,853,1192,5886
7869,2018-2-11,Indiana Pacers,56,13490,2301,4784,0.481,516,1387,0.372,1785,3397,0.525,846,1096,0.772,497,1826,2323,1253,462,718,1053,5964
7870,2018-2-11,Oklahoma City Thunder,56,13540,2234,4927,0.453,569,1638,0.347,1665,3289,0.506,909,1284,0.708,706,1812,2518,1177,523,758,1133,5946
7871,2018-2-11,Charlotte Hornets,55,13275,2108,4767,0.442,526,1464,0.359,1582,3303,0.479,1094,1487,0.736,564,1950,2514,1140,379,679,985,5836
7872,2018-2-11,Orlando Magic,55,13225,2180,4730,0.461,568,1601,0.355,1612,3129,0.515,885,1166,0.759,497,1781,2278,1283,406,777,1088,5813
7873,2018-2-11,Brooklyn Nets,57,13805,2157,4950,0.436,684,1974,0.347,1473,2976,0.495,1015,1316,0.771,578,2008,2586,1284,346,831,1187,6013
7874,2018-2-11,Portland Trail Blazers,56,13515,2192,4829,0.454,570,1501,0.38,1622,3328,0.487,917,1146,0.8,549,1969,2518,1072,382,751,1099,5871
7875,2018-2-11,Milwaukee Bucks,55,13250,2131,4456,0.478,471,1346,0.35,1660,3110,0.534,1009,1307,0.772,427,1723,2150,1234,466,715,1199,5742
7876,2018-2-11,Phoenix Suns,57,13705,2183,4936,0.442,528,1582,0.334,1655,3354,0.493,1055,1396,0.756,610,1890,2500,1201,386,859,1272,5949
7877,2018-2-11,Atlanta Hawks,56,13465,2144,4756,0.451,620,1675,0.37,1524,3081,0.495,900,1133,0.794,530,1753,2283,1336,441,836,1109,5808
7878,2018-2-11,New York Knicks,56,13565,2239,4822,0.464,439,1226,0.358,1800,3596,0.501,881,1116,0.789,584,1905,2489,1280,378,830,1148,5798
7879,2018-2-11,Chicago Bulls,55,13375,2133,4876,0.437,614,1707,0.36,1519,3169,0.479,807,1050,0.769,510,1951,2461,1300,392,720,1056,5687
7880,2018-2-11,Utah Jazz,55,13250,2091,4552,0.459,603,1609,0.375,1488,2943,0.506,894,1121,0.798,466,1821,2287,1183,494,766,1079,5679
7881,2018-2-11,Detroit Pistons,54,12985,2110,4667,0.452,577,1533,0.376,1533,3134,0.489,774,1035,0.748,530,1776,2306,1227,419,694,990,5571
7882,2018-2-11,Boston Celtics,57,13755,2159,4829,0.447,661,1785,0.37,1498,3044,0.492,888,1163,0.764,514,2010,2524,1254,414,755,1158,5867
7883,2018-2-11,Dallas Mavericks,56,13490,2122,4746,0.447,652,1806,0.361,1470,2940,0.5,818,1065,0.768,439,1827,2266,1250,400,662,1084,5714
7884,2018-2-11,San Antonio Spurs,57,13680,2198,4810,0.457,506,1404,0.36,1692,3406,0.497,883,1133,0.779,580,1951,2531,1296,421,751,959,5785
7885,2018-2-11,Miami Heat,56,13490,2101,4654,0.451,616,1725,0.357,1485,2929,0.507,798,1057,0.755,498,1893,2391,1220,392,791,1116,5616
7886,2018-2-11,Memphis Grizzlies,54,12985,1956,4399,0.445,500,1439,0.347,1456,2960,0.492,936,1176,0.796,502,1682,2184,1131,400,763,1261,5348
7887,2018-2-11,Sacramento Kings,54,12985,2077,4601,0.451,477,1247,0.383,1600,3354,0.477,684,943,0.725,504,1664,2168,1136,446,737,1072,5315
7888,2018-2-12,Golden State Warriors,56,13490,2432,4772,0.51,655,1666,0.393,1777,3106,0.572,954,1176,0.811,485,1994,2479,1707,452,872,1105,6473
7889,2018-2-12,Houston Rockets,55,13250,2155,4654,0.463,857,2345,0.365,1298,2309,0.562,1111,1414,0.786,498,1900,2398,1203,482,742,1088,6278
7890,2018-2-12,Toronto Raptors,55,13250,2264,4822,0.47,632,1773,0.356,1632,3049,0.535,979,1223,0.8,543,1852,2395,1275,454,705,1216,6139
7891,2018-2-12,New Orleans Pelicans,55,13425,2289,4744,0.483,582,1603,0.363,1707,3141,0.543,928,1230,0.754,464,1914,2378,1439,427,828,1056,6088
7892,2018-2-12,Cleveland Cavaliers,55,13250,2182,4604,0.474,665,1805,0.368,1517,2799,0.542,1021,1289,0.792,448,1848,2296,1299,388,763,1015,6050
7893,2018-2-12,Minnesota Timberwolves,59,14260,2427,5057,0.48,470,1308,0.359,1957,3749,0.522,1143,1434,0.797,614,1844,2458,1350,522,701,1047,6467
7894,2018-2-12,Los Angeles Clippers,54,12985,2119,4585,0.462,546,1551,0.352,1573,3034,0.518,1019,1355,0.752,542,1823,2365,1191,423,773,1102,5803
7895,2018-2-12,Philadelphia 76ers,53,12820,2108,4532,0.465,554,1530,0.362,1554,3002,0.518,930,1213,0.767,577,1910,2487,1355,437,886,1207,5700
7896,2018-2-12,Washington Wizards,56,13540,2239,4808,0.466,552,1494,0.369,1687,3314,0.509,975,1270,0.768,559,1842,2401,1356,456,773,1206,6005
7897,2018-2-12,Denver Nuggets,56,13515,2236,4821,0.464,612,1693,0.361,1624,3128,0.519,921,1215,0.758,630,1876,2506,1346,431,821,999,6005
7898,2018-2-12,Los Angeles Lakers,55,13375,2245,4906,0.458,509,1527,0.333,1736,3379,0.514,887,1278,0.694,616,1933,2549,1294,449,853,1192,5886
7899,2018-2-12,Indiana Pacers,57,13730,2348,4878,0.481,528,1415,0.373,1820,3463,0.526,861,1118,0.77,513,1864,2377,1280,469,731,1069,6085
7900,2018-2-12,Oklahoma City Thunder,57,13780,2268,5004,0.453,585,1675,0.349,1683,3329,0.506,935,1324,0.706,715,1841,2556,1198,529,767,1156,6056
7901,2018-2-12,Charlotte Hornets,56,13515,2146,4856,0.442,536,1487,0.36,1610,3369,0.478,1111,1510,0.736,575,1981,2556,1166,384,692,998,5939
7902,2018-2-12,Orlando Magic,55,13225,2180,4730,0.461,568,1601,0.355,1612,3129,0.515,885,1166,0.759,497,1781,2278,1283,406,777,1088,5813
7903,2018-2-12,Brooklyn Nets,57,13805,2157,4950,0.436,684,1974,0.347,1473,2976,0.495,1015,1316,0.771,578,2008,2586,1284,346,831,1187,6013
7904,2018-2-12,Portland Trail Blazers,57,13755,2225,4910,0.453,579,1526,0.379,1646,3384,0.486,938,1171,0.801,555,2000,2555,1088,389,764,1121,5967
7905,2018-2-12,Milwaukee Bucks,55,13250,2131,4456,0.478,471,1346,0.35,1660,3110,0.534,1009,1307,0.772,427,1723,2150,1234,466,715,1199,5742
7906,2018-2-12,Phoenix Suns,57,13705,2183,4936,0.442,528,1582,0.334,1655,3354,0.493,1055,1396,0.756,610,1890,2500,1201,386,859,1272,5949
7907,2018-2-12,Atlanta Hawks,57,13705,2182,4834,0.451,630,1704,0.37,1552,3130,0.496,932,1170,0.797,534,1784,2318,1363,451,849,1135,5926
7908,2018-2-12,New York Knicks,57,13805,2280,4915,0.464,448,1261,0.355,1832,3654,0.501,903,1141,0.791,596,1938,2534,1307,386,841,1166,5911
7909,2018-2-12,Utah Jazz,56,13490,2132,4640,0.459,616,1635,0.377,1516,3005,0.504,914,1143,0.8,482,1863,2345,1206,502,779,1101,5794
7910,2018-2-12,Detroit Pistons,55,13225,2148,4750,0.452,590,1566,0.377,1558,3184,0.489,800,1068,0.749,542,1804,2346,1257,425,709,1018,5686
7911,2018-2-12,Chicago Bulls,55,13375,2133,4876,0.437,614,1707,0.36,1519,3169,0.479,807,1050,0.769,510,1951,2461,1300,392,720,1056,5687
7912,2018-2-12,Boston Celtics,58,13995,2195,4918,0.446,671,1823,0.368,1524,3095,0.492,905,1185,0.764,527,2040,2567,1276,417,769,1172,5966
7913,2018-2-12,Dallas Mavericks,57,13730,2160,4839,0.446,662,1837,0.36,1498,3002,0.499,829,1081,0.767,451,1867,2318,1276,406,676,1109,5811
7914,2018-2-12,San Antonio Spurs,57,13680,2198,4810,0.457,506,1404,0.36,1692,3406,0.497,883,1133,0.779,580,1951,2531,1296,421,751,959,5785
7915,2018-2-12,Miami Heat,56,13490,2101,4654,0.451,616,1725,0.357,1485,2929,0.507,798,1057,0.755,498,1893,2391,1220,392,791,1116,5616
7916,2018-2-12,Memphis Grizzlies,55,13225,1988,4481,0.444,506,1467,0.345,1482,3014,0.492,958,1200,0.798,514,1717,2231,1152,404,780,1293,5440
7917,2018-2-12,Sacramento Kings,55,13225,2119,4689,0.452,487,1272,0.383,1632,3417,0.478,696,960,0.725,519,1692,2211,1153,458,755,1095,5421
7918,2018-2-13,Golden State Warriors,57,13730,2484,4861,0.511,666,1692,0.394,1818,3169,0.574,968,1197,0.809,492,2036,2528,1743,460,883,1123,6602
7919,2018-2-13,Houston Rockets,55,13250,2155,4654,0.463,857,2345,0.365,1298,2309,0.562,1111,1414,0.786,498,1900,2398,1203,482,742,1088,6278
7920,2018-2-13,Toronto Raptors,55,13250,2264,4822,0.47,632,1773,0.356,1632,3049,0.535,979,1223,0.8,543,1852,2395,1275,454,705,1216,6139
7921,2018-2-13,New Orleans Pelicans,56,13665,2333,4844,0.482,596,1637,0.364,1737,3207,0.542,944,1246,0.758,474,1957,2431,1470,433,839,1081,6206
7922,2018-2-13,Cleveland Cavaliers,55,13250,2182,4604,0.474,665,1805,0.368,1517,2799,0.542,1021,1289,0.792,448,1848,2296,1299,388,763,1015,6050
7923,2018-2-13,Minnesota Timberwolves,59,14260,2427,5057,0.48,470,1308,0.359,1957,3749,0.522,1143,1434,0.797,614,1844,2458,1350,522,701,1047,6467
7924,2018-2-13,Los Angeles Clippers,55,13225,2167,4670,0.464,552,1567,0.352,1615,3103,0.52,1031,1369,0.753,550,1858,2408,1210,431,788,1116,5917
7925,2018-2-13,Philadelphia 76ers,54,13060,2149,4607,0.466,564,1549,0.364,1585,3058,0.518,946,1237,0.765,584,1940,2524,1382,450,903,1229,5808
7926,2018-2-13,Washington Wizards,56,13540,2239,4808,0.466,552,1494,0.369,1687,3314,0.509,975,1270,0.768,559,1842,2401,1356,456,773,1206,6005
7927,2018-2-13,Denver Nuggets,56,13515,2236,4821,0.464,612,1693,0.361,1624,3128,0.519,921,1215,0.758,630,1876,2506,1346,431,821,999,6005
7928,2018-2-13,Los Angeles Lakers,55,13375,2245,4906,0.458,509,1527,0.333,1736,3379,0.514,887,1278,0.694,616,1933,2549,1294,449,853,1192,5886
7929,2018-2-13,Indiana Pacers,57,13730,2348,4878,0.481,528,1415,0.373,1820,3463,0.526,861,1118,0.77,513,1864,2377,1280,469,731,1069,6085
7930,2018-2-13,Oklahoma City Thunder,57,13780,2268,5004,0.453,585,1675,0.349,1683,3329,0.506,935,1324,0.706,715,1841,2556,1198,529,767,1156,6056
7931,2018-2-13,Charlotte Hornets,56,13515,2146,4856,0.442,536,1487,0.36,1610,3369,0.478,1111,1510,0.736,575,1981,2556,1166,384,692,998,5939
7932,2018-2-13,Orlando Magic,56,13465,2217,4814,0.461,578,1632,0.354,1639,3182,0.515,902,1185,0.761,504,1813,2317,1307,414,786,1106,5914
7933,2018-2-13,Brooklyn Nets,58,14045,2198,5039,0.436,696,2014,0.346,1502,3025,0.497,1022,1326,0.771,588,2035,2623,1311,356,843,1202,6114
7934,2018-2-13,Portland Trail Blazers,57,13755,2225,4910,0.453,579,1526,0.379,1646,3384,0.486,938,1171,0.801,555,2000,2555,1088,389,764,1121,5967
7935,2018-2-13,Milwaukee Bucks,55,13250,2131,4456,0.478,471,1346,0.35,1660,3110,0.534,1009,1307,0.772,427,1723,2150,1234,466,715,1199,5742
7936,2018-2-13,Atlanta Hawks,57,13705,2182,4834,0.451,630,1704,0.37,1552,3130,0.496,932,1170,0.797,534,1784,2318,1363,451,849,1135,5926
7937,2018-2-13,Phoenix Suns,58,13945,2216,5031,0.44,531,1605,0.331,1685,3426,0.492,1069,1418,0.754,625,1922,2547,1214,388,874,1289,6032
7938,2018-2-13,New York Knicks,58,14045,2311,4994,0.463,454,1285,0.353,1857,3709,0.501,927,1169,0.793,603,1964,2567,1323,391,860,1188,6003
7939,2018-2-13,Detroit Pistons,56,13465,2183,4845,0.451,599,1601,0.374,1584,3244,0.488,824,1100,0.749,556,1844,2400,1275,430,723,1037,5789
7940,2018-2-13,Utah Jazz,57,13730,2167,4724,0.459,627,1659,0.378,1540,3065,0.502,934,1173,0.796,491,1897,2388,1221,509,788,1125,5895
7941,2018-2-13,Chicago Bulls,56,13615,2173,4964,0.438,623,1739,0.358,1550,3225,0.481,823,1071,0.768,521,1986,2507,1325,398,731,1069,5792
7942,2018-2-13,Boston Celtics,58,13995,2195,4918,0.446,671,1823,0.368,1524,3095,0.492,905,1185,0.764,527,2040,2567,1276,417,769,1172,5966
7943,2018-2-13,Dallas Mavericks,57,13730,2160,4839,0.446,662,1837,0.36,1498,3002,0.499,829,1081,0.767,451,1867,2318,1276,406,676,1109,5811
7944,2018-2-13,San Antonio Spurs,58,13920,2236,4895,0.457,512,1429,0.358,1724,3466,0.497,900,1158,0.777,588,1987,2575,1319,426,762,983,5884
7945,2018-2-13,Miami Heat,56,13490,2101,4654,0.451,616,1725,0.357,1485,2929,0.507,798,1057,0.755,498,1893,2391,1220,392,791,1116,5616
7946,2018-2-13,Memphis Grizzlies,55,13225,1988,4481,0.444,506,1467,0.345,1482,3014,0.492,958,1200,0.798,514,1717,2231,1152,404,780,1293,5440
7947,2018-2-13,Sacramento Kings,55,13225,2119,4689,0.452,487,1272,0.383,1632,3417,0.478,696,960,0.725,519,1692,2211,1153,458,755,1095,5421
7948,2018-2-14,Golden State Warriors,57,13730,2484,4861,0.511,666,1692,0.394,1818,3169,0.574,968,1197,0.809,492,2036,2528,1743,460,883,1123,6602
7949,2018-2-14,Houston Rockets,56,13490,2196,4737,0.464,879,2392,0.367,1317,2345,0.562,1133,1443,0.785,507,1928,2435,1228,483,748,1111,6404
7950,2018-2-14,Toronto Raptors,56,13490,2306,4912,0.469,645,1808,0.357,1661,3104,0.535,997,1246,0.8,550,1885,2435,1299,461,713,1235,6254
7951,2018-2-14,New Orleans Pelicans,56,13665,2333,4844,0.482,596,1637,0.364,1737,3207,0.542,944,1246,0.758,474,1957,2431,1470,433,839,1081,6206
7952,2018-2-14,Cleveland Cavaliers,56,13490,2227,4692,0.475,681,1841,0.37,1546,2851,0.542,1035,1311,0.789,458,1879,2337,1323,394,770,1043,6170
7953,2018-2-14,Minnesota Timberwolves,60,14500,2467,5141,0.48,476,1331,0.358,1991,3810,0.523,1165,1457,0.8,623,1875,2498,1372,525,709,1067,6575
7954,2018-2-14,Los Angeles Clippers,55,13225,2167,4670,0.464,552,1567,0.352,1615,3103,0.52,1031,1369,0.753,550,1858,2408,1210,431,788,1116,5917
7955,2018-2-14,Philadelphia 76ers,54,13060,2149,4607,0.466,564,1549,0.364,1585,3058,0.518,946,1237,0.765,584,1940,2524,1382,450,903,1229,5808
7956,2018-2-14,Denver Nuggets,57,13755,2282,4914,0.464,622,1725,0.361,1660,3189,0.521,936,1233,0.759,641,1900,2541,1375,441,832,1017,6122
7957,2018-2-14,Washington Wizards,56,13540,2239,4808,0.466,552,1494,0.369,1687,3314,0.509,975,1270,0.768,559,1842,2401,1356,456,773,1206,6005
7958,2018-2-14,Los Angeles Lakers,55,13375,2245,4906,0.458,509,1527,0.333,1736,3379,0.514,887,1278,0.694,616,1933,2549,1294,449,853,1192,5886
7959,2018-2-14,Indiana Pacers,57,13730,2348,4878,0.481,528,1415,0.373,1820,3463,0.526,861,1118,0.77,513,1864,2377,1280,469,731,1069,6085
7960,2018-2-14,Oklahoma City Thunder,58,14020,2308,5094,0.453,596,1710,0.349,1712,3384,0.506,956,1354,0.706,733,1874,2607,1221,535,776,1176,6168
7961,2018-2-14,Charlotte Hornets,56,13515,2146,4856,0.442,536,1487,0.36,1610,3369,0.478,1111,1510,0.736,575,1981,2556,1166,384,692,998,5939
7962,2018-2-14,Orlando Magic,56,13465,2217,4814,0.461,578,1632,0.354,1639,3182,0.515,902,1185,0.761,504,1813,2317,1307,414,786,1106,5914
7963,2018-2-14,Brooklyn Nets,58,14045,2198,5039,0.436,696,2014,0.346,1502,3025,0.497,1022,1326,0.771,588,2035,2623,1311,356,843,1202,6114
7964,2018-2-14,Portland Trail Blazers,57,13755,2225,4910,0.453,579,1526,0.379,1646,3384,0.486,938,1171,0.801,555,2000,2555,1088,389,764,1121,5967
7965,2018-2-14,Milwaukee Bucks,56,13490,2169,4544,0.477,479,1371,0.349,1690,3173,0.533,1022,1324,0.772,441,1757,2198,1257,472,725,1217,5839
7966,2018-2-14,Phoenix Suns,58,13945,2216,5031,0.44,531,1605,0.331,1685,3426,0.492,1069,1418,0.754,625,1922,2547,1214,388,874,1289,6032
7967,2018-2-14,Atlanta Hawks,58,13945,2215,4920,0.45,642,1739,0.369,1573,3181,0.494,946,1190,0.795,548,1820,2368,1384,458,861,1149,6018
7968,2018-2-14,New York Knicks,58,14045,2311,4994,0.463,454,1285,0.353,1857,3709,0.501,927,1169,0.793,603,1964,2567,1323,391,860,1188,6003
7969,2018-2-14,Detroit Pistons,56,13465,2183,4845,0.451,599,1601,0.374,1584,3244,0.488,824,1100,0.749,556,1844,2400,1275,430,723,1037,5789
7970,2018-2-14,Utah Jazz,57,13730,2167,4724,0.459,627,1659,0.378,1540,3065,0.502,934,1173,0.796,491,1897,2388,1221,509,788,1125,5895
7971,2018-2-14,Chicago Bulls,56,13615,2173,4964,0.438,623,1739,0.358,1550,3225,0.481,823,1071,0.768,521,1986,2507,1325,398,731,1069,5792
7972,2018-2-14,Boston Celtics,58,13995,2195,4918,0.446,671,1823,0.368,1524,3095,0.492,905,1185,0.764,527,2040,2567,1276,417,769,1172,5966
7973,2018-2-14,Dallas Mavericks,58,13970,2198,4922,0.447,677,1877,0.361,1521,3045,0.5,847,1104,0.767,455,1900,2355,1305,410,685,1124,5920
7974,2018-2-14,San Antonio Spurs,59,14160,2280,4977,0.458,518,1451,0.357,1762,3526,0.5,915,1180,0.775,598,2019,2617,1343,432,780,1005,5993
7975,2018-2-14,Miami Heat,57,13730,2143,4740,0.452,628,1754,0.358,1515,2986,0.507,814,1076,0.757,508,1934,2442,1244,397,807,1134,5728
7976,2018-2-14,Memphis Grizzlies,55,13225,1988,4481,0.444,506,1467,0.345,1482,3014,0.492,958,1200,0.798,514,1717,2231,1152,404,780,1293,5440
7977,2018-2-14,Sacramento Kings,56,13465,2166,4776,0.454,499,1301,0.384,1667,3475,0.48,704,972,0.724,524,1725,2249,1183,464,764,1114,5535
7978,2018-2-15,Golden State Warriors,58,13970,2527,4951,0.51,679,1729,0.393,1848,3222,0.574,986,1216,0.811,500,2069,2569,1767,468,899,1147,6719
7979,2018-2-15,Houston Rockets,57,13730,2229,4820,0.462,893,2441,0.366,1336,2379,0.562,1153,1465,0.787,514,1969,2483,1247,493,761,1125,6504
7980,2018-2-15,Toronto Raptors,57,13730,2354,5004,0.47,659,1846,0.357,1695,3158,0.537,1009,1261,0.8,555,1930,2485,1337,466,720,1257,6376
7981,2018-2-15,New Orleans Pelicans,57,13905,2386,4943,0.483,610,1669,0.365,1776,3274,0.542,963,1267,0.76,486,1993,2479,1505,446,850,1101,6345
7982,2018-2-15,Cleveland Cavaliers,56,13490,2227,4692,0.475,681,1841,0.37,1546,2851,0.542,1035,1311,0.789,458,1879,2337,1323,394,770,1043,6170
7983,2018-2-15,Minnesota Timberwolves,60,14500,2467,5141,0.48,476,1331,0.358,1991,3810,0.523,1165,1457,0.8,623,1875,2498,1372,525,709,1067,6575
7984,2018-2-15,Los Angeles Clippers,56,13465,2211,4758,0.465,563,1596,0.353,1648,3162,0.521,1061,1402,0.757,557,1894,2451,1236,436,795,1137,6046
7985,2018-2-15,Philadelphia 76ers,55,13300,2188,4699,0.466,573,1584,0.362,1615,3115,0.518,963,1262,0.763,607,1977,2584,1407,456,920,1252,5912
7986,2018-2-15,Washington Wizards,57,13780,2287,4896,0.467,559,1516,0.369,1728,3380,0.511,990,1289,0.768,565,1881,2446,1387,463,784,1222,6123
7987,2018-2-15,Denver Nuggets,57,13755,2282,4914,0.464,622,1725,0.361,1660,3189,0.521,936,1233,0.759,641,1900,2541,1375,441,832,1017,6122
7988,2018-2-15,Los Angeles Lakers,56,13615,2291,4996,0.459,519,1549,0.335,1772,3447,0.514,902,1296,0.696,623,1963,2586,1320,454,873,1213,6003
7989,2018-2-15,Indiana Pacers,58,13970,2387,4968,0.48,534,1430,0.373,1853,3538,0.524,885,1146,0.772,528,1901,2429,1300,479,739,1089,6193
7990,2018-2-15,Oklahoma City Thunder,59,14260,2348,5174,0.454,613,1746,0.351,1735,3428,0.506,980,1389,0.706,741,1904,2645,1247,542,785,1195,6289
7991,2018-2-15,Charlotte Hornets,57,13755,2184,4944,0.442,549,1517,0.362,1635,3427,0.477,1126,1529,0.736,583,2018,2601,1192,398,704,1013,6043
7992,2018-2-15,Orlando Magic,57,13705,2253,4900,0.46,593,1669,0.355,1660,3231,0.514,917,1202,0.763,513,1852,2365,1328,421,806,1123,6016
7993,2018-2-15,Brooklyn Nets,59,14285,2233,5122,0.436,709,2049,0.346,1524,3073,0.496,1042,1353,0.77,597,2070,2667,1335,360,856,1222,6217
7994,2018-2-15,Portland Trail Blazers,58,13995,2270,5003,0.454,591,1559,0.379,1679,3444,0.488,959,1195,0.803,568,2036,2604,1108,398,777,1139,6090
7995,2018-2-15,Milwaukee Bucks,56,13490,2169,4544,0.477,479,1371,0.349,1690,3173,0.533,1022,1324,0.772,441,1757,2198,1257,472,725,1217,5839
7996,2018-2-15,Phoenix Suns,59,14185,2250,5110,0.44,543,1634,0.332,1707,3476,0.491,1086,1442,0.753,630,1958,2588,1233,393,886,1314,6129
7997,2018-2-15,Atlanta Hawks,59,14185,2253,5009,0.45,648,1772,0.366,1605,3237,0.496,962,1209,0.796,556,1855,2411,1409,467,872,1170,6116
7998,2018-2-15,New York Knicks,59,14285,2356,5091,0.463,463,1304,0.355,1893,3787,0.5,941,1187,0.793,614,1995,2609,1344,398,870,1205,6116
7999,2018-2-15,Utah Jazz,58,13970,2206,4816,0.458,637,1693,0.376,1569,3123,0.502,953,1195,0.797,505,1937,2442,1243,515,796,1142,6002
8000,2018-2-15,Detroit Pistons,57,13705,2218,4928,0.45,612,1634,0.375,1606,3294,0.488,845,1125,0.751,566,1881,2447,1301,433,739,1055,5893
8001,2018-2-15,Chicago Bulls,57,13855,2212,5055,0.438,627,1763,0.356,1585,3292,0.481,839,1091,0.769,525,2024,2549,1342,403,737,1085,5890
8002,2018-2-15,Boston Celtics,59,14235,2237,5015,0.446,686,1854,0.37,1551,3161,0.491,925,1206,0.767,538,2075,2613,1300,421,777,1203,6085
8003,2018-2-15,Dallas Mavericks,58,13970,2198,4922,0.447,677,1877,0.361,1521,3045,0.5,847,1104,0.767,455,1900,2355,1305,410,685,1124,5920
8004,2018-2-15,San Antonio Spurs,59,14160,2280,4977,0.458,518,1451,0.357,1762,3526,0.5,915,1180,0.775,598,2019,2617,1343,432,780,1005,5993
8005,2018-2-15,Miami Heat,58,13970,2178,4817,0.452,639,1781,0.359,1539,3036,0.507,835,1105,0.756,511,1960,2471,1267,406,817,1155,5830
8006,2018-2-15,Memphis Grizzlies,56,13465,2032,4567,0.445,520,1494,0.348,1512,3073,0.492,970,1215,0.798,520,1752,2272,1181,410,792,1318,5554
8007,2018-2-15,Sacramento Kings,57,13705,2204,4863,0.453,509,1333,0.382,1695,3530,0.48,709,980,0.723,533,1764,2297,1209,472,781,1134,5626
8008,2018-2-16,Golden State Warriors,58,13970,2527,4951,0.51,679,1729,0.393,1848,3222,0.574,986,1216,0.811,500,2069,2569,1767,468,899,1147,6719
8009,2018-2-16,Houston Rockets,57,13730,2229,4820,0.462,893,2441,0.366,1336,2379,0.562,1153,1465,0.787,514,1969,2483,1247,493,761,1125,6504
8010,2018-2-16,Toronto Raptors,57,13730,2354,5004,0.47,659,1846,0.357,1695,3158,0.537,1009,1261,0.8,555,1930,2485,1337,466,720,1257,6376
8011,2018-2-16,New Orleans Pelicans,57,13905,2386,4943,0.483,610,1669,0.365,1776,3274,0.542,963,1267,0.76,486,1993,2479,1505,446,850,1101,6345
8012,2018-2-16,Cleveland Cavaliers,56,13490,2227,4692,0.475,681,1841,0.37,1546,2851,0.542,1035,1311,0.789,458,1879,2337,1323,394,770,1043,6170
8013,2018-2-16,Minnesota Timberwolves,61,14740,2509,5231,0.48,482,1355,0.356,2027,3876,0.523,1194,1488,0.802,634,1910,2544,1395,530,719,1089,6694
8014,2018-2-16,Los Angeles Clippers,56,13465,2211,4758,0.465,563,1596,0.353,1648,3162,0.521,1061,1402,0.757,557,1894,2451,1236,436,795,1137,6046
8015,2018-2-16,Denver Nuggets,58,13995,2329,4999,0.466,646,1765,0.366,1683,3234,0.52,952,1253,0.76,649,1926,2575,1412,450,850,1040,6256
8016,2018-2-16,Philadelphia 76ers,55,13300,2188,4699,0.466,573,1584,0.362,1615,3115,0.518,963,1262,0.763,607,1977,2584,1407,456,920,1252,5912
8017,2018-2-16,Washington Wizards,57,13780,2287,4896,0.467,559,1516,0.369,1728,3380,0.511,990,1289,0.768,565,1881,2446,1387,463,784,1222,6123
8018,2018-2-16,Los Angeles Lakers,57,13855,2334,5090,0.459,526,1580,0.333,1808,3510,0.515,920,1322,0.696,634,1998,2632,1339,460,886,1239,6114
8019,2018-2-16,Indiana Pacers,58,13970,2387,4968,0.48,534,1430,0.373,1853,3538,0.524,885,1146,0.772,528,1901,2429,1300,479,739,1089,6193
8020,2018-2-16,Oklahoma City Thunder,59,14260,2348,5174,0.454,613,1746,0.351,1735,3428,0.506,980,1389,0.706,741,1904,2645,1247,542,785,1195,6289
8021,2018-2-16,Charlotte Hornets,57,13755,2184,4944,0.442,549,1517,0.362,1635,3427,0.477,1126,1529,0.736,583,2018,2601,1192,398,704,1013,6043
8022,2018-2-16,Orlando Magic,57,13705,2253,4900,0.46,593,1669,0.355,1660,3231,0.514,917,1202,0.763,513,1852,2365,1328,421,806,1123,6016
8023,2018-2-16,Brooklyn Nets,59,14285,2233,5122,0.436,709,2049,0.346,1524,3073,0.496,1042,1353,0.77,597,2070,2667,1335,360,856,1222,6217
8024,2018-2-16,Portland Trail Blazers,58,13995,2270,5003,0.454,591,1559,0.379,1679,3444,0.488,959,1195,0.803,568,2036,2604,1108,398,777,1139,6090
8025,2018-2-16,Milwaukee Bucks,57,13730,2218,4636,0.478,488,1397,0.349,1730,3239,0.534,1038,1346,0.771,452,1786,2238,1284,481,741,1237,5962
8026,2018-2-16,Phoenix Suns,59,14185,2250,5110,0.44,543,1634,0.332,1707,3476,0.491,1086,1442,0.753,630,1958,2588,1233,393,886,1314,6129
8027,2018-2-16,Atlanta Hawks,59,14185,2253,5009,0.45,648,1772,0.366,1605,3237,0.496,962,1209,0.796,556,1855,2411,1409,467,872,1170,6116
8028,2018-2-16,New York Knicks,59,14285,2356,5091,0.463,463,1304,0.355,1893,3787,0.5,941,1187,0.793,614,1995,2609,1344,398,870,1205,6116
8029,2018-2-16,Utah Jazz,58,13970,2206,4816,0.458,637,1693,0.376,1569,3123,0.502,953,1195,0.797,505,1937,2442,1243,515,796,1142,6002
8030,2018-2-16,Detroit Pistons,57,13705,2218,4928,0.45,612,1634,0.375,1606,3294,0.488,845,1125,0.751,566,1881,2447,1301,433,739,1055,5893
8031,2018-2-16,Chicago Bulls,57,13855,2212,5055,0.438,627,1763,0.356,1585,3292,0.481,839,1091,0.769,525,2024,2549,1342,403,737,1085,5890
8032,2018-2-16,Boston Celtics,59,14235,2237,5015,0.446,686,1854,0.37,1551,3161,0.491,925,1206,0.767,538,2075,2613,1300,421,777,1203,6085
8033,2018-2-16,Dallas Mavericks,58,13970,2198,4922,0.447,677,1877,0.361,1521,3045,0.5,847,1104,0.767,455,1900,2355,1305,410,685,1124,5920
8034,2018-2-16,San Antonio Spurs,59,14160,2280,4977,0.458,518,1451,0.357,1762,3526,0.5,915,1180,0.775,598,2019,2617,1343,432,780,1005,5993
8035,2018-2-16,Miami Heat,58,13970,2178,4817,0.452,639,1781,0.359,1539,3036,0.507,835,1105,0.756,511,1960,2471,1267,406,817,1155,5830
8036,2018-2-16,Memphis Grizzlies,56,13465,2032,4567,0.445,520,1494,0.348,1512,3073,0.492,970,1215,0.798,520,1752,2272,1181,410,792,1318,5554
8037,2018-2-16,Sacramento Kings,57,13705,2204,4863,0.453,509,1333,0.382,1695,3530,0.48,709,980,0.723,533,1764,2297,1209,472,781,1134,5626
8038,2018-2-17,Golden State Warriors,58,13970,2527,4951,0.51,679,1729,0.393,1848,3222,0.574,986,1216,0.811,500,2069,2569,1767,468,899,1147,6719
8039,2018-2-17,Houston Rockets,57,13730,2229,4820,0.462,893,2441,0.366,1336,2379,0.562,1153,1465,0.787,514,1969,2483,1247,493,761,1125,6504
8040,2018-2-17,Toronto Raptors,57,13730,2354,5004,0.47,659,1846,0.357,1695,3158,0.537,1009,1261,0.8,555,1930,2485,1337,466,720,1257,6376
8041,2018-2-17,New Orleans Pelicans,57,13905,2386,4943,0.483,610,1669,0.365,1776,3274,0.542,963,1267,0.76,486,1993,2479,1505,446,850,1101,6345
8042,2018-2-17,Cleveland Cavaliers,56,13490,2227,4692,0.475,681,1841,0.37,1546,2851,0.542,1035,1311,0.789,458,1879,2337,1323,394,770,1043,6170
8043,2018-2-17,Minnesota Timberwolves,61,14740,2509,5231,0.48,482,1355,0.356,2027,3876,0.523,1194,1488,0.802,634,1910,2544,1395,530,719,1089,6694
8044,2018-2-17,Los Angeles Clippers,56,13465,2211,4758,0.465,563,1596,0.353,1648,3162,0.521,1061,1402,0.757,557,1894,2451,1236,436,795,1137,6046
8045,2018-2-17,Denver Nuggets,58,13995,2329,4999,0.466,646,1765,0.366,1683,3234,0.52,952,1253,0.76,649,1926,2575,1412,450,850,1040,6256
8046,2018-2-17,Philadelphia 76ers,55,13300,2188,4699,0.466,573,1584,0.362,1615,3115,0.518,963,1262,0.763,607,1977,2584,1407,456,920,1252,5912
8047,2018-2-17,Washington Wizards,57,13780,2287,4896,0.467,559,1516,0.369,1728,3380,0.511,990,1289,0.768,565,1881,2446,1387,463,784,1222,6123
8048,2018-2-17,Los Angeles Lakers,57,13855,2334,5090,0.459,526,1580,0.333,1808,3510,0.515,920,1322,0.696,634,1998,2632,1339,460,886,1239,6114
8049,2018-2-17,Indiana Pacers,58,13970,2387,4968,0.48,534,1430,0.373,1853,3538,0.524,885,1146,0.772,528,1901,2429,1300,479,739,1089,6193
8050,2018-2-17,Oklahoma City Thunder,59,14260,2348,5174,0.454,613,1746,0.351,1735,3428,0.506,980,1389,0.706,741,1904,2645,1247,542,785,1195,6289
8051,2018-2-17,Charlotte Hornets,57,13755,2184,4944,0.442,549,1517,0.362,1635,3427,0.477,1126,1529,0.736,583,2018,2601,1192,398,704,1013,6043
8052,2018-2-17,Orlando Magic,57,13705,2253,4900,0.46,593,1669,0.355,1660,3231,0.514,917,1202,0.763,513,1852,2365,1328,421,806,1123,6016
8053,2018-2-17,Brooklyn Nets,59,14285,2233,5122,0.436,709,2049,0.346,1524,3073,0.496,1042,1353,0.77,597,2070,2667,1335,360,856,1222,6217
8054,2018-2-17,Portland Trail Blazers,58,13995,2270,5003,0.454,591,1559,0.379,1679,3444,0.488,959,1195,0.803,568,2036,2604,1108,398,777,1139,6090
8055,2018-2-17,Milwaukee Bucks,57,13730,2218,4636,0.478,488,1397,0.349,1730,3239,0.534,1038,1346,0.771,452,1786,2238,1284,481,741,1237,5962
8056,2018-2-17,Phoenix Suns,59,14185,2250,5110,0.44,543,1634,0.332,1707,3476,0.491,1086,1442,0.753,630,1958,2588,1233,393,886,1314,6129
8057,2018-2-17,Atlanta Hawks,59,14185,2253,5009,0.45,648,1772,0.366,1605,3237,0.496,962,1209,0.796,556,1855,2411,1409,467,872,1170,6116
8058,2018-2-17,New York Knicks,59,14285,2356,5091,0.463,463,1304,0.355,1893,3787,0.5,941,1187,0.793,614,1995,2609,1344,398,870,1205,6116
8059,2018-2-17,Utah Jazz,58,13970,2206,4816,0.458,637,1693,0.376,1569,3123,0.502,953,1195,0.797,505,1937,2442,1243,515,796,1142,6002
8060,2018-2-17,Detroit Pistons,57,13705,2218,4928,0.45,612,1634,0.375,1606,3294,0.488,845,1125,0.751,566,1881,2447,1301,433,739,1055,5893
8061,2018-2-17,Chicago Bulls,57,13855,2212,5055,0.438,627,1763,0.356,1585,3292,0.481,839,1091,0.769,525,2024,2549,1342,403,737,1085,5890
8062,2018-2-17,Boston Celtics,59,14235,2237,5015,0.446,686,1854,0.37,1551,3161,0.491,925,1206,0.767,538,2075,2613,1300,421,777,1203,6085
8063,2018-2-17,Dallas Mavericks,58,13970,2198,4922,0.447,677,1877,0.361,1521,3045,0.5,847,1104,0.767,455,1900,2355,1305,410,685,1124,5920
8064,2018-2-17,San Antonio Spurs,59,14160,2280,4977,0.458,518,1451,0.357,1762,3526,0.5,915,1180,0.775,598,2019,2617,1343,432,780,1005,5993
8065,2018-2-17,Miami Heat,58,13970,2178,4817,0.452,639,1781,0.359,1539,3036,0.507,835,1105,0.756,511,1960,2471,1267,406,817,1155,5830
8066,2018-2-17,Memphis Grizzlies,56,13465,2032,4567,0.445,520,1494,0.348,1512,3073,0.492,970,1215,0.798,520,1752,2272,1181,410,792,1318,5554
8067,2018-2-17,Sacramento Kings,57,13705,2204,4863,0.453,509,1333,0.382,1695,3530,0.48,709,980,0.723,533,1764,2297,1209,472,781,1134,5626
8068,2018-2-18,Golden State Warriors,58,13970,2527,4951,0.51,679,1729,0.393,1848,3222,0.574,986,1216,0.811,500,2069,2569,1767,468,899,1147,6719
8069,2018-2-18,Houston Rockets,57,13730,2229,4820,0.462,893,2441,0.366,1336,2379,0.562,1153,1465,0.787,514,1969,2483,1247,493,761,1125,6504
8070,2018-2-18,Toronto Raptors,57,13730,2354,5004,0.47,659,1846,0.357,1695,3158,0.537,1009,1261,0.8,555,1930,2485,1337,466,720,1257,6376
8071,2018-2-18,New Orleans Pelicans,57,13905,2386,4943,0.483,610,1669,0.365,1776,3274,0.542,963,1267,0.76,486,1993,2479,1505,446,850,1101,6345
8072,2018-2-18,Cleveland Cavaliers,56,13490,2227,4692,0.475,681,1841,0.37,1546,2851,0.542,1035,1311,0.789,458,1879,2337,1323,394,770,1043,6170
8073,2018-2-18,Minnesota Timberwolves,61,14740,2509,5231,0.48,482,1355,0.356,2027,3876,0.523,1194,1488,0.802,634,1910,2544,1395,530,719,1089,6694
8074,2018-2-18,Los Angeles Clippers,56,13465,2211,4758,0.465,563,1596,0.353,1648,3162,0.521,1061,1402,0.757,557,1894,2451,1236,436,795,1137,6046
8075,2018-2-18,Denver Nuggets,58,13995,2329,4999,0.466,646,1765,0.366,1683,3234,0.52,952,1253,0.76,649,1926,2575,1412,450,850,1040,6256
8076,2018-2-18,Philadelphia 76ers,55,13300,2188,4699,0.466,573,1584,0.362,1615,3115,0.518,963,1262,0.763,607,1977,2584,1407,456,920,1252,5912
8077,2018-2-18,Washington Wizards,57,13780,2287,4896,0.467,559,1516,0.369,1728,3380,0.511,990,1289,0.768,565,1881,2446,1387,463,784,1222,6123
8078,2018-2-18,Los Angeles Lakers,57,13855,2334,5090,0.459,526,1580,0.333,1808,3510,0.515,920,1322,0.696,634,1998,2632,1339,460,886,1239,6114
8079,2018-2-18,Indiana Pacers,58,13970,2387,4968,0.48,534,1430,0.373,1853,3538,0.524,885,1146,0.772,528,1901,2429,1300,479,739,1089,6193
8080,2018-2-18,Oklahoma City Thunder,59,14260,2348,5174,0.454,613,1746,0.351,1735,3428,0.506,980,1389,0.706,741,1904,2645,1247,542,785,1195,6289
8081,2018-2-18,Charlotte Hornets,57,13755,2184,4944,0.442,549,1517,0.362,1635,3427,0.477,1126,1529,0.736,583,2018,2601,1192,398,704,1013,6043
8082,2018-2-18,Orlando Magic,57,13705,2253,4900,0.46,593,1669,0.355,1660,3231,0.514,917,1202,0.763,513,1852,2365,1328,421,806,1123,6016
8083,2018-2-18,Brooklyn Nets,59,14285,2233,5122,0.436,709,2049,0.346,1524,3073,0.496,1042,1353,0.77,597,2070,2667,1335,360,856,1222,6217
8084,2018-2-18,Portland Trail Blazers,58,13995,2270,5003,0.454,591,1559,0.379,1679,3444,0.488,959,1195,0.803,568,2036,2604,1108,398,777,1139,6090
8085,2018-2-18,Milwaukee Bucks,57,13730,2218,4636,0.478,488,1397,0.349,1730,3239,0.534,1038,1346,0.771,452,1786,2238,1284,481,741,1237,5962
8086,2018-2-18,Phoenix Suns,59,14185,2250,5110,0.44,543,1634,0.332,1707,3476,0.491,1086,1442,0.753,630,1958,2588,1233,393,886,1314,6129
8087,2018-2-18,Atlanta Hawks,59,14185,2253,5009,0.45,648,1772,0.366,1605,3237,0.496,962,1209,0.796,556,1855,2411,1409,467,872,1170,6116
8088,2018-2-18,New York Knicks,59,14285,2356,5091,0.463,463,1304,0.355,1893,3787,0.5,941,1187,0.793,614,1995,2609,1344,398,870,1205,6116
8089,2018-2-18,Utah Jazz,58,13970,2206,4816,0.458,637,1693,0.376,1569,3123,0.502,953,1195,0.797,505,1937,2442,1243,515,796,1142,6002
8090,2018-2-18,Detroit Pistons,57,13705,2218,4928,0.45,612,1634,0.375,1606,3294,0.488,845,1125,0.751,566,1881,2447,1301,433,739,1055,5893
8091,2018-2-18,Chicago Bulls,57,13855,2212,5055,0.438,627,1763,0.356,1585,3292,0.481,839,1091,0.769,525,2024,2549,1342,403,737,1085,5890
8092,2018-2-18,Boston Celtics,59,14235,2237,5015,0.446,686,1854,0.37,1551,3161,0.491,925,1206,0.767,538,2075,2613,1300,421,777,1203,6085
8093,2018-2-18,Dallas Mavericks,58,13970,2198,4922,0.447,677,1877,0.361,1521,3045,0.5,847,1104,0.767,455,1900,2355,1305,410,685,1124,5920
8094,2018-2-18,San Antonio Spurs,59,14160,2280,4977,0.458,518,1451,0.357,1762,3526,0.5,915,1180,0.775,598,2019,2617,1343,432,780,1005,5993
8095,2018-2-18,Miami Heat,58,13970,2178,4817,0.452,639,1781,0.359,1539,3036,0.507,835,1105,0.756,511,1960,2471,1267,406,817,1155,5830
8096,2018-2-18,Memphis Grizzlies,56,13465,2032,4567,0.445,520,1494,0.348,1512,3073,0.492,970,1215,0.798,520,1752,2272,1181,410,792,1318,5554
8097,2018-2-18,Sacramento Kings,57,13705,2204,4863,0.453,509,1333,0.382,1695,3530,0.48,709,980,0.723,533,1764,2297,1209,472,781,1134,5626
8098,2018-2-19,Golden State Warriors,58,13970,2527,4951,0.51,679,1729,0.393,1848,3222,0.574,986,1216,0.811,500,2069,2569,1767,468,899,1147,6719
8099,2018-2-19,Houston Rockets,57,13730,2229,4820,0.462,893,2441,0.366,1336,2379,0.562,1153,1465,0.787,514,1969,2483,1247,493,761,1125,6504
8100,2018-2-19,Toronto Raptors,57,13730,2354,5004,0.47,659,1846,0.357,1695,3158,0.537,1009,1261,0.8,555,1930,2485,1337,466,720,1257,6376
8101,2018-2-19,New Orleans Pelicans,57,13905,2386,4943,0.483,610,1669,0.365,1776,3274,0.542,963,1267,0.76,486,1993,2479,1505,446,850,1101,6345
8102,2018-2-19,Cleveland Cavaliers,56,13490,2227,4692,0.475,681,1841,0.37,1546,2851,0.542,1035,1311,0.789,458,1879,2337,1323,394,770,1043,6170
8103,2018-2-19,Minnesota Timberwolves,61,14740,2509,5231,0.48,482,1355,0.356,2027,3876,0.523,1194,1488,0.802,634,1910,2544,1395,530,719,1089,6694
8104,2018-2-19,Los Angeles Clippers,56,13465,2211,4758,0.465,563,1596,0.353,1648,3162,0.521,1061,1402,0.757,557,1894,2451,1236,436,795,1137,6046
8105,2018-2-19,Denver Nuggets,58,13995,2329,4999,0.466,646,1765,0.366,1683,3234,0.52,952,1253,0.76,649,1926,2575,1412,450,850,1040,6256
8106,2018-2-19,Philadelphia 76ers,55,13300,2188,4699,0.466,573,1584,0.362,1615,3115,0.518,963,1262,0.763,607,1977,2584,1407,456,920,1252,5912
8107,2018-2-19,Washington Wizards,57,13780,2287,4896,0.467,559,1516,0.369,1728,3380,0.511,990,1289,0.768,565,1881,2446,1387,463,784,1222,6123
8108,2018-2-19,Los Angeles Lakers,57,13855,2334,5090,0.459,526,1580,0.333,1808,3510,0.515,920,1322,0.696,634,1998,2632,1339,460,886,1239,6114
8109,2018-2-19,Indiana Pacers,58,13970,2387,4968,0.48,534,1430,0.373,1853,3538,0.524,885,1146,0.772,528,1901,2429,1300,479,739,1089,6193
8110,2018-2-19,Oklahoma City Thunder,59,14260,2348,5174,0.454,613,1746,0.351,1735,3428,0.506,980,1389,0.706,741,1904,2645,1247,542,785,1195,6289
8111,2018-2-19,Charlotte Hornets,57,13755,2184,4944,0.442,549,1517,0.362,1635,3427,0.477,1126,1529,0.736,583,2018,2601,1192,398,704,1013,6043
8112,2018-2-19,Orlando Magic,57,13705,2253,4900,0.46,593,1669,0.355,1660,3231,0.514,917,1202,0.763,513,1852,2365,1328,421,806,1123,6016
8113,2018-2-19,Brooklyn Nets,59,14285,2233,5122,0.436,709,2049,0.346,1524,3073,0.496,1042,1353,0.77,597,2070,2667,1335,360,856,1222,6217
8114,2018-2-19,Portland Trail Blazers,58,13995,2270,5003,0.454,591,1559,0.379,1679,3444,0.488,959,1195,0.803,568,2036,2604,1108,398,777,1139,6090
8115,2018-2-19,Milwaukee Bucks,57,13730,2218,4636,0.478,488,1397,0.349,1730,3239,0.534,1038,1346,0.771,452,1786,2238,1284,481,741,1237,5962
8116,2018-2-19,Phoenix Suns,59,14185,2250,5110,0.44,543,1634,0.332,1707,3476,0.491,1086,1442,0.753,630,1958,2588,1233,393,886,1314,6129
8117,2018-2-19,Atlanta Hawks,59,14185,2253,5009,0.45,648,1772,0.366,1605,3237,0.496,962,1209,0.796,556,1855,2411,1409,467,872,1170,6116
8118,2018-2-19,New York Knicks,59,14285,2356,5091,0.463,463,1304,0.355,1893,3787,0.5,941,1187,0.793,614,1995,2609,1344,398,870,1205,6116
8119,2018-2-19,Utah Jazz,58,13970,2206,4816,0.458,637,1693,0.376,1569,3123,0.502,953,1195,0.797,505,1937,2442,1243,515,796,1142,6002
8120,2018-2-19,Detroit Pistons,57,13705,2218,4928,0.45,612,1634,0.375,1606,3294,0.488,845,1125,0.751,566,1881,2447,1301,433,739,1055,5893
8121,2018-2-19,Chicago Bulls,57,13855,2212,5055,0.438,627,1763,0.356,1585,3292,0.481,839,1091,0.769,525,2024,2549,1342,403,737,1085,5890
8122,2018-2-19,Boston Celtics,59,14235,2237,5015,0.446,686,1854,0.37,1551,3161,0.491,925,1206,0.767,538,2075,2613,1300,421,777,1203,6085
8123,2018-2-19,Dallas Mavericks,58,13970,2198,4922,0.447,677,1877,0.361,1521,3045,0.5,847,1104,0.767,455,1900,2355,1305,410,685,1124,5920
8124,2018-2-19,San Antonio Spurs,59,14160,2280,4977,0.458,518,1451,0.357,1762,3526,0.5,915,1180,0.775,598,2019,2617,1343,432,780,1005,5993
8125,2018-2-19,Miami Heat,58,13970,2178,4817,0.452,639,1781,0.359,1539,3036,0.507,835,1105,0.756,511,1960,2471,1267,406,817,1155,5830
8126,2018-2-19,Memphis Grizzlies,56,13465,2032,4567,0.445,520,1494,0.348,1512,3073,0.492,970,1215,0.798,520,1752,2272,1181,410,792,1318,5554
8127,2018-2-19,Sacramento Kings,57,13705,2204,4863,0.453,509,1333,0.382,1695,3530,0.48,709,980,0.723,533,1764,2297,1209,472,781,1134,5626
8128,2018-2-20,Golden State Warriors,58,13970,2527,4951,0.51,679,1729,0.393,1848,3222,0.574,986,1216,0.811,500,2069,2569,1767,468,899,1147,6719
8129,2018-2-20,Houston Rockets,57,13730,2229,4820,0.462,893,2441,0.366,1336,2379,0.562,1153,1465,0.787,514,1969,2483,1247,493,761,1125,6504
8130,2018-2-20,Toronto Raptors,57,13730,2354,5004,0.47,659,1846,0.357,1695,3158,0.537,1009,1261,0.8,555,1930,2485,1337,466,720,1257,6376
8131,2018-2-20,New Orleans Pelicans,57,13905,2386,4943,0.483,610,1669,0.365,1776,3274,0.542,963,1267,0.76,486,1993,2479,1505,446,850,1101,6345
8132,2018-2-20,Cleveland Cavaliers,56,13490,2227,4692,0.475,681,1841,0.37,1546,2851,0.542,1035,1311,0.789,458,1879,2337,1323,394,770,1043,6170
8133,2018-2-20,Minnesota Timberwolves,61,14740,2509,5231,0.48,482,1355,0.356,2027,3876,0.523,1194,1488,0.802,634,1910,2544,1395,530,719,1089,6694
8134,2018-2-20,Los Angeles Clippers,56,13465,2211,4758,0.465,563,1596,0.353,1648,3162,0.521,1061,1402,0.757,557,1894,2451,1236,436,795,1137,6046
8135,2018-2-20,Denver Nuggets,58,13995,2329,4999,0.466,646,1765,0.366,1683,3234,0.52,952,1253,0.76,649,1926,2575,1412,450,850,1040,6256
8136,2018-2-20,Philadelphia 76ers,55,13300,2188,4699,0.466,573,1584,0.362,1615,3115,0.518,963,1262,0.763,607,1977,2584,1407,456,920,1252,5912
8137,2018-2-20,Washington Wizards,57,13780,2287,4896,0.467,559,1516,0.369,1728,3380,0.511,990,1289,0.768,565,1881,2446,1387,463,784,1222,6123
8138,2018-2-20,Los Angeles Lakers,57,13855,2334,5090,0.459,526,1580,0.333,1808,3510,0.515,920,1322,0.696,634,1998,2632,1339,460,886,1239,6114
8139,2018-2-20,Indiana Pacers,58,13970,2387,4968,0.48,534,1430,0.373,1853,3538,0.524,885,1146,0.772,528,1901,2429,1300,479,739,1089,6193
8140,2018-2-20,Oklahoma City Thunder,59,14260,2348,5174,0.454,613,1746,0.351,1735,3428,0.506,980,1389,0.706,741,1904,2645,1247,542,785,1195,6289
8141,2018-2-20,Charlotte Hornets,57,13755,2184,4944,0.442,549,1517,0.362,1635,3427,0.477,1126,1529,0.736,583,2018,2601,1192,398,704,1013,6043
8142,2018-2-20,Orlando Magic,57,13705,2253,4900,0.46,593,1669,0.355,1660,3231,0.514,917,1202,0.763,513,1852,2365,1328,421,806,1123,6016
8143,2018-2-20,Brooklyn Nets,59,14285,2233,5122,0.436,709,2049,0.346,1524,3073,0.496,1042,1353,0.77,597,2070,2667,1335,360,856,1222,6217
8144,2018-2-20,Portland Trail Blazers,58,13995,2270,5003,0.454,591,1559,0.379,1679,3444,0.488,959,1195,0.803,568,2036,2604,1108,398,777,1139,6090
8145,2018-2-20,Milwaukee Bucks,57,13730,2218,4636,0.478,488,1397,0.349,1730,3239,0.534,1038,1346,0.771,452,1786,2238,1284,481,741,1237,5962
8146,2018-2-20,Phoenix Suns,59,14185,2250,5110,0.44,543,1634,0.332,1707,3476,0.491,1086,1442,0.753,630,1958,2588,1233,393,886,1314,6129
8147,2018-2-20,Atlanta Hawks,59,14185,2253,5009,0.45,648,1772,0.366,1605,3237,0.496,962,1209,0.796,556,1855,2411,1409,467,872,1170,6116
8148,2018-2-20,New York Knicks,59,14285,2356,5091,0.463,463,1304,0.355,1893,3787,0.5,941,1187,0.793,614,1995,2609,1344,398,870,1205,6116
8149,2018-2-20,Utah Jazz,58,13970,2206,4816,0.458,637,1693,0.376,1569,3123,0.502,953,1195,0.797,505,1937,2442,1243,515,796,1142,6002
8150,2018-2-20,Detroit Pistons,57,13705,2218,4928,0.45,612,1634,0.375,1606,3294,0.488,845,1125,0.751,566,1881,2447,1301,433,739,1055,5893
8151,2018-2-20,Chicago Bulls,57,13855,2212,5055,0.438,627,1763,0.356,1585,3292,0.481,839,1091,0.769,525,2024,2549,1342,403,737,1085,5890
8152,2018-2-20,Boston Celtics,59,14235,2237,5015,0.446,686,1854,0.37,1551,3161,0.491,925,1206,0.767,538,2075,2613,1300,421,777,1203,6085
8153,2018-2-20,Dallas Mavericks,58,13970,2198,4922,0.447,677,1877,0.361,1521,3045,0.5,847,1104,0.767,455,1900,2355,1305,410,685,1124,5920
8154,2018-2-20,San Antonio Spurs,59,14160,2280,4977,0.458,518,1451,0.357,1762,3526,0.5,915,1180,0.775,598,2019,2617,1343,432,780,1005,5993
8155,2018-2-20,Miami Heat,58,13970,2178,4817,0.452,639,1781,0.359,1539,3036,0.507,835,1105,0.756,511,1960,2471,1267,406,817,1155,5830
8156,2018-2-20,Memphis Grizzlies,56,13465,2032,4567,0.445,520,1494,0.348,1512,3073,0.492,970,1215,0.798,520,1752,2272,1181,410,792,1318,5554
8157,2018-2-20,Sacramento Kings,57,13705,2204,4863,0.453,509,1333,0.382,1695,3530,0.48,709,980,0.723,533,1764,2297,1209,472,781,1134,5626
8158,2018-2-21,Golden State Warriors,58,13970,2527,4951,0.51,679,1729,0.393,1848,3222,0.574,986,1216,0.811,500,2069,2569,1767,468,899,1147,6719
8159,2018-2-21,Houston Rockets,57,13730,2229,4820,0.462,893,2441,0.366,1336,2379,0.562,1153,1465,0.787,514,1969,2483,1247,493,761,1125,6504
8160,2018-2-21,Toronto Raptors,57,13730,2354,5004,0.47,659,1846,0.357,1695,3158,0.537,1009,1261,0.8,555,1930,2485,1337,466,720,1257,6376
8161,2018-2-21,New Orleans Pelicans,57,13905,2386,4943,0.483,610,1669,0.365,1776,3274,0.542,963,1267,0.76,486,1993,2479,1505,446,850,1101,6345
8162,2018-2-21,Cleveland Cavaliers,56,13490,2227,4692,0.475,681,1841,0.37,1546,2851,0.542,1035,1311,0.789,458,1879,2337,1323,394,770,1043,6170
8163,2018-2-21,Minnesota Timberwolves,61,14740,2509,5231,0.48,482,1355,0.356,2027,3876,0.523,1194,1488,0.802,634,1910,2544,1395,530,719,1089,6694
8164,2018-2-21,Los Angeles Clippers,56,13465,2211,4758,0.465,563,1596,0.353,1648,3162,0.521,1061,1402,0.757,557,1894,2451,1236,436,795,1137,6046
8165,2018-2-21,Denver Nuggets,58,13995,2329,4999,0.466,646,1765,0.366,1683,3234,0.52,952,1253,0.76,649,1926,2575,1412,450,850,1040,6256
8166,2018-2-21,Philadelphia 76ers,55,13300,2188,4699,0.466,573,1584,0.362,1615,3115,0.518,963,1262,0.763,607,1977,2584,1407,456,920,1252,5912
8167,2018-2-21,Washington Wizards,57,13780,2287,4896,0.467,559,1516,0.369,1728,3380,0.511,990,1289,0.768,565,1881,2446,1387,463,784,1222,6123
8168,2018-2-21,Los Angeles Lakers,57,13855,2334,5090,0.459,526,1580,0.333,1808,3510,0.515,920,1322,0.696,634,1998,2632,1339,460,886,1239,6114
8169,2018-2-21,Indiana Pacers,58,13970,2387,4968,0.48,534,1430,0.373,1853,3538,0.524,885,1146,0.772,528,1901,2429,1300,479,739,1089,6193
8170,2018-2-21,Oklahoma City Thunder,59,14260,2348,5174,0.454,613,1746,0.351,1735,3428,0.506,980,1389,0.706,741,1904,2645,1247,542,785,1195,6289
8171,2018-2-21,Charlotte Hornets,57,13755,2184,4944,0.442,549,1517,0.362,1635,3427,0.477,1126,1529,0.736,583,2018,2601,1192,398,704,1013,6043
8172,2018-2-21,Orlando Magic,57,13705,2253,4900,0.46,593,1669,0.355,1660,3231,0.514,917,1202,0.763,513,1852,2365,1328,421,806,1123,6016
8173,2018-2-21,Brooklyn Nets,59,14285,2233,5122,0.436,709,2049,0.346,1524,3073,0.496,1042,1353,0.77,597,2070,2667,1335,360,856,1222,6217
8174,2018-2-21,Portland Trail Blazers,58,13995,2270,5003,0.454,591,1559,0.379,1679,3444,0.488,959,1195,0.803,568,2036,2604,1108,398,777,1139,6090
8175,2018-2-21,Milwaukee Bucks,57,13730,2218,4636,0.478,488,1397,0.349,1730,3239,0.534,1038,1346,0.771,452,1786,2238,1284,481,741,1237,5962
8176,2018-2-21,Phoenix Suns,59,14185,2250,5110,0.44,543,1634,0.332,1707,3476,0.491,1086,1442,0.753,630,1958,2588,1233,393,886,1314,6129
8177,2018-2-21,Atlanta Hawks,59,14185,2253,5009,0.45,648,1772,0.366,1605,3237,0.496,962,1209,0.796,556,1855,2411,1409,467,872,1170,6116
8178,2018-2-21,New York Knicks,59,14285,2356,5091,0.463,463,1304,0.355,1893,3787,0.5,941,1187,0.793,614,1995,2609,1344,398,870,1205,6116
8179,2018-2-21,Utah Jazz,58,13970,2206,4816,0.458,637,1693,0.376,1569,3123,0.502,953,1195,0.797,505,1937,2442,1243,515,796,1142,6002
8180,2018-2-21,Detroit Pistons,57,13705,2218,4928,0.45,612,1634,0.375,1606,3294,0.488,845,1125,0.751,566,1881,2447,1301,433,739,1055,5893
8181,2018-2-21,Chicago Bulls,57,13855,2212,5055,0.438,627,1763,0.356,1585,3292,0.481,839,1091,0.769,525,2024,2549,1342,403,737,1085,5890
8182,2018-2-21,Boston Celtics,59,14235,2237,5015,0.446,686,1854,0.37,1551,3161,0.491,925,1206,0.767,538,2075,2613,1300,421,777,1203,6085
8183,2018-2-21,Dallas Mavericks,58,13970,2198,4922,0.447,677,1877,0.361,1521,3045,0.5,847,1104,0.767,455,1900,2355,1305,410,685,1124,5920
8184,2018-2-21,San Antonio Spurs,59,14160,2280,4977,0.458,518,1451,0.357,1762,3526,0.5,915,1180,0.775,598,2019,2617,1343,432,780,1005,5993
8185,2018-2-21,Miami Heat,58,13970,2178,4817,0.452,639,1781,0.359,1539,3036,0.507,835,1105,0.756,511,1960,2471,1267,406,817,1155,5830
8186,2018-2-21,Memphis Grizzlies,56,13465,2032,4567,0.445,520,1494,0.348,1512,3073,0.492,970,1215,0.798,520,1752,2272,1181,410,792,1318,5554
8187,2018-2-21,Sacramento Kings,57,13705,2204,4863,0.453,509,1333,0.382,1695,3530,0.48,709,980,0.723,533,1764,2297,1209,472,781,1134,5626
8188,2018-2-22,Golden State Warriors,58,13970,2527,4951,0.51,679,1729,0.393,1848,3222,0.574,986,1216,0.811,500,2069,2569,1767,468,899,1147,6719
8189,2018-2-22,Houston Rockets,57,13730,2229,4820,0.462,893,2441,0.366,1336,2379,0.562,1153,1465,0.787,514,1969,2483,1247,493,761,1125,6504
8190,2018-2-22,Toronto Raptors,57,13730,2354,5004,0.47,659,1846,0.357,1695,3158,0.537,1009,1261,0.8,555,1930,2485,1337,466,720,1257,6376
8191,2018-2-22,New Orleans Pelicans,57,13905,2386,4943,0.483,610,1669,0.365,1776,3274,0.542,963,1267,0.76,486,1993,2479,1505,446,850,1101,6345
8192,2018-2-22,Cleveland Cavaliers,56,13490,2227,4692,0.475,681,1841,0.37,1546,2851,0.542,1035,1311,0.789,458,1879,2337,1323,394,770,1043,6170
8193,2018-2-22,Minnesota Timberwolves,61,14740,2509,5231,0.48,482,1355,0.356,2027,3876,0.523,1194,1488,0.802,634,1910,2544,1395,530,719,1089,6694
8194,2018-2-22,Los Angeles Clippers,56,13465,2211,4758,0.465,563,1596,0.353,1648,3162,0.521,1061,1402,0.757,557,1894,2451,1236,436,795,1137,6046
8195,2018-2-22,Denver Nuggets,58,13995,2329,4999,0.466,646,1765,0.366,1683,3234,0.52,952,1253,0.76,649,1926,2575,1412,450,850,1040,6256
8196,2018-2-22,Philadelphia 76ers,55,13300,2188,4699,0.466,573,1584,0.362,1615,3115,0.518,963,1262,0.763,607,1977,2584,1407,456,920,1252,5912
8197,2018-2-22,Washington Wizards,57,13780,2287,4896,0.467,559,1516,0.369,1728,3380,0.511,990,1289,0.768,565,1881,2446,1387,463,784,1222,6123
8198,2018-2-22,Los Angeles Lakers,57,13855,2334,5090,0.459,526,1580,0.333,1808,3510,0.515,920,1322,0.696,634,1998,2632,1339,460,886,1239,6114
8199,2018-2-22,Indiana Pacers,58,13970,2387,4968,0.48,534,1430,0.373,1853,3538,0.524,885,1146,0.772,528,1901,2429,1300,479,739,1089,6193
8200,2018-2-22,Oklahoma City Thunder,59,14260,2348,5174,0.454,613,1746,0.351,1735,3428,0.506,980,1389,0.706,741,1904,2645,1247,542,785,1195,6289
8201,2018-2-22,Charlotte Hornets,57,13755,2184,4944,0.442,549,1517,0.362,1635,3427,0.477,1126,1529,0.736,583,2018,2601,1192,398,704,1013,6043
8202,2018-2-22,Orlando Magic,57,13705,2253,4900,0.46,593,1669,0.355,1660,3231,0.514,917,1202,0.763,513,1852,2365,1328,421,806,1123,6016
8203,2018-2-22,Brooklyn Nets,59,14285,2233,5122,0.436,709,2049,0.346,1524,3073,0.496,1042,1353,0.77,597,2070,2667,1335,360,856,1222,6217
8204,2018-2-22,Portland Trail Blazers,58,13995,2270,5003,0.454,591,1559,0.379,1679,3444,0.488,959,1195,0.803,568,2036,2604,1108,398,777,1139,6090
8205,2018-2-22,Milwaukee Bucks,57,13730,2218,4636,0.478,488,1397,0.349,1730,3239,0.534,1038,1346,0.771,452,1786,2238,1284,481,741,1237,5962
8206,2018-2-22,Phoenix Suns,59,14185,2250,5110,0.44,543,1634,0.332,1707,3476,0.491,1086,1442,0.753,630,1958,2588,1233,393,886,1314,6129
8207,2018-2-22,Atlanta Hawks,59,14185,2253,5009,0.45,648,1772,0.366,1605,3237,0.496,962,1209,0.796,556,1855,2411,1409,467,872,1170,6116
8208,2018-2-22,New York Knicks,59,14285,2356,5091,0.463,463,1304,0.355,1893,3787,0.5,941,1187,0.793,614,1995,2609,1344,398,870,1205,6116
8209,2018-2-22,Utah Jazz,58,13970,2206,4816,0.458,637,1693,0.376,1569,3123,0.502,953,1195,0.797,505,1937,2442,1243,515,796,1142,6002
8210,2018-2-22,Detroit Pistons,57,13705,2218,4928,0.45,612,1634,0.375,1606,3294,0.488,845,1125,0.751,566,1881,2447,1301,433,739,1055,5893
8211,2018-2-22,Chicago Bulls,57,13855,2212,5055,0.438,627,1763,0.356,1585,3292,0.481,839,1091,0.769,525,2024,2549,1342,403,737,1085,5890
8212,2018-2-22,Boston Celtics,59,14235,2237,5015,0.446,686,1854,0.37,1551,3161,0.491,925,1206,0.767,538,2075,2613,1300,421,777,1203,6085
8213,2018-2-22,Dallas Mavericks,58,13970,2198,4922,0.447,677,1877,0.361,1521,3045,0.5,847,1104,0.767,455,1900,2355,1305,410,685,1124,5920
8214,2018-2-22,San Antonio Spurs,59,14160,2280,4977,0.458,518,1451,0.357,1762,3526,0.5,915,1180,0.775,598,2019,2617,1343,432,780,1005,5993
8215,2018-2-22,Miami Heat,58,13970,2178,4817,0.452,639,1781,0.359,1539,3036,0.507,835,1105,0.756,511,1960,2471,1267,406,817,1155,5830
8216,2018-2-22,Memphis Grizzlies,56,13465,2032,4567,0.445,520,1494,0.348,1512,3073,0.492,970,1215,0.798,520,1752,2272,1181,410,792,1318,5554
8217,2018-2-22,Sacramento Kings,57,13705,2204,4863,0.453,509,1333,0.382,1695,3530,0.48,709,980,0.723,533,1764,2297,1209,472,781,1134,5626
8218,2018-2-23,Golden State Warriors,59,14210,2574,5028,0.512,693,1754,0.395,1881,3274,0.575,1012,1250,0.81,503,2098,2601,1798,476,914,1171,6853
8219,2018-2-23,Houston Rockets,57,13730,2229,4820,0.462,893,2441,0.366,1336,2379,0.562,1153,1465,0.787,514,1969,2483,1247,493,761,1125,6504
8220,2018-2-23,Toronto Raptors,57,13730,2354,5004,0.47,659,1846,0.357,1695,3158,0.537,1009,1261,0.8,555,1930,2485,1337,466,720,1257,6376
8221,2018-2-23,New Orleans Pelicans,57,13905,2386,4943,0.483,610,1669,0.365,1776,3274,0.542,963,1267,0.76,486,1993,2479,1505,446,850,1101,6345
8222,2018-2-23,Cleveland Cavaliers,57,13730,2269,4776,0.475,689,1876,0.367,1580,2900,0.545,1046,1330,0.786,464,1909,2373,1343,399,783,1058,6273
8223,2018-2-23,Minnesota Timberwolves,61,14740,2509,5231,0.48,482,1355,0.356,2027,3876,0.523,1194,1488,0.802,634,1910,2544,1395,530,719,1089,6694
8224,2018-2-23,Los Angeles Clippers,57,13705,2255,4846,0.465,574,1628,0.353,1681,3218,0.522,1089,1436,0.758,565,1922,2487,1268,445,809,1156,6173
8225,2018-2-23,Denver Nuggets,58,13995,2329,4999,0.466,646,1765,0.366,1683,3234,0.52,952,1253,0.76,649,1926,2575,1412,450,850,1040,6256
8226,2018-2-23,Philadelphia 76ers,56,13540,2230,4781,0.466,584,1613,0.362,1646,3168,0.52,984,1297,0.759,615,2010,2625,1432,463,929,1269,6028
8227,2018-2-23,Washington Wizards,58,14020,2331,4988,0.467,571,1546,0.369,1760,3442,0.511,1000,1299,0.77,574,1915,2489,1416,472,794,1245,6233
8228,2018-2-23,Los Angeles Lakers,57,13855,2334,5090,0.459,526,1580,0.333,1808,3510,0.515,920,1322,0.696,634,1998,2632,1339,460,886,1239,6114
8229,2018-2-23,Indiana Pacers,58,13970,2387,4968,0.48,534,1430,0.373,1853,3538,0.524,885,1146,0.772,528,1901,2429,1300,479,739,1089,6193
8230,2018-2-23,Oklahoma City Thunder,60,14500,2386,5260,0.454,627,1781,0.352,1759,3479,0.506,1000,1413,0.708,751,1943,2694,1273,548,796,1211,6399
8231,2018-2-23,Charlotte Hornets,58,13995,2226,5031,0.442,560,1538,0.364,1666,3493,0.477,1142,1549,0.737,596,2059,2655,1221,401,718,1028,6154
8232,2018-2-23,Orlando Magic,58,13945,2296,4983,0.461,604,1693,0.357,1692,3290,0.514,933,1225,0.762,518,1886,2404,1356,428,819,1138,6129
8233,2018-2-23,Brooklyn Nets,60,14525,2269,5215,0.435,723,2092,0.346,1546,3123,0.495,1052,1367,0.77,608,2100,2708,1362,366,865,1245,6313
8234,2018-2-23,Portland Trail Blazers,58,13995,2270,5003,0.454,591,1559,0.379,1679,3444,0.488,959,1195,0.803,568,2036,2604,1108,398,777,1139,6090
8235,2018-2-23,Milwaukee Bucks,57,13730,2218,4636,0.478,488,1397,0.349,1730,3239,0.534,1038,1346,0.771,452,1786,2238,1284,481,741,1237,5962
8236,2018-2-23,Phoenix Suns,59,14185,2250,5110,0.44,543,1634,0.332,1707,3476,0.491,1086,1442,0.753,630,1958,2588,1233,393,886,1314,6129
8237,2018-2-23,New York Knicks,60,14525,2404,5190,0.463,470,1329,0.354,1934,3861,0.501,958,1208,0.793,630,2026,2656,1372,405,878,1220,6236
8238,2018-2-23,Atlanta Hawks,59,14185,2253,5009,0.45,648,1772,0.366,1605,3237,0.496,962,1209,0.796,556,1855,2411,1409,467,872,1170,6116
8239,2018-2-23,Utah Jazz,58,13970,2206,4816,0.458,637,1693,0.376,1569,3123,0.502,953,1195,0.797,505,1937,2442,1243,515,796,1142,6002
8240,2018-2-23,Chicago Bulls,58,14095,2256,5152,0.438,645,1797,0.359,1611,3355,0.48,848,1106,0.767,536,2061,2597,1369,408,750,1111,6005
8241,2018-2-23,Detroit Pistons,57,13705,2218,4928,0.45,612,1634,0.375,1606,3294,0.488,845,1125,0.751,566,1881,2447,1301,433,739,1055,5893
8242,2018-2-23,Boston Celtics,59,14235,2237,5015,0.446,686,1854,0.37,1551,3161,0.491,925,1206,0.767,538,2075,2613,1300,421,777,1203,6085
8243,2018-2-23,Dallas Mavericks,58,13970,2198,4922,0.447,677,1877,0.361,1521,3045,0.5,847,1104,0.767,455,1900,2355,1305,410,685,1124,5920
8244,2018-2-23,San Antonio Spurs,59,14160,2280,4977,0.458,518,1451,0.357,1762,3526,0.5,915,1180,0.775,598,2019,2617,1343,432,780,1005,5993
8245,2018-2-23,Miami Heat,58,13970,2178,4817,0.452,639,1781,0.359,1539,3036,0.507,835,1105,0.756,511,1960,2471,1267,406,817,1155,5830
8246,2018-2-23,Memphis Grizzlies,56,13465,2032,4567,0.445,520,1494,0.348,1512,3073,0.492,970,1215,0.798,520,1752,2272,1181,410,792,1318,5554
8247,2018-2-23,Sacramento Kings,58,13945,2246,4954,0.453,521,1360,0.383,1725,3594,0.48,720,995,0.724,543,1798,2341,1232,478,790,1154,5733
8248,2018-2-24,Golden State Warriors,59,14210,2574,5028,0.512,693,1754,0.395,1881,3274,0.575,1012,1250,0.81,503,2098,2601,1798,476,914,1171,6853
8249,2018-2-24,Houston Rockets,58,13970,2269,4903,0.463,907,2479,0.366,1362,2424,0.562,1179,1495,0.789,528,2005,2533,1271,499,771,1142,6624
8250,2018-2-24,Toronto Raptors,58,13995,2397,5094,0.471,668,1880,0.355,1729,3214,0.538,1033,1287,0.803,560,1962,2522,1360,473,732,1278,6495
8251,2018-2-24,New Orleans Pelicans,58,14170,2434,5051,0.482,618,1700,0.364,1816,3351,0.542,983,1291,0.761,499,2036,2535,1532,455,865,1119,6469
8252,2018-2-24,Cleveland Cavaliers,58,13970,2309,4863,0.475,700,1905,0.367,1609,2958,0.544,1067,1352,0.789,471,1948,2419,1369,412,801,1081,6385
8253,2018-2-24,Minnesota Timberwolves,62,14980,2549,5325,0.479,492,1381,0.356,2057,3944,0.522,1206,1504,0.802,650,1937,2587,1414,536,729,1111,6796
8254,2018-2-24,Los Angeles Clippers,58,13945,2300,4933,0.466,588,1660,0.354,1712,3273,0.523,1113,1468,0.758,573,1965,2538,1291,450,825,1182,6301
8255,2018-2-24,Denver Nuggets,59,14235,2377,5096,0.466,658,1797,0.366,1719,3299,0.521,966,1272,0.759,667,1960,2627,1445,455,861,1067,6378
8256,2018-2-24,Los Angeles Lakers,58,14095,2382,5183,0.46,539,1613,0.334,1843,3570,0.516,935,1342,0.697,647,2047,2694,1371,468,902,1256,6238
8257,2018-2-24,Philadelphia 76ers,56,13540,2230,4781,0.466,584,1613,0.362,1646,3168,0.52,984,1297,0.759,615,2010,2625,1432,463,929,1269,6028
8258,2018-2-24,Washington Wizards,59,14260,2371,5069,0.468,580,1571,0.369,1791,3498,0.512,1016,1316,0.772,580,1945,2525,1441,475,808,1266,6338
8259,2018-2-24,Indiana Pacers,59,14210,2435,5069,0.48,543,1458,0.372,1892,3611,0.524,896,1159,0.773,543,1943,2486,1330,496,756,1109,6309
8260,2018-2-24,Oklahoma City Thunder,60,14500,2386,5260,0.454,627,1781,0.352,1759,3479,0.506,1000,1413,0.708,751,1943,2694,1273,548,796,1211,6399
8261,2018-2-24,Charlotte Hornets,59,14235,2270,5121,0.443,577,1577,0.366,1693,3544,0.478,1159,1569,0.739,609,2087,2696,1247,408,726,1046,6276
8262,2018-2-24,Orlando Magic,58,13945,2296,4983,0.461,604,1693,0.357,1692,3290,0.514,933,1225,0.762,518,1886,2404,1356,428,819,1138,6129
8263,2018-2-24,Brooklyn Nets,60,14525,2269,5215,0.435,723,2092,0.346,1546,3123,0.495,1052,1367,0.77,608,2100,2708,1362,366,865,1245,6313
8264,2018-2-24,Milwaukee Bucks,58,13995,2261,4726,0.478,501,1423,0.352,1760,3303,0.533,1061,1373,0.773,465,1824,2289,1305,487,759,1261,6084
8265,2018-2-24,Portland Trail Blazers,59,14235,2309,5090,0.454,600,1583,0.379,1709,3507,0.487,972,1209,0.804,574,2071,2645,1122,409,789,1159,6190
8266,2018-2-24,Phoenix Suns,60,14425,2295,5213,0.44,552,1665,0.332,1743,3548,0.491,1104,1473,0.749,646,1990,2636,1255,405,896,1339,6246
8267,2018-2-24,New York Knicks,60,14525,2404,5190,0.463,470,1329,0.354,1934,3861,0.501,958,1208,0.793,630,2026,2656,1372,405,878,1220,6236
8268,2018-2-24,Atlanta Hawks,60,14425,2290,5091,0.45,655,1803,0.363,1635,3288,0.497,974,1228,0.793,562,1889,2451,1423,476,894,1190,6209
8269,2018-2-24,Chicago Bulls,58,14095,2256,5152,0.438,645,1797,0.359,1611,3355,0.48,848,1106,0.767,536,2061,2597,1369,408,750,1111,6005
8270,2018-2-24,Detroit Pistons,58,13945,2255,5013,0.45,622,1667,0.373,1633,3346,0.488,859,1146,0.75,578,1914,2492,1317,437,752,1073,5991
8271,2018-2-24,Boston Celtics,60,14475,2278,5100,0.447,703,1893,0.371,1575,3207,0.491,936,1224,0.765,548,2107,2655,1330,429,788,1225,6195
8272,2018-2-24,Utah Jazz,59,14210,2239,4894,0.457,643,1718,0.374,1596,3176,0.503,962,1206,0.798,513,1972,2485,1258,522,815,1155,6083
8273,2018-2-24,Dallas Mavericks,59,14210,2235,5013,0.446,696,1919,0.363,1539,3094,0.497,856,1115,0.768,458,1926,2384,1330,419,696,1143,6022
8274,2018-2-24,San Antonio Spurs,60,14400,2323,5062,0.459,523,1467,0.357,1800,3595,0.501,943,1219,0.774,609,2046,2655,1371,436,787,1025,6112
8275,2018-2-24,Miami Heat,59,14235,2228,4925,0.452,645,1799,0.359,1583,3126,0.506,852,1131,0.753,524,2005,2529,1293,418,830,1178,5953
8276,2018-2-24,Memphis Grizzlies,57,13705,2065,4651,0.444,529,1518,0.348,1536,3133,0.49,984,1233,0.798,525,1784,2309,1203,420,813,1343,5643
8277,2018-2-24,Sacramento Kings,58,13945,2246,4954,0.453,521,1360,0.383,1725,3594,0.48,720,995,0.724,543,1798,2341,1232,478,790,1154,5733
8278,2018-2-25,Golden State Warriors,60,14450,2616,5117,0.511,710,1792,0.396,1906,3325,0.573,1023,1263,0.81,515,2140,2655,1834,484,928,1192,6965
8279,2018-2-25,Houston Rockets,58,13970,2269,4903,0.463,907,2479,0.366,1362,2424,0.562,1179,1495,0.789,528,2005,2533,1271,499,771,1142,6624
8280,2018-2-25,Toronto Raptors,58,13995,2397,5094,0.471,668,1880,0.355,1729,3214,0.538,1033,1287,0.803,560,1962,2522,1360,473,732,1278,6495
8281,2018-2-25,New Orleans Pelicans,58,14170,2434,5051,0.482,618,1700,0.364,1816,3351,0.542,983,1291,0.761,499,2036,2535,1532,455,865,1119,6469
8282,2018-2-25,Cleveland Cavaliers,58,13970,2309,4863,0.475,700,1905,0.367,1609,2958,0.544,1067,1352,0.789,471,1948,2419,1369,412,801,1081,6385
8283,2018-2-25,Minnesota Timberwolves,63,15220,2595,5419,0.479,503,1416,0.355,2092,4003,0.523,1225,1530,0.801,660,1978,2638,1439,542,740,1126,6918
8284,2018-2-25,Los Angeles Clippers,58,13945,2300,4933,0.466,588,1660,0.354,1712,3273,0.523,1113,1468,0.758,573,1965,2538,1291,450,825,1182,6301
8285,2018-2-25,Denver Nuggets,59,14235,2377,5096,0.466,658,1797,0.366,1719,3299,0.521,966,1272,0.759,667,1960,2627,1445,455,861,1067,6378
8286,2018-2-25,Philadelphia 76ers,57,13780,2272,4862,0.467,593,1640,0.362,1679,3222,0.521,1007,1324,0.761,624,2046,2670,1463,468,943,1285,6144
8287,2018-2-25,Los Angeles Lakers,59,14335,2423,5274,0.459,556,1651,0.337,1867,3623,0.515,949,1362,0.697,659,2079,2738,1397,473,912,1274,6351
8288,2018-2-25,Washington Wizards,59,14260,2371,5069,0.468,580,1571,0.369,1791,3498,0.512,1016,1316,0.772,580,1945,2525,1441,475,808,1266,6338
8289,2018-2-25,Indiana Pacers,59,14210,2435,5069,0.48,543,1458,0.372,1892,3611,0.524,896,1159,0.773,543,1943,2486,1330,496,756,1109,6309
8290,2018-2-25,Charlotte Hornets,59,14235,2270,5121,0.443,577,1577,0.366,1693,3544,0.478,1159,1569,0.739,609,2087,2696,1247,408,726,1046,6276
8291,2018-2-25,Oklahoma City Thunder,61,14740,2415,5348,0.452,636,1815,0.35,1779,3533,0.504,1013,1434,0.706,765,1972,2737,1292,556,811,1228,6479
8292,2018-2-25,Orlando Magic,59,14185,2334,5068,0.461,617,1724,0.358,1717,3344,0.513,949,1244,0.763,524,1913,2437,1383,435,830,1158,6234
8293,2018-2-25,Brooklyn Nets,60,14525,2269,5215,0.435,723,2092,0.346,1546,3123,0.495,1052,1367,0.77,608,2100,2708,1362,366,865,1245,6313
8294,2018-2-25,Milwaukee Bucks,58,13995,2261,4726,0.478,501,1423,0.352,1760,3303,0.533,1061,1373,0.773,465,1824,2289,1305,487,759,1261,6084
8295,2018-2-25,Portland Trail Blazers,60,14475,2348,5189,0.452,606,1613,0.376,1742,3576,0.487,994,1239,0.802,586,2107,2693,1137,415,795,1178,6296
8296,2018-2-25,Phoenix Suns,61,14665,2334,5300,0.44,563,1691,0.333,1771,3609,0.491,1119,1494,0.749,652,2035,2687,1278,410,909,1363,6350
8297,2018-2-25,New York Knicks,61,14765,2449,5286,0.463,476,1356,0.351,1973,3930,0.502,974,1228,0.793,643,2062,2705,1392,415,892,1242,6348
8298,2018-2-25,Atlanta Hawks,60,14425,2290,5091,0.45,655,1803,0.363,1635,3288,0.497,974,1228,0.793,562,1889,2451,1423,476,894,1190,6209
8299,2018-2-25,Boston Celtics,61,14715,2320,5193,0.447,716,1926,0.372,1604,3267,0.491,960,1252,0.767,559,2141,2700,1351,440,799,1240,6316
8300,2018-2-25,Chicago Bulls,59,14335,2298,5242,0.438,651,1820,0.358,1647,3422,0.481,862,1126,0.766,540,2099,2639,1390,413,764,1131,6109
8301,2018-2-25,Detroit Pistons,58,13945,2255,5013,0.45,622,1667,0.373,1633,3346,0.488,859,1146,0.75,578,1914,2492,1317,437,752,1073,5991
8302,2018-2-25,Utah Jazz,60,14450,2273,4979,0.457,652,1750,0.373,1621,3229,0.502,982,1232,0.797,522,2007,2529,1284,528,826,1174,6180
8303,2018-2-25,San Antonio Spurs,60,14400,2323,5062,0.459,523,1467,0.357,1800,3595,0.501,943,1219,0.774,609,2046,2655,1371,436,787,1025,6112
8304,2018-2-25,Dallas Mavericks,60,14450,2269,5096,0.445,706,1954,0.361,1563,3142,0.497,868,1129,0.769,463,1965,2428,1349,425,711,1166,6112
8305,2018-2-25,Miami Heat,60,14475,2269,5014,0.453,657,1832,0.359,1612,3182,0.507,873,1158,0.754,538,2041,2579,1320,433,840,1195,6068
8306,2018-2-25,Sacramento Kings,59,14185,2288,5048,0.453,534,1385,0.386,1754,3663,0.479,731,1012,0.722,560,1829,2389,1260,483,801,1175,5841
8307,2018-2-25,Memphis Grizzlies,58,13945,2100,4731,0.444,534,1529,0.349,1566,3202,0.489,998,1250,0.798,534,1815,2349,1219,427,832,1365,5732
8308,2018-2-26,Golden State Warriors,60,14450,2616,5117,0.511,710,1792,0.396,1906,3325,0.573,1023,1263,0.81,515,2140,2655,1834,484,928,1192,6965
8309,2018-2-26,Houston Rockets,59,14210,2308,4980,0.463,922,2514,0.367,1386,2466,0.562,1205,1527,0.789,539,2036,2575,1289,506,789,1165,6743
8310,2018-2-26,Toronto Raptors,58,13995,2397,5094,0.471,668,1880,0.355,1729,3214,0.538,1033,1287,0.803,560,1962,2522,1360,473,732,1278,6495
8311,2018-2-26,New Orleans Pelicans,59,14435,2485,5158,0.482,628,1730,0.363,1857,3428,0.542,994,1305,0.762,510,2075,2585,1554,463,880,1143,6592
8312,2018-2-26,Cleveland Cavaliers,59,14210,2347,4954,0.474,708,1939,0.365,1639,3015,0.544,1077,1366,0.788,484,1982,2466,1387,420,816,1105,6479
8313,2018-2-26,Minnesota Timberwolves,63,15220,2595,5419,0.479,503,1416,0.355,2092,4003,0.523,1225,1530,0.801,660,1978,2638,1439,542,740,1126,6918
8314,2018-2-26,Los Angeles Clippers,58,13945,2300,4933,0.466,588,1660,0.354,1712,3273,0.523,1113,1468,0.758,573,1965,2538,1291,450,825,1182,6301
8315,2018-2-26,Denver Nuggets,60,14475,2421,5187,0.467,668,1826,0.366,1753,3361,0.522,982,1296,0.758,679,1984,2663,1478,468,874,1094,6492
8316,2018-2-26,Los Angeles Lakers,59,14335,2423,5274,0.459,556,1651,0.337,1867,3623,0.515,949,1362,0.697,659,2079,2738,1397,473,912,1274,6351
8317,2018-2-26,Philadelphia 76ers,58,14020,2303,4948,0.465,602,1673,0.36,1701,3275,0.519,1030,1355,0.76,641,2072,2713,1487,481,958,1301,6238
8318,2018-2-26,Washington Wizards,60,14500,2414,5148,0.469,592,1596,0.371,1822,3552,0.513,1027,1328,0.773,590,1983,2573,1476,484,827,1294,6447
8319,2018-2-26,Indiana Pacers,59,14210,2435,5069,0.48,543,1458,0.372,1892,3611,0.524,896,1159,0.773,543,1943,2486,1330,496,756,1109,6309
8320,2018-2-26,Charlotte Hornets,60,14475,2312,5209,0.444,593,1612,0.368,1719,3597,0.478,1173,1592,0.737,622,2121,2743,1275,417,744,1065,6390
8321,2018-2-26,Oklahoma City Thunder,61,14740,2415,5348,0.452,636,1815,0.35,1779,3533,0.504,1013,1434,0.706,765,1972,2737,1292,556,811,1228,6479
8322,2018-2-26,Orlando Magic,59,14185,2334,5068,0.461,617,1724,0.358,1717,3344,0.513,949,1244,0.763,524,1913,2437,1383,435,830,1158,6234
8323,2018-2-26,Milwaukee Bucks,59,14260,2305,4822,0.478,508,1448,0.351,1797,3374,0.533,1087,1402,0.775,474,1859,2333,1326,497,772,1280,6205
8324,2018-2-26,Brooklyn Nets,60,14525,2269,5215,0.435,723,2092,0.346,1546,3123,0.495,1052,1367,0.77,608,2100,2708,1362,366,865,1245,6313
8325,2018-2-26,Portland Trail Blazers,60,14475,2348,5189,0.452,606,1613,0.376,1742,3576,0.487,994,1239,0.802,586,2107,2693,1137,415,795,1178,6296
8326,2018-2-26,Phoenix Suns,61,14665,2334,5300,0.44,563,1691,0.333,1771,3609,0.491,1119,1494,0.749,652,2035,2687,1278,410,909,1363,6350
8327,2018-2-26,New York Knicks,61,14765,2449,5286,0.463,476,1356,0.351,1973,3930,0.502,974,1228,0.793,643,2062,2705,1392,415,892,1242,6348
8328,2018-2-26,Atlanta Hawks,60,14425,2290,5091,0.45,655,1803,0.363,1635,3288,0.497,974,1228,0.793,562,1889,2451,1423,476,894,1190,6209
8329,2018-2-26,Boston Celtics,61,14715,2320,5193,0.447,716,1926,0.372,1604,3267,0.491,960,1252,0.767,559,2141,2700,1351,440,799,1240,6316
8330,2018-2-26,Chicago Bulls,59,14335,2298,5242,0.438,651,1820,0.358,1647,3422,0.481,862,1126,0.766,540,2099,2639,1390,413,764,1131,6109
8331,2018-2-26,Detroit Pistons,59,14185,2297,5098,0.451,626,1685,0.372,1671,3413,0.49,869,1160,0.749,586,1947,2533,1340,441,769,1095,6089
8332,2018-2-26,Utah Jazz,60,14450,2273,4979,0.457,652,1750,0.373,1621,3229,0.502,982,1232,0.797,522,2007,2529,1284,528,826,1174,6180
8333,2018-2-26,San Antonio Spurs,61,14640,2361,5148,0.459,532,1486,0.358,1829,3662,0.499,968,1251,0.774,619,2080,2699,1393,447,796,1037,6222
8334,2018-2-26,Dallas Mavericks,60,14450,2269,5096,0.445,706,1954,0.361,1563,3142,0.497,868,1129,0.769,463,1965,2428,1349,425,711,1166,6112
8335,2018-2-26,Miami Heat,60,14475,2269,5014,0.453,657,1832,0.359,1612,3182,0.507,873,1158,0.754,538,2041,2579,1320,433,840,1195,6068
8336,2018-2-26,Sacramento Kings,59,14185,2288,5048,0.453,534,1385,0.386,1754,3663,0.479,731,1012,0.722,560,1829,2389,1260,483,801,1175,5841
8337,2018-2-26,Memphis Grizzlies,58,13945,2100,4731,0.444,534,1529,0.349,1566,3202,0.489,998,1250,0.798,534,1815,2349,1219,427,832,1365,5732
8338,2018-2-27,Golden State Warriors,61,14690,2660,5202,0.511,725,1823,0.398,1935,3379,0.573,1045,1289,0.811,523,2175,2698,1865,492,940,1205,7090
8339,2018-2-27,Houston Rockets,60,14450,2342,5059,0.463,931,2547,0.366,1411,2512,0.562,1224,1552,0.789,548,2067,2615,1304,521,804,1186,6839
8340,2018-2-27,Toronto Raptors,59,14235,2439,5174,0.471,685,1918,0.357,1754,3256,0.539,1055,1310,0.805,566,2003,2569,1391,483,750,1296,6618
8341,2018-2-27,New Orleans Pelicans,60,14675,2528,5249,0.482,636,1758,0.362,1892,3491,0.542,1025,1345,0.762,519,2112,2631,1584,470,894,1165,6717
8342,2018-2-27,Minnesota Timberwolves,64,15460,2634,5495,0.479,510,1432,0.356,2124,4063,0.523,1258,1566,0.803,668,2013,2681,1461,553,752,1140,7036
8343,2018-2-27,Cleveland Cavaliers,59,14210,2347,4954,0.474,708,1939,0.365,1639,3015,0.544,1077,1366,0.788,484,1982,2466,1387,420,816,1105,6479
8344,2018-2-27,Los Angeles Clippers,58,13945,2300,4933,0.466,588,1660,0.354,1712,3273,0.523,1113,1468,0.758,573,1965,2538,1291,450,825,1182,6301
8345,2018-2-27,Denver Nuggets,60,14475,2421,5187,0.467,668,1826,0.366,1753,3361,0.522,982,1296,0.758,679,1984,2663,1478,468,874,1094,6492
8346,2018-2-27,Los Angeles Lakers,60,14575,2470,5364,0.46,571,1684,0.339,1899,3680,0.516,963,1381,0.697,669,2128,2797,1425,481,935,1297,6474
8347,2018-2-27,Philadelphia 76ers,58,14020,2303,4948,0.465,602,1673,0.36,1701,3275,0.519,1030,1355,0.76,641,2072,2713,1487,481,958,1301,6238
8348,2018-2-27,Washington Wizards,60,14500,2414,5148,0.469,592,1596,0.371,1822,3552,0.513,1027,1328,0.773,590,1983,2573,1476,484,827,1294,6447
8349,2018-2-27,Indiana Pacers,60,14450,2476,5156,0.48,548,1478,0.371,1928,3678,0.524,912,1182,0.772,552,1984,2536,1352,502,768,1128,6412
8350,2018-2-27,Charlotte Hornets,60,14475,2312,5209,0.444,593,1612,0.368,1719,3597,0.478,1173,1592,0.737,622,2121,2743,1275,417,744,1065,6390
8351,2018-2-27,Oklahoma City Thunder,62,14980,2457,5436,0.452,647,1840,0.352,1810,3596,0.503,1030,1454,0.708,779,2008,2787,1316,562,831,1241,6591
8352,2018-2-27,Orlando Magic,60,14425,2373,5152,0.461,629,1753,0.359,1744,3399,0.513,964,1265,0.762,532,1940,2472,1406,450,846,1177,6339
8353,2018-2-27,Milwaukee Bucks,59,14260,2305,4822,0.478,508,1448,0.351,1797,3374,0.533,1087,1402,0.775,474,1859,2333,1326,497,772,1280,6205
8354,2018-2-27,Brooklyn Nets,61,14765,2309,5305,0.435,739,2134,0.346,1570,3171,0.495,1060,1375,0.771,615,2141,2756,1393,370,880,1265,6417
8355,2018-2-27,Portland Trail Blazers,60,14475,2348,5189,0.452,606,1613,0.376,1742,3576,0.487,994,1239,0.802,586,2107,2693,1137,415,795,1178,6296
8356,2018-2-27,Phoenix Suns,62,14905,2376,5397,0.44,570,1715,0.332,1806,3682,0.49,1144,1526,0.75,666,2072,2738,1301,419,923,1396,6466
8357,2018-2-27,New York Knicks,62,15005,2496,5382,0.464,486,1381,0.352,2010,4001,0.502,981,1237,0.793,653,2091,2744,1420,422,906,1260,6459
8358,2018-2-27,Boston Celtics,62,14955,2359,5279,0.447,728,1963,0.371,1631,3316,0.492,979,1279,0.765,568,2176,2744,1376,445,807,1263,6425
8359,2018-2-27,Atlanta Hawks,61,14665,2326,5187,0.448,663,1839,0.361,1663,3348,0.497,998,1262,0.791,570,1922,2492,1444,490,905,1207,6313
8360,2018-2-27,Chicago Bulls,60,14575,2331,5335,0.437,657,1843,0.356,1674,3492,0.479,877,1149,0.763,555,2140,2695,1407,421,777,1142,6196
8361,2018-2-27,Detroit Pistons,60,14425,2333,5192,0.449,633,1707,0.371,1700,3485,0.488,884,1180,0.749,599,1976,2575,1360,452,782,1117,6183
8362,2018-2-27,Utah Jazz,61,14690,2304,5050,0.456,659,1779,0.37,1645,3271,0.503,998,1254,0.796,529,2039,2568,1305,534,848,1193,6265
8363,2018-2-27,San Antonio Spurs,61,14640,2361,5148,0.459,532,1486,0.358,1829,3662,0.499,968,1251,0.774,619,2080,2699,1393,447,796,1037,6222
8364,2018-2-27,Dallas Mavericks,61,14690,2309,5184,0.445,720,1991,0.362,1589,3193,0.498,883,1147,0.77,470,2002,2472,1369,434,721,1187,6221
8365,2018-2-27,Miami Heat,60,14475,2269,5014,0.453,657,1832,0.359,1612,3182,0.507,873,1158,0.754,538,2041,2579,1320,433,840,1195,6068
8366,2018-2-27,Sacramento Kings,60,14425,2328,5132,0.454,542,1407,0.385,1786,3725,0.479,743,1025,0.725,568,1852,2420,1282,488,815,1198,5941
8367,2018-2-27,Memphis Grizzlies,59,14185,2134,4809,0.444,539,1552,0.347,1595,3257,0.49,1023,1282,0.798,539,1850,2389,1246,431,842,1387,5830
8368,2018-2-28,Golden State Warriors,61,14690,2660,5202,0.511,725,1823,0.398,1935,3379,0.573,1045,1289,0.811,523,2175,2698,1865,492,940,1205,7090
8369,2018-2-28,Houston Rockets,60,14450,2342,5059,0.463,931,2547,0.366,1411,2512,0.562,1224,1552,0.789,548,2067,2615,1304,521,804,1186,6839
8370,2018-2-28,Toronto Raptors,59,14235,2439,5174,0.471,685,1918,0.357,1754,3256,0.539,1055,1310,0.805,566,2003,2569,1391,483,750,1296,6618
8371,2018-2-28,New Orleans Pelicans,60,14675,2528,5249,0.482,636,1758,0.362,1892,3491,0.542,1025,1345,0.762,519,2112,2631,1584,470,894,1165,6717
8372,2018-2-28,Cleveland Cavaliers,60,14450,2397,5051,0.475,720,1963,0.367,1677,3088,0.543,1094,1393,0.785,498,2023,2521,1411,427,827,1129,6608
8373,2018-2-28,Minnesota Timberwolves,64,15460,2634,5495,0.479,510,1432,0.356,2124,4063,0.523,1258,1566,0.803,668,2013,2681,1461,553,752,1140,7036
8374,2018-2-28,Los Angeles Clippers,59,14185,2346,5022,0.467,595,1686,0.353,1751,3336,0.525,1136,1499,0.758,586,1995,2581,1317,462,843,1207,6423
8375,2018-2-28,Denver Nuggets,61,14715,2464,5274,0.467,678,1857,0.365,1786,3417,0.523,1006,1326,0.759,690,2014,2704,1505,479,894,1121,6612
8376,2018-2-28,Los Angeles Lakers,60,14575,2470,5364,0.46,571,1684,0.339,1899,3680,0.516,963,1381,0.697,669,2128,2797,1425,481,935,1297,6474
8377,2018-2-28,Washington Wizards,61,14740,2456,5236,0.469,599,1616,0.371,1857,3620,0.513,1043,1350,0.773,599,2014,2613,1506,493,838,1316,6554
8378,2018-2-28,Philadelphia 76ers,59,14260,2338,5032,0.465,614,1704,0.36,1724,3328,0.518,1049,1378,0.761,651,2106,2757,1512,491,981,1325,6339
8379,2018-2-28,Indiana Pacers,60,14450,2476,5156,0.48,548,1478,0.371,1928,3678,0.524,912,1182,0.772,552,1984,2536,1352,502,768,1128,6412
8380,2018-2-28,Charlotte Hornets,61,14715,2356,5291,0.445,608,1647,0.369,1748,3644,0.48,1188,1613,0.737,628,2150,2778,1303,428,758,1079,6508
8381,2018-2-28,Oklahoma City Thunder,62,14980,2457,5436,0.452,647,1840,0.352,1810,3596,0.503,1030,1454,0.708,779,2008,2787,1316,562,831,1241,6591
8382,2018-2-28,Orlando Magic,60,14425,2373,5152,0.461,629,1753,0.359,1744,3399,0.513,964,1265,0.762,532,1940,2472,1406,450,846,1177,6339
8383,2018-2-28,Brooklyn Nets,62,15005,2353,5387,0.437,751,2166,0.347,1602,3221,0.497,1083,1405,0.771,618,2174,2792,1422,376,892,1286,6540
8384,2018-2-28,Milwaukee Bucks,60,14500,2340,4899,0.478,518,1474,0.351,1822,3425,0.532,1111,1430,0.777,482,1891,2373,1346,507,788,1300,6309
8385,2018-2-28,Portland Trail Blazers,61,14715,2392,5273,0.454,621,1647,0.377,1771,3626,0.488,1007,1256,0.802,596,2144,2740,1164,425,812,1193,6412
8386,2018-2-28,Phoenix Suns,62,14905,2376,5397,0.44,570,1715,0.332,1806,3682,0.49,1144,1526,0.75,666,2072,2738,1301,419,923,1396,6466
8387,2018-2-28,New York Knicks,62,15005,2496,5382,0.464,486,1381,0.352,2010,4001,0.502,981,1237,0.793,653,2091,2744,1420,422,906,1260,6459
8388,2018-2-28,Boston Celtics,62,14955,2359,5279,0.447,728,1963,0.371,1631,3316,0.492,979,1279,0.765,568,2176,2744,1376,445,807,1263,6425
8389,2018-2-28,Atlanta Hawks,61,14665,2326,5187,0.448,663,1839,0.361,1663,3348,0.497,998,1262,0.791,570,1922,2492,1444,490,905,1207,6313
8390,2018-2-28,Chicago Bulls,61,14815,2370,5416,0.438,666,1867,0.357,1704,3549,0.48,893,1170,0.763,566,2173,2739,1433,429,797,1165,6299
8391,2018-2-28,Detroit Pistons,60,14425,2333,5192,0.449,633,1707,0.371,1700,3485,0.488,884,1180,0.749,599,1976,2575,1360,452,782,1117,6183
8392,2018-2-28,Utah Jazz,61,14690,2304,5050,0.456,659,1779,0.37,1645,3271,0.503,998,1254,0.796,529,2039,2568,1305,534,848,1193,6265
8393,2018-2-28,San Antonio Spurs,61,14640,2361,5148,0.459,532,1486,0.358,1829,3662,0.499,968,1251,0.774,619,2080,2699,1393,447,796,1037,6222
8394,2018-2-28,Dallas Mavericks,61,14690,2309,5184,0.445,720,1991,0.362,1589,3193,0.498,883,1147,0.77,470,2002,2472,1369,434,721,1187,6221
8395,2018-2-28,Miami Heat,61,14715,2305,5096,0.452,666,1859,0.358,1639,3237,0.506,894,1186,0.754,549,2067,2616,1339,445,855,1214,6170
8396,2018-2-28,Sacramento Kings,61,14665,2367,5220,0.453,549,1429,0.384,1818,3791,0.48,757,1040,0.728,574,1882,2456,1302,502,827,1210,6040
8397,2018-2-28,Memphis Grizzlies,59,14185,2134,4809,0.444,539,1552,0.347,1595,3257,0.49,1023,1282,0.798,539,1850,2389,1246,431,842,1387,5830
8398,2018-2-29,Golden State Warriors,62,14930,2697,5274,0.511,735,1847,0.398,1962,3427,0.573,1070,1319,0.811,526,2208,2734,1889,502,954,1226,7199
8399,2018-2-29,Houston Rockets,61,14690,2378,5144,0.462,944,2590,0.364,1434,2554,0.561,1244,1576,0.789,558,2098,2656,1325,532,814,1207,6944
8400,2018-2-29,Toronto Raptors,60,14475,2484,5257,0.473,697,1948,0.358,1787,3309,0.54,1070,1334,0.802,573,2038,2611,1424,492,762,1318,6735
8401,2018-2-29,New Orleans Pelicans,61,14915,2578,5348,0.482,645,1784,0.362,1933,3564,0.542,1037,1360,0.763,531,2143,2674,1610,477,906,1182,6838
8402,2018-2-29,Cleveland Cavaliers,60,14450,2397,5051,0.475,720,1963,0.367,1677,3088,0.543,1094,1393,0.785,498,2023,2521,1411,427,827,1129,6608
8403,2018-2-29,Minnesota Timberwolves,64,15460,2634,5495,0.479,510,1432,0.356,2124,4063,0.523,1258,1566,0.803,668,2013,2681,1461,553,752,1140,7036
8404,2018-2-29,Los Angeles Clippers,60,14425,2382,5101,0.467,602,1709,0.352,1780,3392,0.525,1149,1518,0.757,590,2030,2620,1334,468,859,1226,6515
8405,2018-2-29,Denver Nuggets,61,14715,2464,5274,0.467,678,1857,0.365,1786,3417,0.523,1006,1326,0.759,690,2014,2704,1505,479,894,1121,6612
8406,2018-2-29,Los Angeles Lakers,60,14575,2470,5364,0.46,571,1684,0.339,1899,3680,0.516,963,1381,0.697,669,2128,2797,1425,481,935,1297,6474
8407,2018-2-29,Philadelphia 76ers,59,14260,2338,5032,0.465,614,1704,0.36,1724,3328,0.518,1049,1378,0.761,651,2106,2757,1512,491,981,1325,6339
8408,2018-2-29,Washington Wizards,62,14980,2492,5326,0.468,610,1648,0.37,1882,3678,0.512,1061,1371,0.774,617,2047,2664,1531,499,854,1340,6655
8409,2018-2-29,Indiana Pacers,61,14690,2514,5246,0.479,559,1510,0.37,1955,3736,0.523,927,1202,0.771,563,2016,2579,1373,515,792,1148,6514
8410,2018-2-29,Charlotte Hornets,62,14955,2398,5382,0.446,617,1674,0.369,1781,3708,0.48,1201,1635,0.735,637,2174,2811,1327,434,765,1096,6614
8411,2018-2-29,Oklahoma City Thunder,63,15245,2499,5529,0.452,657,1876,0.35,1842,3653,0.504,1047,1473,0.711,798,2045,2843,1335,569,853,1265,6702
8412,2018-2-29,Orlando Magic,61,14665,2412,5234,0.461,642,1783,0.36,1770,3451,0.513,977,1288,0.759,540,1974,2514,1433,458,859,1196,6443
8413,2018-2-29,Brooklyn Nets,62,15005,2353,5387,0.437,751,2166,0.347,1602,3221,0.497,1083,1405,0.771,618,2174,2792,1422,376,892,1286,6540
8414,2018-2-29,Portland Trail Blazers,61,14715,2392,5273,0.454,621,1647,0.377,1771,3626,0.488,1007,1256,0.802,596,2144,2740,1164,425,812,1193,6412
8415,2018-2-29,Milwaukee Bucks,61,14740,2368,4972,0.476,526,1498,0.351,1842,3474,0.53,1134,1458,0.778,488,1920,2408,1362,514,801,1320,6396
8416,2018-2-29,Phoenix Suns,63,15145,2414,5480,0.441,576,1736,0.332,1838,3744,0.491,1172,1564,0.749,674,2111,2785,1320,431,939,1424,6576
8417,2018-2-29,New York Knicks,62,15005,2496,5382,0.464,486,1381,0.352,2010,4001,0.502,981,1237,0.793,653,2091,2744,1420,422,906,1260,6459
8418,2018-2-29,Boston Celtics,63,15195,2413,5366,0.45,740,1983,0.373,1673,3383,0.495,993,1294,0.767,572,2219,2791,1407,448,817,1283,6559
8419,2018-2-29,Atlanta Hawks,62,14905,2364,5274,0.448,672,1868,0.36,1692,3406,0.497,1020,1289,0.791,585,1956,2541,1465,503,926,1230,6420
8420,2018-2-29,Chicago Bulls,61,14815,2370,5416,0.438,666,1867,0.357,1704,3549,0.48,893,1170,0.763,566,2173,2739,1433,429,797,1165,6299
8421,2018-2-29,Detroit Pistons,61,14665,2375,5287,0.449,642,1736,0.37,1733,3551,0.488,901,1202,0.75,621,2011,2632,1386,461,791,1137,6293
8422,2018-2-29,Utah Jazz,61,14690,2304,5050,0.456,659,1779,0.37,1645,3271,0.503,998,1254,0.796,529,2039,2568,1305,534,848,1193,6265
8423,2018-2-29,San Antonio Spurs,62,14880,2409,5247,0.459,541,1512,0.358,1868,3735,0.5,979,1265,0.774,632,2114,2746,1416,454,807,1052,6338
8424,2018-2-29,Dallas Mavericks,62,14955,2353,5275,0.446,733,2027,0.362,1620,3248,0.499,892,1162,0.768,478,2030,2508,1399,445,737,1209,6331
8425,2018-2-29,Miami Heat,61,14715,2305,5096,0.452,666,1859,0.358,1639,3237,0.506,894,1186,0.754,549,2067,2616,1339,445,855,1214,6170
8426,2018-2-29,Sacramento Kings,61,14665,2367,5220,0.453,549,1429,0.384,1818,3791,0.48,757,1040,0.728,574,1882,2456,1302,502,827,1210,6040
8427,2018-2-29,Memphis Grizzlies,60,14425,2167,4896,0.443,552,1583,0.349,1615,3313,0.487,1046,1310,0.798,550,1887,2437,1269,439,862,1416,5932
8428,2018-2-30,Golden State Warriors,62,14930,2697,5274,0.511,735,1847,0.398,1962,3427,0.573,1070,1319,0.811,526,2208,2734,1889,502,954,1226,7199
8429,2018-2-30,Houston Rockets,61,14690,2378,5144,0.462,944,2590,0.364,1434,2554,0.561,1244,1576,0.789,558,2098,2656,1325,532,814,1207,6944
8430,2018-2-30,Toronto Raptors,60,14475,2484,5257,0.473,697,1948,0.358,1787,3309,0.54,1070,1334,0.802,573,2038,2611,1424,492,762,1318,6735
8431,2018-2-30,New Orleans Pelicans,61,14915,2578,5348,0.482,645,1784,0.362,1933,3564,0.542,1037,1360,0.763,531,2143,2674,1610,477,906,1182,6838
8432,2018-2-30,Cleveland Cavaliers,60,14450,2397,5051,0.475,720,1963,0.367,1677,3088,0.543,1094,1393,0.785,498,2023,2521,1411,427,827,1129,6608
8433,2018-2-30,Minnesota Timberwolves,64,15460,2634,5495,0.479,510,1432,0.356,2124,4063,0.523,1258,1566,0.803,668,2013,2681,1461,553,752,1140,7036
8434,2018-2-30,Los Angeles Clippers,60,14425,2382,5101,0.467,602,1709,0.352,1780,3392,0.525,1149,1518,0.757,590,2030,2620,1334,468,859,1226,6515
8435,2018-2-30,Denver Nuggets,61,14715,2464,5274,0.467,678,1857,0.365,1786,3417,0.523,1006,1326,0.759,690,2014,2704,1505,479,894,1121,6612
8436,2018-2-30,Los Angeles Lakers,60,14575,2470,5364,0.46,571,1684,0.339,1899,3680,0.516,963,1381,0.697,669,2128,2797,1425,481,935,1297,6474
8437,2018-2-30,Philadelphia 76ers,59,14260,2338,5032,0.465,614,1704,0.36,1724,3328,0.518,1049,1378,0.761,651,2106,2757,1512,491,981,1325,6339
8438,2018-2-30,Washington Wizards,62,14980,2492,5326,0.468,610,1648,0.37,1882,3678,0.512,1061,1371,0.774,617,2047,2664,1531,499,854,1340,6655
8439,2018-2-30,Indiana Pacers,61,14690,2514,5246,0.479,559,1510,0.37,1955,3736,0.523,927,1202,0.771,563,2016,2579,1373,515,792,1148,6514
8440,2018-2-30,Charlotte Hornets,62,14955,2398,5382,0.446,617,1674,0.369,1781,3708,0.48,1201,1635,0.735,637,2174,2811,1327,434,765,1096,6614
8441,2018-2-30,Oklahoma City Thunder,63,15245,2499,5529,0.452,657,1876,0.35,1842,3653,0.504,1047,1473,0.711,798,2045,2843,1335,569,853,1265,6702
8442,2018-2-30,Orlando Magic,61,14665,2412,5234,0.461,642,1783,0.36,1770,3451,0.513,977,1288,0.759,540,1974,2514,1433,458,859,1196,6443
8443,2018-2-30,Brooklyn Nets,62,15005,2353,5387,0.437,751,2166,0.347,1602,3221,0.497,1083,1405,0.771,618,2174,2792,1422,376,892,1286,6540
8444,2018-2-30,Portland Trail Blazers,61,14715,2392,5273,0.454,621,1647,0.377,1771,3626,0.488,1007,1256,0.802,596,2144,2740,1164,425,812,1193,6412
8445,2018-2-30,Milwaukee Bucks,61,14740,2368,4972,0.476,526,1498,0.351,1842,3474,0.53,1134,1458,0.778,488,1920,2408,1362,514,801,1320,6396
8446,2018-2-30,Phoenix Suns,63,15145,2414,5480,0.441,576,1736,0.332,1838,3744,0.491,1172,1564,0.749,674,2111,2785,1320,431,939,1424,6576
8447,2018-2-30,New York Knicks,62,15005,2496,5382,0.464,486,1381,0.352,2010,4001,0.502,981,1237,0.793,653,2091,2744,1420,422,906,1260,6459
8448,2018-2-30,Boston Celtics,63,15195,2413,5366,0.45,740,1983,0.373,1673,3383,0.495,993,1294,0.767,572,2219,2791,1407,448,817,1283,6559
8449,2018-2-30,Atlanta Hawks,62,14905,2364,5274,0.448,672,1868,0.36,1692,3406,0.497,1020,1289,0.791,585,1956,2541,1465,503,926,1230,6420
8450,2018-2-30,Chicago Bulls,61,14815,2370,5416,0.438,666,1867,0.357,1704,3549,0.48,893,1170,0.763,566,2173,2739,1433,429,797,1165,6299
8451,2018-2-30,Detroit Pistons,61,14665,2375,5287,0.449,642,1736,0.37,1733,3551,0.488,901,1202,0.75,621,2011,2632,1386,461,791,1137,6293
8452,2018-2-30,Utah Jazz,61,14690,2304,5050,0.456,659,1779,0.37,1645,3271,0.503,998,1254,0.796,529,2039,2568,1305,534,848,1193,6265
8453,2018-2-30,San Antonio Spurs,62,14880,2409,5247,0.459,541,1512,0.358,1868,3735,0.5,979,1265,0.774,632,2114,2746,1416,454,807,1052,6338
8454,2018-2-30,Dallas Mavericks,62,14955,2353,5275,0.446,733,2027,0.362,1620,3248,0.499,892,1162,0.768,478,2030,2508,1399,445,737,1209,6331
8455,2018-2-30,Miami Heat,61,14715,2305,5096,0.452,666,1859,0.358,1639,3237,0.506,894,1186,0.754,549,2067,2616,1339,445,855,1214,6170
8456,2018-2-30,Sacramento Kings,61,14665,2367,5220,0.453,549,1429,0.384,1818,3791,0.48,757,1040,0.728,574,1882,2456,1302,502,827,1210,6040
8457,2018-2-30,Memphis Grizzlies,60,14425,2167,4896,0.443,552,1583,0.349,1615,3313,0.487,1046,1310,0.798,550,1887,2437,1269,439,862,1416,5932
8458,2018-3-1,Golden State Warriors,62,14930,2697,5274,0.511,735,1847,0.398,1962,3427,0.573,1070,1319,0.811,526,2208,2734,1889,502,954,1226,7199
8459,2018-3-1,Houston Rockets,61,14690,2378,5144,0.462,944,2590,0.364,1434,2554,0.561,1244,1576,0.789,558,2098,2656,1325,532,814,1207,6944
8460,2018-3-1,Toronto Raptors,60,14475,2484,5257,0.473,697,1948,0.358,1787,3309,0.54,1070,1334,0.802,573,2038,2611,1424,492,762,1318,6735
8461,2018-3-1,New Orleans Pelicans,61,14915,2578,5348,0.482,645,1784,0.362,1933,3564,0.542,1037,1360,0.763,531,2143,2674,1610,477,906,1182,6838
8462,2018-3-1,Cleveland Cavaliers,60,14450,2397,5051,0.475,720,1963,0.367,1677,3088,0.543,1094,1393,0.785,498,2023,2521,1411,427,827,1129,6608
8463,2018-3-1,Minnesota Timberwolves,64,15460,2634,5495,0.479,510,1432,0.356,2124,4063,0.523,1258,1566,0.803,668,2013,2681,1461,553,752,1140,7036
8464,2018-3-1,Los Angeles Clippers,60,14425,2382,5101,0.467,602,1709,0.352,1780,3392,0.525,1149,1518,0.757,590,2030,2620,1334,468,859,1226,6515
8465,2018-3-1,Denver Nuggets,61,14715,2464,5274,0.467,678,1857,0.365,1786,3417,0.523,1006,1326,0.759,690,2014,2704,1505,479,894,1121,6612
8466,2018-3-1,Los Angeles Lakers,60,14575,2470,5364,0.46,571,1684,0.339,1899,3680,0.516,963,1381,0.697,669,2128,2797,1425,481,935,1297,6474
8467,2018-3-1,Philadelphia 76ers,59,14260,2338,5032,0.465,614,1704,0.36,1724,3328,0.518,1049,1378,0.761,651,2106,2757,1512,491,981,1325,6339
8468,2018-3-1,Washington Wizards,62,14980,2492,5326,0.468,610,1648,0.37,1882,3678,0.512,1061,1371,0.774,617,2047,2664,1531,499,854,1340,6655
8469,2018-3-1,Indiana Pacers,61,14690,2514,5246,0.479,559,1510,0.37,1955,3736,0.523,927,1202,0.771,563,2016,2579,1373,515,792,1148,6514
8470,2018-3-1,Charlotte Hornets,62,14955,2398,5382,0.446,617,1674,0.369,1781,3708,0.48,1201,1635,0.735,637,2174,2811,1327,434,765,1096,6614
8471,2018-3-1,Oklahoma City Thunder,63,15245,2499,5529,0.452,657,1876,0.35,1842,3653,0.504,1047,1473,0.711,798,2045,2843,1335,569,853,1265,6702
8472,2018-3-1,Orlando Magic,61,14665,2412,5234,0.461,642,1783,0.36,1770,3451,0.513,977,1288,0.759,540,1974,2514,1433,458,859,1196,6443
8473,2018-3-1,Brooklyn Nets,62,15005,2353,5387,0.437,751,2166,0.347,1602,3221,0.497,1083,1405,0.771,618,2174,2792,1422,376,892,1286,6540
8474,2018-3-1,Portland Trail Blazers,61,14715,2392,5273,0.454,621,1647,0.377,1771,3626,0.488,1007,1256,0.802,596,2144,2740,1164,425,812,1193,6412
8475,2018-3-1,Milwaukee Bucks,61,14740,2368,4972,0.476,526,1498,0.351,1842,3474,0.53,1134,1458,0.778,488,1920,2408,1362,514,801,1320,6396
8476,2018-3-1,Phoenix Suns,63,15145,2414,5480,0.441,576,1736,0.332,1838,3744,0.491,1172,1564,0.749,674,2111,2785,1320,431,939,1424,6576
8477,2018-3-1,New York Knicks,62,15005,2496,5382,0.464,486,1381,0.352,2010,4001,0.502,981,1237,0.793,653,2091,2744,1420,422,906,1260,6459
8478,2018-3-1,Boston Celtics,63,15195,2413,5366,0.45,740,1983,0.373,1673,3383,0.495,993,1294,0.767,572,2219,2791,1407,448,817,1283,6559
8479,2018-3-1,Atlanta Hawks,62,14905,2364,5274,0.448,672,1868,0.36,1692,3406,0.497,1020,1289,0.791,585,1956,2541,1465,503,926,1230,6420
8480,2018-3-1,Chicago Bulls,61,14815,2370,5416,0.438,666,1867,0.357,1704,3549,0.48,893,1170,0.763,566,2173,2739,1433,429,797,1165,6299
8481,2018-3-1,Detroit Pistons,61,14665,2375,5287,0.449,642,1736,0.37,1733,3551,0.488,901,1202,0.75,621,2011,2632,1386,461,791,1137,6293
8482,2018-3-1,Utah Jazz,61,14690,2304,5050,0.456,659,1779,0.37,1645,3271,0.503,998,1254,0.796,529,2039,2568,1305,534,848,1193,6265
8483,2018-3-1,San Antonio Spurs,62,14880,2409,5247,0.459,541,1512,0.358,1868,3735,0.5,979,1265,0.774,632,2114,2746,1416,454,807,1052,6338
8484,2018-3-1,Dallas Mavericks,62,14955,2353,5275,0.446,733,2027,0.362,1620,3248,0.499,892,1162,0.768,478,2030,2508,1399,445,737,1209,6331
8485,2018-3-1,Miami Heat,61,14715,2305,5096,0.452,666,1859,0.358,1639,3237,0.506,894,1186,0.754,549,2067,2616,1339,445,855,1214,6170
8486,2018-3-1,Sacramento Kings,61,14665,2367,5220,0.453,549,1429,0.384,1818,3791,0.48,757,1040,0.728,574,1882,2456,1302,502,827,1210,6040
8487,2018-3-1,Memphis Grizzlies,60,14425,2167,4896,0.443,552,1583,0.349,1615,3313,0.487,1046,1310,0.798,550,1887,2437,1269,439,862,1416,5932
8488,2018-3-2,Golden State Warriors,62,14930,2697,5274,0.511,735,1847,0.398,1962,3427,0.573,1070,1319,0.811,526,2208,2734,1889,502,954,1226,7199
8489,2018-3-2,Houston Rockets,61,14690,2378,5144,0.462,944,2590,0.364,1434,2554,0.561,1244,1576,0.789,558,2098,2656,1325,532,814,1207,6944
8490,2018-3-2,Toronto Raptors,60,14475,2484,5257,0.473,697,1948,0.358,1787,3309,0.54,1070,1334,0.802,573,2038,2611,1424,492,762,1318,6735
8491,2018-3-2,New Orleans Pelicans,61,14915,2578,5348,0.482,645,1784,0.362,1933,3564,0.542,1037,1360,0.763,531,2143,2674,1610,477,906,1182,6838
8492,2018-3-2,Cleveland Cavaliers,61,14690,2433,5138,0.474,729,1995,0.365,1704,3143,0.542,1110,1416,0.784,508,2058,2566,1434,431,836,1150,6705
8493,2018-3-2,Minnesota Timberwolves,65,15700,2672,5580,0.479,514,1452,0.354,2158,4128,0.523,1277,1587,0.805,677,2053,2730,1477,558,767,1164,7135
8494,2018-3-2,Los Angeles Clippers,60,14425,2382,5101,0.467,602,1709,0.352,1780,3392,0.525,1149,1518,0.757,590,2030,2620,1334,468,859,1226,6515
8495,2018-3-2,Denver Nuggets,61,14715,2464,5274,0.467,678,1857,0.365,1786,3417,0.523,1006,1326,0.759,690,2014,2704,1505,479,894,1121,6612
8496,2018-3-2,Los Angeles Lakers,61,14815,2517,5443,0.462,587,1713,0.343,1930,3730,0.517,984,1407,0.699,675,2158,2833,1454,490,948,1314,6605
8497,2018-3-2,Philadelphia 76ers,60,14500,2378,5122,0.464,624,1734,0.36,1754,3388,0.518,1067,1405,0.759,665,2146,2811,1534,495,990,1345,6447
8498,2018-3-2,Washington Wizards,62,14980,2492,5326,0.468,610,1648,0.37,1882,3678,0.512,1061,1371,0.774,617,2047,2664,1531,499,854,1340,6655
8499,2018-3-2,Indiana Pacers,61,14690,2514,5246,0.479,559,1510,0.37,1955,3736,0.523,927,1202,0.771,563,2016,2579,1373,515,792,1148,6514
8500,2018-3-2,Charlotte Hornets,62,14955,2398,5382,0.446,617,1674,0.369,1781,3708,0.48,1201,1635,0.735,637,2174,2811,1327,434,765,1096,6614
8501,2018-3-2,Oklahoma City Thunder,63,15245,2499,5529,0.452,657,1876,0.35,1842,3653,0.504,1047,1473,0.711,798,2045,2843,1335,569,853,1265,6702
8502,2018-3-2,Orlando Magic,61,14665,2412,5234,0.461,642,1783,0.36,1770,3451,0.513,977,1288,0.759,540,1974,2514,1433,458,859,1196,6443
8503,2018-3-2,Brooklyn Nets,63,15270,2393,5483,0.436,768,2212,0.347,1625,3271,0.497,1097,1422,0.771,634,2209,2843,1449,386,913,1300,6651
8504,2018-3-2,Portland Trail Blazers,62,14955,2428,5365,0.453,630,1677,0.376,1798,3688,0.488,1034,1291,0.801,608,2180,2788,1181,434,820,1211,6520
8505,2018-3-2,Milwaukee Bucks,61,14740,2368,4972,0.476,526,1498,0.351,1842,3474,0.53,1134,1458,0.778,488,1920,2408,1362,514,801,1320,6396
8506,2018-3-2,Phoenix Suns,63,15145,2414,5480,0.441,576,1736,0.332,1838,3744,0.491,1172,1564,0.749,674,2111,2785,1320,431,939,1424,6576
8507,2018-3-2,New York Knicks,62,15005,2496,5382,0.464,486,1381,0.352,2010,4001,0.502,981,1237,0.793,653,2091,2744,1420,422,906,1260,6459
8508,2018-3-2,Boston Celtics,63,15195,2413,5366,0.45,740,1983,0.373,1673,3383,0.495,993,1294,0.767,572,2219,2791,1407,448,817,1283,6559
8509,2018-3-2,Atlanta Hawks,62,14905,2364,5274,0.448,672,1868,0.36,1692,3406,0.497,1020,1289,0.791,585,1956,2541,1465,503,926,1230,6420
8510,2018-3-2,Chicago Bulls,61,14815,2370,5416,0.438,666,1867,0.357,1704,3549,0.48,893,1170,0.763,566,2173,2739,1433,429,797,1165,6299
8511,2018-3-2,Detroit Pistons,61,14665,2375,5287,0.449,642,1736,0.37,1733,3551,0.488,901,1202,0.75,621,2011,2632,1386,461,791,1137,6293
8512,2018-3-2,Utah Jazz,61,14690,2304,5050,0.456,659,1779,0.37,1645,3271,0.503,998,1254,0.796,529,2039,2568,1305,534,848,1193,6265
8513,2018-3-2,San Antonio Spurs,62,14880,2409,5247,0.459,541,1512,0.358,1868,3735,0.5,979,1265,0.774,632,2114,2746,1416,454,807,1052,6338
8514,2018-3-2,Dallas Mavericks,62,14955,2353,5275,0.446,733,2027,0.362,1620,3248,0.499,892,1162,0.768,478,2030,2508,1399,445,737,1209,6331
8515,2018-3-2,Miami Heat,62,14955,2351,5191,0.453,675,1890,0.357,1676,3301,0.508,906,1202,0.754,563,2093,2656,1362,451,866,1235,6283
8516,2018-3-2,Sacramento Kings,62,14930,2417,5317,0.455,555,1443,0.385,1862,3874,0.481,767,1052,0.729,585,1915,2500,1325,517,842,1223,6156
8517,2018-3-2,Memphis Grizzlies,60,14425,2167,4896,0.443,552,1583,0.349,1615,3313,0.487,1046,1310,0.798,550,1887,2437,1269,439,862,1416,5932
8518,2018-3-3,Golden State Warriors,63,15170,2739,5353,0.512,746,1878,0.397,1993,3475,0.574,1089,1341,0.812,528,2241,2769,1922,514,972,1246,7313
8519,2018-3-3,Houston Rockets,61,14690,2378,5144,0.462,944,2590,0.364,1434,2554,0.561,1244,1576,0.789,558,2098,2656,1325,532,814,1207,6944
8520,2018-3-3,New Orleans Pelicans,61,14915,2578,5348,0.482,645,1784,0.362,1933,3564,0.542,1037,1360,0.763,531,2143,2674,1610,477,906,1182,6838
8521,2018-3-3,Toronto Raptors,61,14715,2520,5335,0.472,707,1981,0.357,1813,3354,0.541,1090,1366,0.798,581,2064,2645,1443,501,769,1340,6837
8522,2018-3-3,Cleveland Cavaliers,61,14690,2433,5138,0.474,729,1995,0.365,1704,3143,0.542,1110,1416,0.784,508,2058,2566,1434,431,836,1150,6705
8523,2018-3-3,Minnesota Timberwolves,66,15940,2710,5654,0.479,523,1469,0.356,2187,4185,0.523,1300,1618,0.803,679,2078,2757,1491,567,779,1187,7243
8524,2018-3-3,Los Angeles Clippers,61,14665,2432,5190,0.469,611,1734,0.352,1821,3456,0.527,1168,1542,0.757,604,2067,2671,1368,482,870,1243,6643
8525,2018-3-3,Denver Nuggets,62,14955,2504,5347,0.468,684,1879,0.364,1820,3468,0.525,1028,1352,0.76,696,2045,2741,1523,496,916,1143,6720
8526,2018-3-3,Los Angeles Lakers,61,14815,2517,5443,0.462,587,1713,0.343,1930,3730,0.517,984,1407,0.699,675,2158,2833,1454,490,948,1314,6605
8527,2018-3-3,Philadelphia 76ers,61,14740,2419,5203,0.465,633,1758,0.36,1786,3445,0.518,1086,1430,0.759,672,2185,2857,1561,499,1001,1367,6557
8528,2018-3-3,Washington Wizards,63,15220,2528,5405,0.468,619,1672,0.37,1909,3733,0.511,1075,1392,0.772,632,2079,2711,1555,501,871,1365,6750
8529,2018-3-3,Oklahoma City Thunder,64,15485,2545,5625,0.452,668,1910,0.35,1877,3715,0.505,1068,1502,0.711,814,2077,2891,1357,574,864,1285,6826
8530,2018-3-3,Indiana Pacers,62,14930,2551,5329,0.479,565,1526,0.37,1986,3803,0.522,950,1232,0.771,576,2051,2627,1392,527,806,1171,6617
8531,2018-3-3,Charlotte Hornets,63,15195,2432,5463,0.445,628,1698,0.37,1804,3765,0.479,1221,1667,0.732,644,2206,2850,1348,441,775,1121,6713
8532,2018-3-3,Orlando Magic,62,14930,2456,5320,0.462,655,1819,0.36,1801,3501,0.514,991,1307,0.758,547,2012,2559,1467,466,875,1219,6558
8533,2018-3-3,Brooklyn Nets,63,15270,2393,5483,0.436,768,2212,0.347,1625,3271,0.497,1097,1422,0.771,634,2209,2843,1449,386,913,1300,6651
8534,2018-3-3,Portland Trail Blazers,62,14955,2428,5365,0.453,630,1677,0.376,1798,3688,0.488,1034,1291,0.801,608,2180,2788,1181,434,820,1211,6520
8535,2018-3-3,Milwaukee Bucks,62,14980,2399,5053,0.475,535,1523,0.351,1864,3530,0.528,1159,1490,0.778,502,1949,2451,1377,523,816,1344,6492
8536,2018-3-3,Phoenix Suns,64,15385,2460,5576,0.441,587,1761,0.333,1873,3815,0.491,1185,1582,0.749,687,2142,2829,1346,436,952,1449,6692
8537,2018-3-3,New York Knicks,63,15245,2537,5471,0.464,497,1406,0.353,2040,4065,0.502,993,1253,0.792,663,2114,2777,1444,426,923,1282,6564
8538,2018-3-3,Boston Celtics,63,15195,2413,5366,0.45,740,1983,0.373,1673,3383,0.495,993,1294,0.767,572,2219,2791,1407,448,817,1283,6559
8539,2018-3-3,Atlanta Hawks,63,15145,2402,5360,0.448,687,1903,0.361,1715,3457,0.496,1038,1309,0.793,588,1988,2576,1486,513,945,1251,6529
8540,2018-3-3,Chicago Bulls,62,15055,2412,5505,0.438,676,1894,0.357,1736,3611,0.481,907,1190,0.762,577,2207,2784,1457,439,810,1183,6407
8541,2018-3-3,Detroit Pistons,62,14930,2415,5379,0.449,654,1765,0.371,1761,3614,0.487,915,1226,0.746,634,2041,2675,1408,471,805,1154,6399
8542,2018-3-3,Utah Jazz,62,14930,2344,5128,0.457,668,1808,0.369,1676,3320,0.505,1025,1289,0.795,540,2073,2613,1326,541,866,1214,6381
8543,2018-3-3,San Antonio Spurs,62,14880,2409,5247,0.459,541,1512,0.358,1868,3735,0.5,979,1265,0.774,632,2114,2746,1416,454,807,1052,6338
8544,2018-3-3,Dallas Mavericks,63,15195,2388,5359,0.446,746,2056,0.363,1642,3303,0.497,909,1183,0.768,491,2063,2554,1420,451,754,1224,6431
8545,2018-3-3,Miami Heat,62,14955,2351,5191,0.453,675,1890,0.357,1676,3301,0.508,906,1202,0.754,563,2093,2656,1362,451,866,1235,6283
8546,2018-3-3,Sacramento Kings,62,14930,2417,5317,0.455,555,1443,0.385,1862,3874,0.481,767,1052,0.729,585,1915,2500,1325,517,842,1223,6156
8547,2018-3-3,Memphis Grizzlies,61,14665,2207,4987,0.443,562,1610,0.349,1645,3377,0.487,1058,1325,0.798,567,1910,2477,1295,453,882,1439,6034
8548,2018-3-4,Golden State Warriors,63,15170,2739,5353,0.512,746,1878,0.397,1993,3475,0.574,1089,1341,0.812,528,2241,2769,1922,514,972,1246,7313
8549,2018-3-4,Houston Rockets,62,14930,2417,5231,0.462,963,2639,0.365,1454,2592,0.561,1270,1606,0.791,568,2128,2696,1349,543,824,1228,7067
8550,2018-3-4,New Orleans Pelicans,61,14915,2578,5348,0.482,645,1784,0.362,1933,3564,0.542,1037,1360,0.763,531,2143,2674,1610,477,906,1182,6838
8551,2018-3-4,Toronto Raptors,61,14715,2520,5335,0.472,707,1981,0.357,1813,3354,0.541,1090,1366,0.798,581,2064,2645,1443,501,769,1340,6837
8552,2018-3-4,Cleveland Cavaliers,62,14930,2479,5226,0.474,738,2019,0.366,1741,3207,0.543,1126,1437,0.784,520,2087,2607,1459,436,845,1166,6822
8553,2018-3-4,Minnesota Timberwolves,66,15940,2710,5654,0.479,523,1469,0.356,2187,4185,0.523,1300,1618,0.803,679,2078,2757,1491,567,779,1187,7243
8554,2018-3-4,Los Angeles Clippers,61,14665,2432,5190,0.469,611,1734,0.352,1821,3456,0.527,1168,1542,0.757,604,2067,2671,1368,482,870,1243,6643
8555,2018-3-4,Denver Nuggets,63,15195,2551,5433,0.47,703,1914,0.367,1848,3519,0.525,1041,1367,0.762,702,2074,2776,1558,500,925,1162,6846
8556,2018-3-4,Los Angeles Lakers,62,15055,2557,5535,0.462,602,1747,0.345,1955,3788,0.516,1005,1434,0.701,685,2194,2879,1480,500,963,1335,6721
8557,2018-3-4,Philadelphia 76ers,61,14740,2419,5203,0.465,633,1758,0.36,1786,3445,0.518,1086,1430,0.759,672,2185,2857,1561,499,1001,1367,6557
8558,2018-3-4,Washington Wizards,63,15220,2528,5405,0.468,619,1672,0.37,1909,3733,0.511,1075,1392,0.772,632,2079,2711,1555,501,871,1365,6750
8559,2018-3-4,Indiana Pacers,62,14930,2551,5329,0.479,565,1526,0.37,1986,3803,0.522,950,1232,0.771,576,2051,2627,1392,527,806,1171,6617
8560,2018-3-4,Charlotte Hornets,63,15195,2432,5463,0.445,628,1698,0.37,1804,3765,0.479,1221,1667,0.732,644,2206,2850,1348,441,775,1121,6713
8561,2018-3-4,Oklahoma City Thunder,65,15725,2585,5716,0.452,674,1937,0.348,1911,3779,0.506,1082,1523,0.71,823,2108,2931,1375,580,876,1306,6926
8562,2018-3-4,Orlando Magic,63,15170,2492,5392,0.462,663,1844,0.36,1829,3548,0.516,1018,1340,0.76,552,2051,2603,1486,470,889,1242,6665
8563,2018-3-4,Brooklyn Nets,63,15270,2393,5483,0.436,768,2212,0.347,1625,3271,0.497,1097,1422,0.771,634,2209,2843,1449,386,913,1300,6651
8564,2018-3-4,Portland Trail Blazers,63,15195,2467,5453,0.452,641,1710,0.375,1826,3743,0.488,1053,1314,0.801,622,2213,2835,1201,440,835,1232,6628
8565,2018-3-4,Milwaukee Bucks,62,14980,2399,5053,0.475,535,1523,0.351,1864,3530,0.528,1159,1490,0.778,502,1949,2451,1377,523,816,1344,6492
8566,2018-3-4,Phoenix Suns,64,15385,2460,5576,0.441,587,1761,0.333,1873,3815,0.491,1185,1582,0.749,687,2142,2829,1346,436,952,1449,6692
8567,2018-3-4,Boston Celtics,64,15435,2457,5457,0.45,753,2007,0.375,1704,3450,0.494,1012,1315,0.77,582,2247,2829,1429,454,830,1304,6679
8568,2018-3-4,New York Knicks,63,15245,2537,5471,0.464,497,1406,0.353,2040,4065,0.502,993,1253,0.792,663,2114,2777,1444,426,923,1282,6564
8569,2018-3-4,Atlanta Hawks,63,15145,2402,5360,0.448,687,1903,0.361,1715,3457,0.496,1038,1309,0.793,588,1988,2576,1486,513,945,1251,6529
8570,2018-3-4,Chicago Bulls,62,15055,2412,5505,0.438,676,1894,0.357,1736,3611,0.481,907,1190,0.762,577,2207,2784,1457,439,810,1183,6407
8571,2018-3-4,Detroit Pistons,63,15170,2452,5468,0.448,661,1789,0.369,1791,3679,0.487,930,1247,0.746,651,2070,2721,1426,479,823,1177,6495
8572,2018-3-4,Utah Jazz,63,15170,2378,5210,0.456,679,1840,0.369,1699,3370,0.504,1044,1318,0.792,551,2114,2665,1346,550,879,1233,6479
8573,2018-3-4,San Antonio Spurs,63,15120,2453,5345,0.459,548,1542,0.355,1905,3803,0.501,996,1285,0.775,644,2152,2796,1444,464,823,1071,6450
8574,2018-3-4,Dallas Mavericks,63,15195,2388,5359,0.446,746,2056,0.363,1642,3303,0.497,909,1183,0.768,491,2063,2554,1420,451,754,1224,6431
8575,2018-3-4,Miami Heat,63,15195,2388,5273,0.453,687,1919,0.358,1701,3354,0.507,925,1230,0.752,578,2123,2701,1381,462,879,1255,6388
8576,2018-3-4,Sacramento Kings,63,15170,2451,5406,0.453,564,1473,0.383,1887,3933,0.48,781,1069,0.731,596,1952,2548,1340,524,855,1247,6247
8577,2018-3-4,Memphis Grizzlies,62,14905,2245,5080,0.442,568,1632,0.348,1677,3448,0.486,1076,1351,0.796,580,1943,2523,1319,462,891,1465,6134
8578,2018-3-5,Golden State Warriors,63,15170,2739,5353,0.512,746,1878,0.397,1993,3475,0.574,1089,1341,0.812,528,2241,2769,1922,514,972,1246,7313
8579,2018-3-5,Houston Rockets,62,14930,2417,5231,0.462,963,2639,0.365,1454,2592,0.561,1270,1606,0.791,568,2128,2696,1349,543,824,1228,7067
8580,2018-3-5,New Orleans Pelicans,62,15155,2627,5439,0.483,657,1810,0.363,1970,3629,0.543,1053,1381,0.762,537,2184,2721,1637,486,917,1203,6964
8581,2018-3-5,Toronto Raptors,62,14955,2555,5418,0.472,719,2022,0.356,1836,3396,0.541,1111,1393,0.798,590,2105,2695,1465,506,784,1368,6940
8582,2018-3-5,Cleveland Cavaliers,62,14930,2479,5226,0.474,738,2019,0.366,1741,3207,0.543,1126,1437,0.784,520,2087,2607,1459,436,845,1166,6822
8583,2018-3-5,Minnesota Timberwolves,66,15940,2710,5654,0.479,523,1469,0.356,2187,4185,0.523,1300,1618,0.803,679,2078,2757,1491,567,779,1187,7243
8584,2018-3-5,Los Angeles Clippers,62,14905,2476,5274,0.469,621,1761,0.353,1855,3513,0.528,1193,1572,0.759,611,2100,2711,1386,494,880,1263,6766
8585,2018-3-5,Denver Nuggets,63,15195,2551,5433,0.47,703,1914,0.367,1848,3519,0.525,1041,1367,0.762,702,2074,2776,1558,500,925,1162,6846
8586,2018-3-5,Los Angeles Lakers,62,15055,2557,5535,0.462,602,1747,0.345,1955,3788,0.516,1005,1434,0.701,685,2194,2879,1480,500,963,1335,6721
8587,2018-3-5,Philadelphia 76ers,62,14980,2458,5273,0.466,647,1786,0.362,1811,3487,0.519,1104,1452,0.76,678,2211,2889,1587,503,1027,1391,6667
8588,2018-3-5,Washington Wizards,64,15460,2563,5488,0.467,629,1699,0.37,1934,3789,0.51,1090,1411,0.773,642,2111,2753,1576,510,885,1386,6845
8589,2018-3-5,Oklahoma City Thunder,65,15725,2585,5716,0.452,674,1937,0.348,1911,3779,0.506,1082,1523,0.71,823,2108,2931,1375,580,876,1306,6926
8590,2018-3-5,Indiana Pacers,63,15170,2585,5406,0.478,573,1551,0.369,2012,3855,0.522,972,1256,0.774,587,2083,2670,1403,537,822,1189,6715
8591,2018-3-5,Charlotte Hornets,64,15435,2464,5548,0.444,633,1719,0.368,1831,3829,0.478,1250,1702,0.734,653,2243,2896,1364,448,784,1142,6811
8592,2018-3-5,Orlando Magic,63,15170,2492,5392,0.462,663,1844,0.36,1829,3548,0.516,1018,1340,0.76,552,2051,2603,1486,470,889,1242,6665
8593,2018-3-5,Brooklyn Nets,64,15510,2433,5575,0.436,787,2257,0.349,1646,3318,0.496,1118,1445,0.774,647,2240,2887,1479,394,927,1321,6771
8594,2018-3-5,Portland Trail Blazers,63,15195,2467,5453,0.452,641,1710,0.375,1826,3743,0.488,1053,1314,0.801,622,2213,2835,1201,440,835,1232,6628
8595,2018-3-5,Milwaukee Bucks,63,15220,2446,5148,0.475,545,1546,0.353,1901,3602,0.528,1173,1512,0.776,518,1971,2489,1404,538,829,1368,6610
8596,2018-3-5,Phoenix Suns,65,15625,2506,5668,0.442,598,1787,0.335,1908,3881,0.492,1194,1597,0.748,692,2178,2870,1379,442,966,1468,6804
8597,2018-3-5,Boston Celtics,64,15435,2457,5457,0.45,753,2007,0.375,1704,3450,0.494,1012,1315,0.77,582,2247,2829,1429,454,830,1304,6679
8598,2018-3-5,New York Knicks,64,15485,2577,5559,0.464,503,1427,0.352,2074,4132,0.502,1006,1271,0.792,678,2147,2825,1465,434,936,1301,6663
8599,2018-3-5,Atlanta Hawks,64,15385,2445,5454,0.448,704,1936,0.364,1741,3518,0.495,1048,1321,0.793,597,2028,2625,1509,520,961,1269,6642
8600,2018-3-5,Chicago Bulls,62,15055,2412,5505,0.438,676,1894,0.357,1736,3611,0.481,907,1190,0.762,577,2207,2784,1457,439,810,1183,6407
8601,2018-3-5,Detroit Pistons,63,15170,2452,5468,0.448,661,1789,0.369,1791,3679,0.487,930,1247,0.746,651,2070,2721,1426,479,823,1177,6495
8602,2018-3-5,Utah Jazz,63,15170,2378,5210,0.456,679,1840,0.369,1699,3370,0.504,1044,1318,0.792,551,2114,2665,1346,550,879,1233,6479
8603,2018-3-5,San Antonio Spurs,63,15120,2453,5345,0.459,548,1542,0.355,1905,3803,0.501,996,1285,0.775,644,2152,2796,1444,464,823,1071,6450
8604,2018-3-5,Dallas Mavericks,64,15435,2428,5449,0.446,756,2079,0.364,1672,3370,0.496,928,1208,0.768,501,2096,2597,1445,456,766,1244,6540
8605,2018-3-5,Miami Heat,63,15195,2388,5273,0.453,687,1919,0.358,1701,3354,0.507,925,1230,0.752,578,2123,2701,1381,462,879,1255,6388
8606,2018-3-5,Sacramento Kings,64,15410,2490,5492,0.453,577,1503,0.384,1913,3989,0.48,792,1080,0.733,603,1983,2586,1361,529,866,1265,6349
8607,2018-3-5,Memphis Grizzlies,62,14905,2245,5080,0.442,568,1632,0.348,1677,3448,0.486,1076,1351,0.796,580,1943,2523,1319,462,891,1465,6134
8608,2018-3-6,Golden State Warriors,63,15170,2739,5353,0.512,746,1878,0.397,1993,3475,0.574,1089,1341,0.812,528,2241,2769,1922,514,972,1246,7313
8609,2018-3-6,Houston Rockets,62,14930,2417,5231,0.462,963,2639,0.365,1454,2592,0.561,1270,1606,0.791,568,2128,2696,1349,543,824,1228,7067
8610,2018-3-6,New Orleans Pelicans,62,15155,2627,5439,0.483,657,1810,0.363,1970,3629,0.543,1053,1381,0.762,537,2184,2721,1637,486,917,1203,6964
8611,2018-3-6,Toronto Raptors,62,14955,2555,5418,0.472,719,2022,0.356,1836,3396,0.541,1111,1393,0.798,590,2105,2695,1465,506,784,1368,6940
8612,2018-3-6,Cleveland Cavaliers,63,15170,2522,5314,0.475,750,2052,0.365,1772,3262,0.543,1140,1454,0.784,531,2129,2660,1488,444,859,1184,6934
8613,2018-3-6,Minnesota Timberwolves,66,15940,2710,5654,0.479,523,1469,0.356,2187,4185,0.523,1300,1618,0.803,679,2078,2757,1491,567,779,1187,7243
8614,2018-3-6,Los Angeles Clippers,62,14905,2476,5274,0.469,621,1761,0.353,1855,3513,0.528,1193,1572,0.759,611,2100,2711,1386,494,880,1263,6766
8615,2018-3-6,Denver Nuggets,63,15195,2551,5433,0.47,703,1914,0.367,1848,3519,0.525,1041,1367,0.762,702,2074,2776,1558,500,925,1162,6846
8616,2018-3-6,Los Angeles Lakers,63,15295,2591,5622,0.461,613,1784,0.344,1978,3838,0.515,1029,1465,0.702,692,2234,2926,1500,509,973,1359,6824
8617,2018-3-6,Philadelphia 76ers,62,14980,2458,5273,0.466,647,1786,0.362,1811,3487,0.519,1104,1452,0.76,678,2211,2889,1587,503,1027,1391,6667
8618,2018-3-6,Washington Wizards,64,15460,2563,5488,0.467,629,1699,0.37,1934,3789,0.51,1090,1411,0.773,642,2111,2753,1576,510,885,1386,6845
8619,2018-3-6,Oklahoma City Thunder,65,15725,2585,5716,0.452,674,1937,0.348,1911,3779,0.506,1082,1523,0.71,823,2108,2931,1375,580,876,1306,6926
8620,2018-3-6,Charlotte Hornets,64,15435,2464,5548,0.444,633,1719,0.368,1831,3829,0.478,1250,1702,0.734,653,2243,2896,1364,448,784,1142,6811
8621,2018-3-6,Indiana Pacers,64,15410,2618,5483,0.477,583,1568,0.372,2035,3915,0.52,988,1277,0.774,595,2112,2707,1421,550,836,1204,6807
8622,2018-3-6,Brooklyn Nets,64,15510,2433,5575,0.436,787,2257,0.349,1646,3318,0.496,1118,1445,0.774,647,2240,2887,1479,394,927,1321,6771
8623,2018-3-6,Orlando Magic,64,15410,2521,5477,0.46,674,1878,0.359,1847,3599,0.513,1029,1354,0.76,558,2081,2639,1504,477,903,1261,6745
8624,2018-3-6,Portland Trail Blazers,64,15435,2502,5536,0.452,651,1733,0.376,1851,3803,0.487,1081,1352,0.8,629,2256,2885,1220,446,849,1257,6736
8625,2018-3-6,Milwaukee Bucks,64,15460,2480,5224,0.475,552,1569,0.352,1928,3655,0.527,1187,1528,0.777,526,2002,2528,1419,546,845,1384,6699
8626,2018-3-6,Phoenix Suns,66,15865,2548,5755,0.443,608,1811,0.336,1940,3944,0.492,1203,1615,0.745,704,2206,2910,1400,445,983,1488,6907
8627,2018-3-6,Boston Celtics,65,15675,2498,5541,0.451,765,2043,0.374,1733,3498,0.495,1023,1327,0.771,594,2288,2882,1454,461,848,1317,6784
8628,2018-3-6,New York Knicks,64,15485,2577,5559,0.464,503,1427,0.352,2074,4132,0.502,1006,1271,0.792,678,2147,2825,1465,434,936,1301,6663
8629,2018-3-6,Atlanta Hawks,64,15385,2445,5454,0.448,704,1936,0.364,1741,3518,0.495,1048,1321,0.793,597,2028,2625,1509,520,961,1269,6642
8630,2018-3-6,Chicago Bulls,63,15295,2444,5586,0.438,688,1927,0.357,1756,3659,0.48,920,1210,0.76,584,2236,2820,1475,453,823,1199,6496
8631,2018-3-6,Detroit Pistons,64,15410,2486,5555,0.448,673,1823,0.369,1813,3732,0.486,940,1262,0.745,659,2102,2761,1443,488,834,1199,6585
8632,2018-3-6,Utah Jazz,64,15410,2414,5283,0.457,689,1871,0.368,1725,3412,0.506,1056,1336,0.79,557,2156,2713,1369,558,894,1255,6573
8633,2018-3-6,San Antonio Spurs,64,15360,2488,5421,0.459,554,1564,0.354,1934,3857,0.501,1020,1316,0.775,648,2184,2832,1462,478,834,1081,6550
8634,2018-3-6,Dallas Mavericks,64,15435,2428,5449,0.446,756,2079,0.364,1672,3370,0.496,928,1208,0.768,501,2096,2597,1445,456,766,1244,6540
8635,2018-3-6,Miami Heat,64,15435,2435,5365,0.454,699,1955,0.358,1736,3410,0.509,944,1253,0.753,594,2158,2752,1414,474,889,1269,6513
8636,2018-3-6,Sacramento Kings,64,15410,2490,5492,0.453,577,1503,0.384,1913,3989,0.48,792,1080,0.733,603,1983,2586,1361,529,866,1265,6349
8637,2018-3-6,Memphis Grizzlies,63,15145,2287,5160,0.443,576,1654,0.348,1711,3506,0.488,1082,1360,0.796,586,1979,2565,1345,470,911,1487,6232
8638,2018-3-7,Golden State Warriors,64,15410,2786,5436,0.513,757,1901,0.398,2029,3535,0.574,1098,1352,0.812,533,2277,2810,1952,522,989,1264,7427
8639,2018-3-7,Houston Rockets,63,15170,2455,5303,0.463,980,2672,0.367,1475,2631,0.561,1299,1640,0.792,575,2158,2733,1374,554,844,1248,7189
8640,2018-3-7,New Orleans Pelicans,63,15395,2673,5542,0.482,670,1840,0.364,2003,3702,0.541,1069,1399,0.764,546,2226,2772,1676,497,925,1223,7085
8641,2018-3-7,Toronto Raptors,63,15195,2589,5506,0.47,729,2058,0.354,1860,3448,0.539,1139,1426,0.799,607,2133,2740,1490,518,796,1389,7046
8642,2018-3-7,Cleveland Cavaliers,63,15170,2522,5314,0.475,750,2052,0.365,1772,3262,0.543,1140,1454,0.784,531,2129,2660,1488,444,859,1184,6934
8643,2018-3-7,Minnesota Timberwolves,66,15940,2710,5654,0.479,523,1469,0.356,2187,4185,0.523,1300,1618,0.803,679,2078,2757,1491,567,779,1187,7243
8644,2018-3-7,Los Angeles Clippers,63,15145,2522,5373,0.469,628,1788,0.351,1894,3585,0.528,1210,1598,0.757,621,2147,2768,1411,499,893,1281,6882
8645,2018-3-7,Denver Nuggets,64,15435,2589,5525,0.469,714,1950,0.366,1875,3575,0.524,1061,1393,0.762,713,2112,2825,1581,505,939,1178,6953
8646,2018-3-7,Los Angeles Lakers,63,15295,2591,5622,0.461,613,1784,0.344,1978,3838,0.515,1029,1465,0.702,692,2234,2926,1500,509,973,1359,6824
8647,2018-3-7,Philadelphia 76ers,63,15220,2508,5360,0.468,663,1819,0.364,1845,3541,0.521,1116,1467,0.761,688,2245,2933,1622,509,1041,1411,6795
8648,2018-3-7,Washington Wizards,65,15725,2603,5568,0.467,643,1723,0.373,1960,3845,0.51,1113,1438,0.774,650,2144,2794,1601,517,903,1408,6962
8649,2018-3-7,Oklahoma City Thunder,66,15965,2631,5809,0.453,686,1971,0.348,1945,3838,0.507,1090,1534,0.711,835,2130,2965,1393,592,895,1334,7038
8650,2018-3-7,Charlotte Hornets,65,15675,2504,5628,0.445,644,1748,0.368,1860,3880,0.479,1273,1733,0.735,661,2268,2929,1390,455,794,1154,6925
8651,2018-3-7,Indiana Pacers,64,15410,2618,5483,0.477,583,1568,0.372,2035,3915,0.52,988,1277,0.774,595,2112,2707,1421,550,836,1204,6807
8652,2018-3-7,Brooklyn Nets,65,15750,2469,5660,0.436,796,2291,0.347,1673,3369,0.497,1138,1470,0.774,657,2268,2925,1503,401,939,1339,6872
8653,2018-3-7,Orlando Magic,64,15410,2521,5477,0.46,674,1878,0.359,1847,3599,0.513,1029,1354,0.76,558,2081,2639,1504,477,903,1261,6745
8654,2018-3-7,Portland Trail Blazers,65,15675,2537,5617,0.452,671,1766,0.38,1866,3851,0.485,1102,1376,0.801,644,2292,2936,1242,450,868,1272,6847
8655,2018-3-7,Milwaukee Bucks,64,15460,2480,5224,0.475,552,1569,0.352,1928,3655,0.527,1187,1528,0.777,526,2002,2528,1419,546,845,1384,6699
8656,2018-3-7,Phoenix Suns,66,15865,2548,5755,0.443,608,1811,0.336,1940,3944,0.492,1203,1615,0.745,704,2206,2910,1400,445,983,1488,6907
8657,2018-3-7,Boston Celtics,65,15675,2498,5541,0.451,765,2043,0.374,1733,3498,0.495,1023,1327,0.771,594,2288,2882,1454,461,848,1317,6784
8658,2018-3-7,New York Knicks,65,15725,2612,5642,0.463,510,1446,0.353,2102,4196,0.501,1016,1286,0.79,687,2177,2864,1486,441,950,1320,6750
8659,2018-3-7,Atlanta Hawks,65,15625,2479,5534,0.448,710,1957,0.363,1769,3577,0.495,1064,1342,0.793,609,2060,2669,1531,528,982,1294,6732
8660,2018-3-7,Chicago Bulls,63,15295,2444,5586,0.438,688,1927,0.357,1756,3659,0.48,920,1210,0.76,584,2236,2820,1475,453,823,1199,6496
8661,2018-3-7,Detroit Pistons,64,15410,2486,5555,0.448,673,1823,0.369,1813,3732,0.486,940,1262,0.745,659,2102,2761,1443,488,834,1199,6585
8662,2018-3-7,Utah Jazz,64,15410,2414,5283,0.457,689,1871,0.368,1725,3412,0.506,1056,1336,0.79,557,2156,2713,1369,558,894,1255,6573
8663,2018-3-7,Dallas Mavericks,65,15675,2471,5539,0.446,771,2106,0.366,1700,3433,0.495,945,1231,0.768,510,2138,2648,1469,464,781,1264,6658
8664,2018-3-7,San Antonio Spurs,64,15360,2488,5421,0.459,554,1564,0.354,1934,3857,0.501,1020,1316,0.775,648,2184,2832,1462,478,834,1081,6550
8665,2018-3-7,Miami Heat,65,15700,2477,5459,0.454,708,1988,0.356,1769,3471,0.51,964,1280,0.753,607,2186,2793,1440,485,903,1293,6626
8666,2018-3-7,Sacramento Kings,64,15410,2490,5492,0.453,577,1503,0.384,1913,3989,0.48,792,1080,0.733,603,1983,2586,1361,529,866,1265,6349
8667,2018-3-7,Memphis Grizzlies,63,15145,2287,5160,0.443,576,1654,0.348,1711,3506,0.488,1082,1360,0.796,586,1979,2565,1345,470,911,1487,6232
8668,2018-3-8,Golden State Warriors,64,15410,2786,5436,0.513,757,1901,0.398,2029,3535,0.574,1098,1352,0.812,533,2277,2810,1952,522,989,1264,7427
8669,2018-3-8,Houston Rockets,64,15410,2494,5385,0.463,994,2712,0.367,1500,2673,0.561,1317,1667,0.79,587,2193,2780,1396,563,860,1269,7299
8670,2018-3-8,New Orleans Pelicans,64,15635,2720,5625,0.484,681,1866,0.365,2039,3759,0.542,1078,1408,0.766,551,2261,2812,1702,503,941,1245,7199
8671,2018-3-8,Toronto Raptors,64,15460,2634,5607,0.47,741,2098,0.353,1893,3509,0.539,1158,1447,0.8,618,2169,2787,1523,527,805,1409,7167
8672,2018-3-8,Cleveland Cavaliers,64,15410,2566,5401,0.475,763,2081,0.367,1803,3320,0.543,1152,1472,0.783,538,2157,2695,1513,454,869,1203,7047
8673,2018-3-8,Minnesota Timberwolves,66,15940,2710,5654,0.479,523,1469,0.356,2187,4185,0.523,1300,1618,0.803,679,2078,2757,1491,567,779,1187,7243
8674,2018-3-8,Los Angeles Clippers,63,15145,2522,5373,0.469,628,1788,0.351,1894,3585,0.528,1210,1598,0.757,621,2147,2768,1411,499,893,1281,6882
8675,2018-3-8,Denver Nuggets,65,15675,2631,5611,0.469,724,1977,0.366,1907,3634,0.525,1075,1411,0.762,727,2149,2876,1603,512,960,1194,7061
8676,2018-3-8,Los Angeles Lakers,64,15535,2634,5710,0.461,624,1817,0.343,2010,3893,0.516,1040,1477,0.704,699,2266,2965,1527,516,987,1375,6932
8677,2018-3-8,Philadelphia 76ers,63,15220,2508,5360,0.468,663,1819,0.364,1845,3541,0.521,1116,1467,0.761,688,2245,2933,1622,509,1041,1411,6795
8678,2018-3-8,Washington Wizards,65,15725,2603,5568,0.467,643,1723,0.373,1960,3845,0.51,1113,1438,0.774,650,2144,2794,1601,517,903,1408,6962
8679,2018-3-8,Oklahoma City Thunder,66,15965,2631,5809,0.453,686,1971,0.348,1945,3838,0.507,1090,1534,0.711,835,2130,2965,1393,592,895,1334,7038
8680,2018-3-8,Charlotte Hornets,65,15675,2504,5628,0.445,644,1748,0.368,1860,3880,0.479,1273,1733,0.735,661,2268,2929,1390,455,794,1154,6925
8681,2018-3-8,Indiana Pacers,65,15650,2652,5571,0.476,586,1591,0.368,2066,3980,0.519,1001,1294,0.774,609,2143,2752,1433,559,848,1221,6891
8682,2018-3-8,Brooklyn Nets,65,15750,2469,5660,0.436,796,2291,0.347,1673,3369,0.497,1138,1470,0.774,657,2268,2925,1503,401,939,1339,6872
8683,2018-3-8,Orlando Magic,65,15650,2563,5561,0.461,686,1906,0.36,1877,3655,0.514,1040,1373,0.757,566,2116,2682,1535,482,919,1283,6852
8684,2018-3-8,Portland Trail Blazers,65,15675,2537,5617,0.452,671,1766,0.38,1866,3851,0.485,1102,1376,0.801,644,2292,2936,1242,450,868,1272,6847
8685,2018-3-8,Phoenix Suns,66,15865,2548,5755,0.443,608,1811,0.336,1940,3944,0.492,1203,1615,0.745,704,2206,2910,1400,445,983,1488,6907
8686,2018-3-8,Milwaukee Bucks,65,15700,2518,5307,0.474,561,1597,0.351,1957,3710,0.527,1201,1547,0.776,532,2034,2566,1440,555,858,1406,6798
8687,2018-3-8,Boston Celtics,65,15675,2498,5541,0.451,765,2043,0.374,1733,3498,0.495,1023,1327,0.771,594,2288,2882,1454,461,848,1317,6784
8688,2018-3-8,New York Knicks,65,15725,2612,5642,0.463,510,1446,0.353,2102,4196,0.501,1016,1286,0.79,687,2177,2864,1486,441,950,1320,6750
8689,2018-3-8,Atlanta Hawks,65,15625,2479,5534,0.448,710,1957,0.363,1769,3577,0.495,1064,1342,0.793,609,2060,2669,1531,528,982,1294,6732
8690,2018-3-8,Chicago Bulls,64,15535,2486,5665,0.439,699,1956,0.357,1787,3709,0.482,944,1242,0.76,593,2268,2861,1500,463,843,1221,6615
8691,2018-3-8,Detroit Pistons,65,15675,2530,5645,0.448,686,1849,0.371,1844,3796,0.486,958,1285,0.746,668,2144,2812,1470,490,850,1222,6704
8692,2018-3-8,Utah Jazz,65,15650,2455,5363,0.458,700,1902,0.368,1755,3461,0.507,1067,1352,0.789,564,2191,2755,1399,567,906,1273,6677
8693,2018-3-8,Dallas Mavericks,65,15675,2471,5539,0.446,771,2106,0.366,1700,3433,0.495,945,1231,0.768,510,2138,2648,1469,464,781,1264,6658
8694,2018-3-8,San Antonio Spurs,64,15360,2488,5421,0.459,554,1564,0.354,1934,3857,0.501,1020,1316,0.775,648,2184,2832,1462,478,834,1081,6550
8695,2018-3-8,Miami Heat,65,15700,2477,5459,0.454,708,1988,0.356,1769,3471,0.51,964,1280,0.753,607,2186,2793,1440,485,903,1293,6626
8696,2018-3-8,Sacramento Kings,65,15650,2529,5585,0.453,586,1531,0.383,1943,4054,0.479,806,1097,0.735,617,2008,2625,1381,533,875,1281,6450
8697,2018-3-8,Memphis Grizzlies,64,15385,2327,5242,0.444,586,1683,0.348,1741,3559,0.489,1102,1385,0.796,595,2003,2598,1369,482,925,1513,6342
8698,2018-3-9,Golden State Warriors,65,15650,2827,5531,0.511,765,1931,0.396,2062,3600,0.573,1118,1375,0.813,545,2314,2859,1982,528,999,1282,7537
8699,2018-3-9,Houston Rockets,64,15410,2494,5385,0.463,994,2712,0.367,1500,2673,0.561,1317,1667,0.79,587,2193,2780,1396,563,860,1269,7299
8700,2018-3-9,New Orleans Pelicans,64,15635,2720,5625,0.484,681,1866,0.365,2039,3759,0.542,1078,1408,0.766,551,2261,2812,1702,503,941,1245,7199
8701,2018-3-9,Toronto Raptors,64,15460,2634,5607,0.47,741,2098,0.353,1893,3509,0.539,1158,1447,0.8,618,2169,2787,1523,527,805,1409,7167
8702,2018-3-9,Cleveland Cavaliers,64,15410,2566,5401,0.475,763,2081,0.367,1803,3320,0.543,1152,1472,0.783,538,2157,2695,1513,454,869,1203,7047
8703,2018-3-9,Minnesota Timberwolves,67,16180,2754,5748,0.479,535,1500,0.357,2219,4248,0.522,1309,1631,0.803,692,2112,2804,1515,570,791,1209,7352
8704,2018-3-9,Los Angeles Clippers,63,15145,2522,5373,0.469,628,1788,0.351,1894,3585,0.528,1210,1598,0.757,621,2147,2768,1411,499,893,1281,6882
8705,2018-3-9,Denver Nuggets,65,15675,2631,5611,0.469,724,1977,0.366,1907,3634,0.525,1075,1411,0.762,727,2149,2876,1603,512,960,1194,7061
8706,2018-3-9,Los Angeles Lakers,64,15535,2634,5710,0.461,624,1817,0.343,2010,3893,0.516,1040,1477,0.704,699,2266,2965,1527,516,987,1375,6932
8707,2018-3-9,Philadelphia 76ers,64,15460,2542,5446,0.467,678,1856,0.365,1864,3590,0.519,1132,1488,0.761,697,2282,2979,1650,518,1059,1431,6894
8708,2018-3-9,Washington Wizards,65,15725,2603,5568,0.467,643,1723,0.373,1960,3845,0.51,1113,1438,0.774,650,2144,2794,1601,517,903,1408,6962
8709,2018-3-9,Oklahoma City Thunder,67,16205,2673,5889,0.454,699,2004,0.349,1974,3885,0.508,1108,1561,0.71,841,2173,3014,1414,598,913,1354,7153
8710,2018-3-9,Charlotte Hornets,66,15915,2545,5713,0.445,648,1767,0.367,1897,3946,0.481,1298,1763,0.736,667,2298,2965,1409,460,807,1175,7036
8711,2018-3-9,Brooklyn Nets,66,15990,2516,5752,0.437,807,2323,0.347,1709,3429,0.498,1158,1492,0.776,666,2302,2968,1533,408,949,1366,6997
8712,2018-3-9,Indiana Pacers,65,15650,2652,5571,0.476,586,1591,0.368,2066,3980,0.519,1001,1294,0.774,609,2143,2752,1433,559,848,1221,6891
8713,2018-3-9,Orlando Magic,65,15650,2563,5561,0.461,686,1906,0.36,1877,3655,0.514,1040,1373,0.757,566,2116,2682,1535,482,919,1283,6852
8714,2018-3-9,Portland Trail Blazers,65,15675,2537,5617,0.452,671,1766,0.38,1866,3851,0.485,1102,1376,0.801,644,2292,2936,1242,450,868,1272,6847
8715,2018-3-9,Milwaukee Bucks,65,15700,2518,5307,0.474,561,1597,0.351,1957,3710,0.527,1201,1547,0.776,532,2034,2566,1440,555,858,1406,6798
8716,2018-3-9,Boston Celtics,66,15915,2541,5628,0.451,776,2075,0.374,1765,3553,0.497,1043,1354,0.77,603,2325,2928,1482,468,859,1334,6901
8717,2018-3-9,Phoenix Suns,67,16105,2579,5847,0.441,617,1848,0.334,1962,3999,0.491,1219,1633,0.746,711,2242,2953,1415,454,996,1513,6994
8718,2018-3-9,New York Knicks,65,15725,2612,5642,0.463,510,1446,0.353,2102,4196,0.501,1016,1286,0.79,687,2177,2864,1486,441,950,1320,6750
8719,2018-3-9,Atlanta Hawks,65,15625,2479,5534,0.448,710,1957,0.363,1769,3577,0.495,1064,1342,0.793,609,2060,2669,1531,528,982,1294,6732
8720,2018-3-9,Chicago Bulls,64,15535,2486,5665,0.439,699,1956,0.357,1787,3709,0.482,944,1242,0.76,593,2268,2861,1500,463,843,1221,6615
8721,2018-3-9,Detroit Pistons,65,15675,2530,5645,0.448,686,1849,0.371,1844,3796,0.486,958,1285,0.746,668,2144,2812,1470,490,850,1222,6704
8722,2018-3-9,Utah Jazz,65,15650,2455,5363,0.458,700,1902,0.368,1755,3461,0.507,1067,1352,0.789,564,2191,2755,1399,567,906,1273,6677
8723,2018-3-9,San Antonio Spurs,65,15600,2531,5516,0.459,560,1586,0.353,1971,3930,0.502,1035,1334,0.776,658,2219,2877,1491,485,846,1101,6657
8724,2018-3-9,Dallas Mavericks,65,15675,2471,5539,0.446,771,2106,0.366,1700,3433,0.495,945,1231,0.768,510,2138,2648,1469,464,781,1264,6658
8725,2018-3-9,Miami Heat,66,15940,2519,5548,0.454,722,2014,0.358,1797,3534,0.508,974,1298,0.75,613,2229,2842,1466,495,917,1313,6734
8726,2018-3-9,Sacramento Kings,65,15650,2529,5585,0.453,586,1531,0.383,1943,4054,0.479,806,1097,0.735,617,2008,2625,1381,533,875,1281,6450
8727,2018-3-9,Memphis Grizzlies,64,15385,2327,5242,0.444,586,1683,0.348,1741,3559,0.489,1102,1385,0.796,595,2003,2598,1369,482,925,1513,6342
8728,2018-3-10,Golden State Warriors,66,15890,2865,5609,0.511,777,1959,0.397,2088,3650,0.572,1138,1399,0.813,551,2341,2892,2002,533,1009,1302,7645
8729,2018-3-10,Houston Rockets,65,15650,2534,5466,0.464,1003,2739,0.366,1531,2727,0.561,1333,1690,0.789,594,2222,2816,1411,572,873,1282,7404
8730,2018-3-10,New Orleans Pelicans,65,15875,2758,5707,0.483,687,1886,0.364,2071,3821,0.542,1093,1426,0.766,553,2297,2850,1725,506,956,1263,7296
8731,2018-3-10,Toronto Raptors,65,15700,2675,5692,0.47,756,2136,0.354,1919,3556,0.54,1169,1461,0.8,630,2199,2829,1545,534,821,1429,7275
8732,2018-3-10,Cleveland Cavaliers,65,15650,2605,5488,0.475,775,2117,0.366,1830,3371,0.543,1164,1490,0.781,546,2189,2735,1535,464,881,1231,7149
8733,2018-3-10,Minnesota Timberwolves,67,16180,2754,5748,0.479,535,1500,0.357,2219,4248,0.522,1309,1631,0.803,692,2112,2804,1515,570,791,1209,7352
8734,2018-3-10,Los Angeles Clippers,64,15385,2565,5462,0.47,639,1816,0.352,1926,3646,0.528,1229,1628,0.755,634,2186,2820,1436,505,906,1297,6998
8735,2018-3-10,Denver Nuggets,66,15915,2673,5694,0.469,739,2008,0.368,1934,3686,0.525,1101,1441,0.764,734,2178,2912,1633,522,972,1210,7186
8736,2018-3-10,Los Angeles Lakers,65,15775,2679,5802,0.462,638,1852,0.344,2041,3950,0.517,1052,1493,0.705,711,2298,3009,1552,524,1002,1398,7048
8737,2018-3-10,Philadelphia 76ers,64,15460,2542,5446,0.467,678,1856,0.365,1864,3590,0.519,1132,1488,0.761,697,2282,2979,1650,518,1059,1431,6894
8738,2018-3-10,Washington Wizards,66,15965,2649,5664,0.468,652,1749,0.373,1997,3915,0.51,1128,1458,0.774,660,2183,2843,1635,527,915,1424,7078
8739,2018-3-10,Oklahoma City Thunder,67,16205,2673,5889,0.454,699,2004,0.349,1974,3885,0.508,1108,1561,0.71,841,2173,3014,1414,598,913,1354,7153
8740,2018-3-10,Charlotte Hornets,66,15915,2545,5713,0.445,648,1767,0.367,1897,3946,0.481,1298,1763,0.736,667,2298,2965,1409,460,807,1175,7036
8741,2018-3-10,Indiana Pacers,66,15890,2697,5662,0.476,600,1619,0.371,2097,4043,0.519,1009,1304,0.774,618,2183,2801,1454,570,864,1237,7003
8742,2018-3-10,Brooklyn Nets,66,15990,2516,5752,0.437,807,2323,0.347,1709,3429,0.498,1158,1492,0.776,666,2302,2968,1533,408,949,1366,6997
8743,2018-3-10,Portland Trail Blazers,66,15915,2581,5706,0.452,687,1805,0.381,1894,3901,0.486,1123,1403,0.8,658,2324,2982,1263,454,879,1289,6972
8744,2018-3-10,Orlando Magic,66,15890,2596,5639,0.46,695,1935,0.359,1901,3704,0.513,1053,1389,0.758,571,2145,2716,1552,489,933,1300,6940
8745,2018-3-10,Milwaukee Bucks,66,15940,2559,5380,0.476,569,1615,0.352,1990,3765,0.529,1231,1586,0.776,538,2070,2608,1469,563,872,1422,6918
8746,2018-3-10,Boston Celtics,66,15915,2541,5628,0.451,776,2075,0.374,1765,3553,0.497,1043,1354,0.77,603,2325,2928,1482,468,859,1334,6901
8747,2018-3-10,Phoenix Suns,67,16105,2579,5847,0.441,617,1848,0.334,1962,3999,0.491,1219,1633,0.746,711,2242,2953,1415,454,996,1513,6994
8748,2018-3-10,New York Knicks,66,15965,2659,5740,0.463,517,1474,0.351,2142,4266,0.502,1027,1300,0.79,698,2205,2903,1510,447,961,1346,6862
8749,2018-3-10,Atlanta Hawks,66,15865,2513,5616,0.447,720,1990,0.362,1793,3626,0.494,1073,1352,0.794,615,2089,2704,1552,539,1000,1307,6819
8750,2018-3-10,Detroit Pistons,66,15915,2568,5726,0.448,695,1876,0.37,1873,3850,0.486,972,1303,0.746,679,2183,2862,1492,498,866,1235,6803
8751,2018-3-10,Chicago Bulls,65,15775,2519,5758,0.437,708,1987,0.356,1811,3771,0.48,952,1252,0.76,603,2300,2903,1519,474,856,1240,6698
8752,2018-3-10,Utah Jazz,66,15890,2488,5437,0.458,713,1934,0.369,1775,3503,0.507,1083,1374,0.788,572,2231,2803,1425,577,923,1290,6772
8753,2018-3-10,San Antonio Spurs,65,15600,2531,5516,0.459,560,1586,0.353,1971,3930,0.502,1035,1334,0.776,658,2219,2877,1491,485,846,1101,6657
8754,2018-3-10,Dallas Mavericks,65,15675,2471,5539,0.446,771,2106,0.366,1700,3433,0.495,945,1231,0.768,510,2138,2648,1469,464,781,1264,6658
8755,2018-3-10,Miami Heat,66,15940,2519,5548,0.454,722,2014,0.358,1797,3534,0.508,974,1298,0.75,613,2229,2842,1466,495,917,1313,6734
8756,2018-3-10,Sacramento Kings,66,15890,2565,5668,0.453,595,1556,0.382,1970,4112,0.479,819,1112,0.737,630,2045,2675,1405,540,891,1302,6544
8757,2018-3-10,Memphis Grizzlies,65,15625,2358,5325,0.443,592,1705,0.347,1766,3620,0.488,1112,1399,0.795,605,2032,2637,1385,486,940,1535,6420
8758,2018-3-11,Golden State Warriors,66,15890,2865,5609,0.511,777,1959,0.397,2088,3650,0.572,1138,1399,0.813,551,2341,2892,2002,533,1009,1302,7645
8759,2018-3-11,Houston Rockets,65,15650,2534,5466,0.464,1003,2739,0.366,1531,2727,0.561,1333,1690,0.789,594,2222,2816,1411,572,873,1282,7404
8760,2018-3-11,New Orleans Pelicans,65,15875,2758,5707,0.483,687,1886,0.364,2071,3821,0.542,1093,1426,0.766,553,2297,2850,1725,506,956,1263,7296
8761,2018-3-11,Toronto Raptors,65,15700,2675,5692,0.47,756,2136,0.354,1919,3556,0.54,1169,1461,0.8,630,2199,2829,1545,534,821,1429,7275
8762,2018-3-11,Cleveland Cavaliers,65,15650,2605,5488,0.475,775,2117,0.366,1830,3371,0.543,1164,1490,0.781,546,2189,2735,1535,464,881,1231,7149
8763,2018-3-11,Minnesota Timberwolves,67,16180,2754,5748,0.479,535,1500,0.357,2219,4248,0.522,1309,1631,0.803,692,2112,2804,1515,570,791,1209,7352
8764,2018-3-11,Los Angeles Clippers,65,15625,2606,5540,0.47,646,1834,0.352,1960,3706,0.529,1253,1656,0.757,642,2219,2861,1453,514,921,1317,7111
8765,2018-3-11,Denver Nuggets,66,15915,2673,5694,0.469,739,2008,0.368,1934,3686,0.525,1101,1441,0.764,734,2178,2912,1633,522,972,1210,7186
8766,2018-3-11,Los Angeles Lakers,65,15775,2679,5802,0.462,638,1852,0.344,2041,3950,0.517,1052,1493,0.705,711,2298,3009,1552,524,1002,1398,7048
8767,2018-3-11,Philadelphia 76ers,64,15460,2542,5446,0.467,678,1856,0.365,1864,3590,0.519,1132,1488,0.761,697,2282,2979,1650,518,1059,1431,6894
8768,2018-3-11,Washington Wizards,67,16205,2683,5741,0.467,659,1769,0.373,2024,3972,0.51,1155,1492,0.774,668,2215,2883,1657,531,930,1444,7180
8769,2018-3-11,Charlotte Hornets,67,16155,2589,5800,0.446,661,1799,0.367,1928,4001,0.482,1319,1790,0.737,674,2332,3006,1433,471,819,1193,7158
8770,2018-3-11,Oklahoma City Thunder,68,16445,2712,5974,0.454,709,2032,0.349,2003,3942,0.508,1124,1585,0.709,852,2211,3063,1438,606,928,1367,7257
8771,2018-3-11,Indiana Pacers,66,15890,2697,5662,0.476,600,1619,0.371,2097,4043,0.519,1009,1304,0.774,618,2183,2801,1454,570,864,1237,7003
8772,2018-3-11,Brooklyn Nets,66,15990,2516,5752,0.437,807,2323,0.347,1709,3429,0.498,1158,1492,0.776,666,2302,2968,1533,408,949,1366,6997
8773,2018-3-11,Portland Trail Blazers,66,15915,2581,5706,0.452,687,1805,0.381,1894,3901,0.486,1123,1403,0.8,658,2324,2982,1263,454,879,1289,6972
8774,2018-3-11,Orlando Magic,67,16130,2634,5723,0.46,703,1959,0.359,1931,3764,0.513,1074,1416,0.758,580,2169,2749,1572,501,947,1319,7045
8775,2018-3-11,Milwaukee Bucks,66,15940,2559,5380,0.476,569,1615,0.352,1990,3765,0.529,1231,1586,0.776,538,2070,2608,1469,563,872,1422,6918
8776,2018-3-11,Boston Celtics,66,15915,2541,5628,0.451,776,2075,0.374,1765,3553,0.497,1043,1354,0.77,603,2325,2928,1482,468,859,1334,6901
8777,2018-3-11,Phoenix Suns,68,16345,2621,5930,0.442,635,1880,0.338,1986,4050,0.49,1232,1652,0.746,716,2272,2988,1442,463,1010,1538,7109
8778,2018-3-11,New York Knicks,66,15965,2659,5740,0.463,517,1474,0.351,2142,4266,0.502,1027,1300,0.79,698,2205,2903,1510,447,961,1346,6862
8779,2018-3-11,Atlanta Hawks,66,15865,2513,5616,0.447,720,1990,0.362,1793,3626,0.494,1073,1352,0.794,615,2089,2704,1552,539,1000,1307,6819
8780,2018-3-11,Detroit Pistons,66,15915,2568,5726,0.448,695,1876,0.37,1873,3850,0.486,972,1303,0.746,679,2183,2862,1492,498,866,1235,6803
8781,2018-3-11,Chicago Bulls,65,15775,2519,5758,0.437,708,1987,0.356,1811,3771,0.48,952,1252,0.76,603,2300,2903,1519,474,856,1240,6698
8782,2018-3-11,Utah Jazz,66,15890,2488,5437,0.458,713,1934,0.369,1775,3503,0.507,1083,1374,0.788,572,2231,2803,1425,577,923,1290,6772
8783,2018-3-11,Dallas Mavericks,66,15915,2508,5616,0.447,781,2135,0.366,1727,3481,0.496,975,1266,0.77,519,2181,2700,1490,472,791,1282,6772
8784,2018-3-11,Miami Heat,67,16180,2571,5636,0.456,732,2042,0.358,1839,3594,0.512,989,1319,0.75,618,2266,2884,1493,504,927,1338,6863
8785,2018-3-11,San Antonio Spurs,66,15840,2571,5602,0.459,570,1606,0.355,2001,3996,0.501,1039,1341,0.775,664,2256,2920,1517,491,860,1123,6751
8786,2018-3-11,Sacramento Kings,66,15890,2565,5668,0.453,595,1556,0.382,1970,4112,0.479,819,1112,0.737,630,2045,2675,1405,540,891,1302,6544
8787,2018-3-11,Memphis Grizzlies,66,15865,2388,5409,0.441,599,1723,0.348,1789,3686,0.485,1125,1416,0.794,614,2064,2678,1404,490,954,1559,6500
8788,2018-3-12,Golden State Warriors,67,16130,2902,5700,0.509,787,1995,0.394,2115,3705,0.571,1157,1420,0.815,563,2379,2942,2024,539,1022,1319,7748
8789,2018-3-12,Houston Rockets,66,15890,2573,5550,0.464,1020,2784,0.366,1553,2766,0.561,1343,1704,0.788,600,2261,2861,1432,577,884,1304,7509
8790,2018-3-12,Toronto Raptors,66,15940,2722,5785,0.471,772,2171,0.356,1950,3614,0.54,1191,1486,0.801,644,2237,2881,1577,537,832,1448,7407
8791,2018-3-12,New Orleans Pelicans,66,16115,2799,5800,0.483,693,1907,0.363,2106,3893,0.541,1104,1439,0.767,563,2325,2888,1753,513,969,1288,7395
8792,2018-3-12,Cleveland Cavaliers,66,15890,2646,5576,0.475,787,2148,0.366,1859,3428,0.542,1183,1513,0.782,553,2219,2772,1557,468,893,1249,7262
8793,2018-3-12,Minnesota Timberwolves,68,16420,2798,5843,0.479,541,1520,0.356,2257,4323,0.522,1324,1652,0.801,705,2149,2854,1542,577,800,1224,7461
8794,2018-3-12,Los Angeles Clippers,65,15625,2606,5540,0.47,646,1834,0.352,1960,3706,0.529,1253,1656,0.757,642,2219,2861,1453,514,921,1317,7111
8795,2018-3-12,Denver Nuggets,67,16155,2723,5783,0.471,754,2045,0.369,1969,3738,0.527,1116,1462,0.763,742,2221,2963,1671,524,979,1227,7316
8796,2018-3-12,Los Angeles Lakers,66,16015,2727,5898,0.462,651,1886,0.345,2076,4012,0.517,1070,1513,0.707,725,2335,3060,1582,533,1015,1417,7175
8797,2018-3-12,Philadelphia 76ers,65,15700,2592,5541,0.468,687,1882,0.365,1905,3659,0.521,1143,1506,0.759,709,2318,3027,1683,530,1068,1450,7014
8798,2018-3-12,Washington Wizards,67,16205,2683,5741,0.467,659,1769,0.373,2024,3972,0.51,1155,1492,0.774,668,2215,2883,1657,531,930,1444,7180
8799,2018-3-12,Charlotte Hornets,67,16155,2589,5800,0.446,661,1799,0.367,1928,4001,0.482,1319,1790,0.737,674,2332,3006,1433,471,819,1193,7158
8800,2018-3-12,Oklahoma City Thunder,68,16445,2712,5974,0.454,709,2032,0.349,2003,3942,0.508,1124,1585,0.709,852,2211,3063,1438,606,928,1367,7257
8801,2018-3-12,Indiana Pacers,67,16130,2736,5743,0.476,612,1641,0.373,2124,4102,0.518,1018,1314,0.775,624,2216,2840,1480,579,882,1257,7102
8802,2018-3-12,Brooklyn Nets,67,16230,2549,5837,0.437,817,2351,0.348,1732,3486,0.497,1179,1516,0.778,679,2331,3010,1550,413,967,1385,7094
8803,2018-3-12,Portland Trail Blazers,66,15915,2581,5706,0.452,687,1805,0.381,1894,3901,0.486,1123,1403,0.8,658,2324,2982,1263,454,879,1289,6972
8804,2018-3-12,Orlando Magic,67,16130,2634,5723,0.46,703,1959,0.359,1931,3764,0.513,1074,1416,0.758,580,2169,2749,1572,501,947,1319,7045
8805,2018-3-12,Milwaukee Bucks,66,15940,2559,5380,0.476,569,1615,0.352,1990,3765,0.529,1231,1586,0.776,538,2070,2608,1469,563,872,1422,6918
8806,2018-3-12,Phoenix Suns,68,16345,2621,5930,0.442,635,1880,0.338,1986,4050,0.49,1232,1652,0.746,716,2272,2988,1442,463,1010,1538,7109
8807,2018-3-12,Boston Celtics,67,16155,2575,5709,0.451,788,2112,0.373,1787,3597,0.497,1060,1375,0.771,613,2357,2970,1508,478,875,1347,6998
8808,2018-3-12,New York Knicks,67,16205,2699,5828,0.463,524,1495,0.351,2175,4333,0.502,1046,1324,0.79,706,2234,2940,1531,454,971,1365,6968
8809,2018-3-12,Atlanta Hawks,67,16105,2555,5698,0.448,739,2030,0.364,1816,3668,0.495,1092,1374,0.795,620,2126,2746,1584,541,1015,1321,6941
8810,2018-3-12,Chicago Bulls,66,16015,2567,5856,0.438,725,2024,0.358,1842,3832,0.481,968,1271,0.762,616,2334,2950,1550,484,861,1264,6827
8811,2018-3-12,Detroit Pistons,66,15915,2568,5726,0.448,695,1876,0.37,1873,3850,0.486,972,1303,0.746,679,2183,2862,1492,498,866,1235,6803
8812,2018-3-12,Utah Jazz,67,16130,2528,5533,0.457,725,1966,0.369,1803,3567,0.505,1107,1399,0.791,589,2269,2858,1449,581,938,1310,6888
8813,2018-3-12,Miami Heat,67,16180,2571,5636,0.456,732,2042,0.358,1839,3594,0.512,989,1319,0.75,618,2266,2884,1493,504,927,1338,6863
8814,2018-3-12,San Antonio Spurs,66,15840,2571,5602,0.459,570,1606,0.355,2001,3996,0.501,1039,1341,0.775,664,2256,2920,1517,491,860,1123,6751
8815,2018-3-12,Dallas Mavericks,67,16155,2541,5710,0.445,786,2166,0.363,1755,3544,0.495,986,1284,0.768,536,2217,2753,1517,477,801,1300,6854
8816,2018-3-12,Sacramento Kings,67,16130,2604,5759,0.452,601,1587,0.379,2003,4172,0.48,839,1138,0.737,637,2076,2713,1431,543,894,1323,6648
8817,2018-3-12,Memphis Grizzlies,66,15865,2388,5409,0.441,599,1723,0.348,1789,3686,0.485,1125,1416,0.794,614,2064,2678,1404,490,954,1559,6500
8818,2018-3-13,Golden State Warriors,67,16130,2902,5700,0.509,787,1995,0.394,2115,3705,0.571,1157,1420,0.815,563,2379,2942,2024,539,1022,1319,7748
8819,2018-3-13,Houston Rockets,67,16130,2612,5630,0.464,1033,2828,0.365,1579,2802,0.564,1361,1727,0.788,609,2302,2911,1456,583,899,1328,7618
8820,2018-3-13,Toronto Raptors,66,15940,2722,5785,0.471,772,2171,0.356,1950,3614,0.54,1191,1486,0.801,644,2237,2881,1577,537,832,1448,7407
8821,2018-3-13,New Orleans Pelicans,66,16115,2799,5800,0.483,693,1907,0.363,2106,3893,0.541,1104,1439,0.767,563,2325,2888,1753,513,969,1288,7395
8822,2018-3-13,Cleveland Cavaliers,66,15890,2646,5576,0.475,787,2148,0.366,1859,3428,0.542,1183,1513,0.782,553,2219,2772,1557,468,893,1249,7262
8823,2018-3-13,Minnesota Timberwolves,68,16420,2798,5843,0.479,541,1520,0.356,2257,4323,0.522,1324,1652,0.801,705,2149,2854,1542,577,800,1224,7461
8824,2018-3-13,Los Angeles Clippers,65,15625,2606,5540,0.47,646,1834,0.352,1960,3706,0.529,1253,1656,0.757,642,2219,2861,1453,514,921,1317,7111
8825,2018-3-13,Denver Nuggets,67,16155,2723,5783,0.471,754,2045,0.369,1969,3738,0.527,1116,1462,0.763,742,2221,2963,1671,524,979,1227,7316
8826,2018-3-13,Los Angeles Lakers,66,16015,2727,5898,0.462,651,1886,0.345,2076,4012,0.517,1070,1513,0.707,725,2335,3060,1582,533,1015,1417,7175
8827,2018-3-13,Philadelphia 76ers,65,15700,2592,5541,0.468,687,1882,0.365,1905,3659,0.521,1143,1506,0.759,709,2318,3027,1683,530,1068,1450,7014
8828,2018-3-13,Washington Wizards,67,16205,2683,5741,0.467,659,1769,0.373,2024,3972,0.51,1155,1492,0.774,668,2215,2883,1657,531,930,1444,7180
8829,2018-3-13,Charlotte Hornets,67,16155,2589,5800,0.446,661,1799,0.367,1928,4001,0.482,1319,1790,0.737,674,2332,3006,1433,471,819,1193,7158
8830,2018-3-13,Oklahoma City Thunder,69,16685,2750,6058,0.454,725,2068,0.351,2025,3990,0.508,1138,1603,0.71,857,2249,3106,1459,611,938,1382,7363
8831,2018-3-13,Indiana Pacers,67,16130,2736,5743,0.476,612,1641,0.373,2124,4102,0.518,1018,1314,0.775,624,2216,2840,1480,579,882,1257,7102
8832,2018-3-13,Brooklyn Nets,67,16230,2549,5837,0.437,817,2351,0.348,1732,3486,0.497,1179,1516,0.778,679,2331,3010,1550,413,967,1385,7094
8833,2018-3-13,Portland Trail Blazers,67,16155,2619,5789,0.452,701,1841,0.381,1918,3948,0.486,1148,1433,0.801,667,2365,3032,1286,459,891,1304,7087
8834,2018-3-13,Milwaukee Bucks,67,16180,2606,5461,0.477,581,1640,0.354,2025,3821,0.53,1246,1608,0.775,549,2106,2655,1502,569,890,1444,7039
8835,2018-3-13,Orlando Magic,67,16130,2634,5723,0.46,703,1959,0.359,1931,3764,0.513,1074,1416,0.758,580,2169,2749,1572,501,947,1319,7045
8836,2018-3-13,Phoenix Suns,68,16345,2621,5930,0.442,635,1880,0.338,1986,4050,0.49,1232,1652,0.746,716,2272,2988,1442,463,1010,1538,7109
8837,2018-3-13,Boston Celtics,67,16155,2575,5709,0.451,788,2112,0.373,1787,3597,0.497,1060,1375,0.771,613,2357,2970,1508,478,875,1347,6998
8838,2018-3-13,New York Knicks,67,16205,2699,5828,0.463,524,1495,0.351,2175,4333,0.502,1046,1324,0.79,706,2234,2940,1531,454,971,1365,6968
8839,2018-3-13,Atlanta Hawks,67,16105,2555,5698,0.448,739,2030,0.364,1816,3668,0.495,1092,1374,0.795,620,2126,2746,1584,541,1015,1321,6941
8840,2018-3-13,Chicago Bulls,66,16015,2567,5856,0.438,725,2024,0.358,1842,3832,0.481,968,1271,0.762,616,2334,2950,1550,484,861,1264,6827
8841,2018-3-13,Detroit Pistons,66,15915,2568,5726,0.448,695,1876,0.37,1873,3850,0.486,972,1303,0.746,679,2183,2862,1492,498,866,1235,6803
8842,2018-3-13,Utah Jazz,67,16130,2528,5533,0.457,725,1966,0.369,1803,3567,0.505,1107,1399,0.791,589,2269,2858,1449,581,938,1310,6888
8843,2018-3-13,Miami Heat,68,16420,2610,5727,0.456,742,2073,0.358,1868,3654,0.511,1000,1335,0.749,628,2302,2930,1517,510,938,1362,6962
8844,2018-3-13,Dallas Mavericks,67,16155,2541,5710,0.445,786,2166,0.363,1755,3544,0.495,986,1284,0.768,536,2217,2753,1517,477,801,1300,6854
8845,2018-3-13,San Antonio Spurs,67,16080,2604,5683,0.458,581,1634,0.356,2023,4049,0.5,1055,1364,0.773,671,2285,2956,1537,496,873,1140,6844
8846,2018-3-13,Sacramento Kings,68,16370,2642,5852,0.451,613,1620,0.378,2029,4232,0.479,852,1154,0.738,650,2112,2762,1452,551,905,1345,6749
8847,2018-3-13,Memphis Grizzlies,67,16105,2430,5498,0.442,608,1750,0.347,1822,3748,0.486,1135,1435,0.791,624,2085,2709,1431,496,963,1582,6603
8848,2018-3-14,Golden State Warriors,67,16130,2902,5700,0.509,787,1995,0.394,2115,3705,0.571,1157,1420,0.815,563,2379,2942,2024,539,1022,1319,7748
8849,2018-3-14,Houston Rockets,67,16130,2612,5630,0.464,1033,2828,0.365,1579,2802,0.564,1361,1727,0.788,609,2302,2911,1456,583,899,1328,7618
8850,2018-3-14,Toronto Raptors,67,16180,2766,5876,0.471,783,2202,0.356,1983,3674,0.54,1208,1507,0.802,657,2277,2934,1604,544,843,1468,7523
8851,2018-3-14,New Orleans Pelicans,67,16355,2851,5904,0.483,702,1929,0.364,2149,3975,0.541,1110,1447,0.767,577,2361,2938,1786,523,981,1304,7514
8852,2018-3-14,Cleveland Cavaliers,67,16130,2689,5663,0.475,804,2183,0.368,1885,3480,0.542,1209,1543,0.784,558,2258,2816,1582,480,912,1274,7391
8853,2018-3-14,Minnesota Timberwolves,69,16660,2844,5930,0.48,548,1541,0.356,2296,4389,0.523,1341,1671,0.803,716,2175,2891,1565,587,810,1245,7577
8854,2018-3-14,Los Angeles Clippers,66,15865,2643,5616,0.471,654,1863,0.351,1989,3753,0.53,1283,1697,0.756,648,2255,2903,1480,518,935,1331,7223
8855,2018-3-14,Denver Nuggets,68,16395,2761,5869,0.47,767,2085,0.368,1994,3784,0.527,1130,1481,0.763,747,2260,3007,1697,536,998,1253,7419
8856,2018-3-14,Los Angeles Lakers,67,16255,2767,5988,0.462,666,1926,0.346,2101,4062,0.517,1087,1538,0.707,737,2375,3112,1602,539,1030,1440,7287
8857,2018-3-14,Philadelphia 76ers,66,15940,2627,5616,0.468,697,1912,0.365,1930,3704,0.521,1161,1528,0.76,716,2359,3075,1707,533,1089,1475,7112
8858,2018-3-14,Washington Wizards,68,16445,2725,5823,0.468,667,1789,0.373,2058,4034,0.51,1174,1517,0.774,682,2240,2922,1683,537,941,1461,7291
8859,2018-3-14,Charlotte Hornets,68,16395,2634,5893,0.447,668,1825,0.366,1966,4068,0.483,1337,1812,0.738,682,2369,3051,1455,479,832,1206,7273
8860,2018-3-14,Oklahoma City Thunder,70,16925,2792,6147,0.454,741,2103,0.352,2051,4044,0.507,1157,1628,0.711,866,2278,3144,1486,620,945,1403,7482
8861,2018-3-14,Indiana Pacers,68,16370,2774,5838,0.475,617,1665,0.371,2157,4173,0.517,1038,1339,0.775,638,2247,2885,1500,592,891,1280,7203
8862,2018-3-14,Portland Trail Blazers,67,16155,2619,5789,0.452,701,1841,0.381,1918,3948,0.486,1148,1433,0.801,667,2365,3032,1286,459,891,1304,7087
8863,2018-3-14,Brooklyn Nets,68,16470,2584,5923,0.436,832,2387,0.349,1752,3536,0.495,1196,1535,0.779,688,2360,3048,1571,422,978,1404,7196
8864,2018-3-14,Milwaukee Bucks,67,16180,2606,5461,0.477,581,1640,0.354,2025,3821,0.53,1246,1608,0.775,549,2106,2655,1502,569,890,1444,7039
8865,2018-3-14,Orlando Magic,68,16370,2662,5805,0.459,710,1982,0.358,1952,3823,0.511,1083,1425,0.76,589,2201,2790,1588,506,967,1338,7117
8866,2018-3-14,Phoenix Suns,69,16585,2659,6028,0.441,641,1912,0.335,2018,4116,0.49,1257,1682,0.747,727,2308,3035,1459,473,1028,1559,7216
8867,2018-3-14,Boston Celtics,67,16155,2575,5709,0.451,788,2112,0.373,1787,3597,0.497,1060,1375,0.771,613,2357,2970,1508,478,875,1347,6998
8868,2018-3-14,New York Knicks,68,16445,2739,5910,0.463,532,1520,0.35,2207,4390,0.503,1055,1336,0.79,716,2268,2984,1550,463,990,1383,7065
8869,2018-3-14,Atlanta Hawks,68,16345,2592,5785,0.448,752,2061,0.365,1840,3724,0.494,1112,1398,0.795,633,2160,2793,1610,546,1030,1346,7048
8870,2018-3-14,Chicago Bulls,67,16255,2610,5957,0.438,732,2053,0.357,1878,3904,0.481,981,1286,0.763,627,2368,2995,1576,495,870,1292,6933
8871,2018-3-14,Utah Jazz,68,16370,2570,5609,0.458,738,2000,0.369,1832,3609,0.508,1120,1422,0.788,600,2310,2910,1478,591,960,1332,6998
8872,2018-3-14,Detroit Pistons,67,16155,2598,5806,0.447,700,1901,0.368,1898,3905,0.486,986,1322,0.746,687,2207,2894,1506,512,883,1258,6882
8873,2018-3-14,Miami Heat,68,16420,2610,5727,0.456,742,2073,0.358,1868,3654,0.511,1000,1335,0.749,628,2302,2930,1517,510,938,1362,6962
8874,2018-3-14,Dallas Mavericks,68,16395,2581,5799,0.445,800,2201,0.363,1781,3598,0.495,1002,1302,0.77,548,2245,2793,1539,488,813,1315,6964
8875,2018-3-14,San Antonio Spurs,68,16320,2644,5767,0.458,590,1653,0.357,2054,4114,0.499,1074,1387,0.774,682,2322,3004,1561,506,885,1153,6952
8876,2018-3-14,Sacramento Kings,68,16370,2642,5852,0.451,613,1620,0.378,2029,4232,0.479,852,1154,0.738,650,2112,2762,1452,551,905,1345,6749
8877,2018-3-14,Memphis Grizzlies,67,16105,2430,5498,0.442,608,1750,0.347,1822,3748,0.486,1135,1435,0.791,624,2085,2709,1431,496,963,1582,6603
8878,2018-3-15,Golden State Warriors,68,16370,2946,5781,0.51,793,2015,0.394,2153,3766,0.572,1180,1448,0.815,574,2418,2992,2049,547,1043,1343,7865
8879,2018-3-15,Houston Rockets,67,16130,2612,5630,0.464,1033,2828,0.365,1579,2802,0.564,1361,1727,0.788,609,2302,2911,1456,583,899,1328,7618
8880,2018-3-15,Toronto Raptors,67,16180,2766,5876,0.471,783,2202,0.356,1983,3674,0.54,1208,1507,0.802,657,2277,2934,1604,544,843,1468,7523
8881,2018-3-15,New Orleans Pelicans,67,16355,2851,5904,0.483,702,1929,0.364,2149,3975,0.541,1110,1447,0.767,577,2361,2938,1786,523,981,1304,7514
8882,2018-3-15,Cleveland Cavaliers,67,16130,2689,5663,0.475,804,2183,0.368,1885,3480,0.542,1209,1543,0.784,558,2258,2816,1582,480,912,1274,7391
8883,2018-3-15,Minnesota Timberwolves,69,16660,2844,5930,0.48,548,1541,0.356,2296,4389,0.523,1341,1671,0.803,716,2175,2891,1565,587,810,1245,7577
8884,2018-3-15,Los Angeles Clippers,66,15865,2643,5616,0.471,654,1863,0.351,1989,3753,0.53,1283,1697,0.756,648,2255,2903,1480,518,935,1331,7223
8885,2018-3-15,Denver Nuggets,68,16395,2761,5869,0.47,767,2085,0.368,1994,3784,0.527,1130,1481,0.763,747,2260,3007,1697,536,998,1253,7419
8886,2018-3-15,Los Angeles Lakers,68,16495,2805,6072,0.462,678,1964,0.345,2127,4108,0.518,1105,1566,0.706,744,2403,3147,1626,550,1044,1459,7393
8887,2018-3-15,Philadelphia 76ers,66,15940,2627,5616,0.468,697,1912,0.365,1930,3704,0.521,1161,1528,0.76,716,2359,3075,1707,533,1089,1475,7112
8888,2018-3-15,Washington Wizards,69,16735,2771,5920,0.468,679,1821,0.373,2092,4099,0.51,1195,1545,0.773,695,2279,2974,1712,547,960,1487,7416
8889,2018-3-15,Charlotte Hornets,68,16395,2634,5893,0.447,668,1825,0.366,1966,4068,0.483,1337,1812,0.738,682,2369,3051,1455,479,832,1206,7273
8890,2018-3-15,Oklahoma City Thunder,70,16925,2792,6147,0.454,741,2103,0.352,2051,4044,0.507,1157,1628,0.711,866,2278,3144,1486,620,945,1403,7482
8891,2018-3-15,Indiana Pacers,68,16370,2774,5838,0.475,617,1665,0.371,2157,4173,0.517,1038,1339,0.775,638,2247,2885,1500,592,891,1280,7203
8892,2018-3-15,Portland Trail Blazers,67,16155,2619,5789,0.452,701,1841,0.381,1918,3948,0.486,1148,1433,0.801,667,2365,3032,1286,459,891,1304,7087
8893,2018-3-15,Brooklyn Nets,68,16470,2584,5923,0.436,832,2387,0.349,1752,3536,0.495,1196,1535,0.779,688,2360,3048,1571,422,978,1404,7196
8894,2018-3-15,Milwaukee Bucks,68,16420,2655,5559,0.478,591,1664,0.355,2064,3895,0.53,1255,1620,0.775,558,2134,2692,1530,581,901,1464,7156
8895,2018-3-15,Orlando Magic,69,16610,2706,5892,0.459,728,2016,0.361,1978,3876,0.51,1103,1448,0.762,598,2234,2832,1619,516,984,1354,7243
8896,2018-3-15,Boston Celtics,68,16445,2623,5808,0.452,800,2138,0.374,1823,3670,0.497,1076,1398,0.77,623,2391,3014,1538,487,892,1369,7122
8897,2018-3-15,Phoenix Suns,69,16585,2659,6028,0.441,641,1912,0.335,2018,4116,0.49,1257,1682,0.747,727,2308,3035,1459,473,1028,1559,7216
8898,2018-3-15,New York Knicks,68,16445,2739,5910,0.463,532,1520,0.35,2207,4390,0.503,1055,1336,0.79,716,2268,2984,1550,463,990,1383,7065
8899,2018-3-15,Atlanta Hawks,68,16345,2592,5785,0.448,752,2061,0.365,1840,3724,0.494,1112,1398,0.795,633,2160,2793,1610,546,1030,1346,7048
8900,2018-3-15,Chicago Bulls,67,16255,2610,5957,0.438,732,2053,0.357,1878,3904,0.481,981,1286,0.763,627,2368,2995,1576,495,870,1292,6933
8901,2018-3-15,Utah Jazz,68,16370,2570,5609,0.458,738,2000,0.369,1832,3609,0.508,1120,1422,0.788,600,2310,2910,1478,591,960,1332,6998
8902,2018-3-15,Detroit Pistons,67,16155,2598,5806,0.447,700,1901,0.368,1898,3905,0.486,986,1322,0.746,687,2207,2894,1506,512,883,1258,6882
8903,2018-3-15,Miami Heat,69,16685,2651,5826,0.455,760,2116,0.359,1891,3710,0.51,1019,1356,0.751,643,2340,2983,1543,515,952,1385,7081
8904,2018-3-15,Dallas Mavericks,68,16395,2581,5799,0.445,800,2201,0.363,1781,3598,0.495,1002,1302,0.77,548,2245,2793,1539,488,813,1315,6964
8905,2018-3-15,San Antonio Spurs,68,16320,2644,5767,0.458,590,1653,0.357,2054,4114,0.499,1074,1387,0.774,682,2322,3004,1561,506,885,1153,6952
8906,2018-3-15,Sacramento Kings,69,16635,2690,5946,0.452,621,1644,0.378,2069,4302,0.481,871,1179,0.739,658,2147,2805,1475,557,916,1366,6872
8907,2018-3-15,Memphis Grizzlies,67,16105,2430,5498,0.442,608,1750,0.347,1822,3748,0.486,1135,1435,0.791,624,2085,2709,1431,496,963,1582,6603
8908,2018-3-16,Golden State Warriors,68,16370,2946,5781,0.51,793,2015,0.394,2153,3766,0.572,1180,1448,0.815,574,2418,2992,2049,547,1043,1343,7865
8909,2018-3-16,Houston Rockets,68,16370,2647,5720,0.463,1045,2869,0.364,1602,2851,0.562,1380,1750,0.789,625,2336,2961,1476,587,910,1341,7719
8910,2018-3-16,Toronto Raptors,68,16420,2801,5955,0.47,795,2234,0.356,2006,3721,0.539,1232,1535,0.803,675,2316,2991,1624,548,863,1487,7629
8911,2018-3-16,New Orleans Pelicans,68,16595,2887,5994,0.482,708,1945,0.364,2179,4049,0.538,1125,1463,0.769,589,2402,2991,1804,530,995,1322,7607
8912,2018-3-16,Cleveland Cavaliers,68,16370,2730,5743,0.475,815,2216,0.368,1915,3527,0.543,1221,1564,0.781,560,2290,2850,1599,485,923,1295,7496
8913,2018-3-16,Minnesota Timberwolves,69,16660,2844,5930,0.48,548,1541,0.356,2296,4389,0.523,1341,1671,0.803,716,2175,2891,1565,587,810,1245,7577
8914,2018-3-16,Denver Nuggets,69,16635,2804,5954,0.471,779,2113,0.369,2025,3841,0.527,1152,1509,0.763,757,2295,3052,1723,543,1013,1268,7539
8915,2018-3-16,Los Angeles Clippers,67,16105,2687,5713,0.47,658,1881,0.35,2029,3832,0.529,1287,1705,0.755,659,2289,2948,1496,521,944,1352,7319
8916,2018-3-16,Los Angeles Lakers,68,16495,2805,6072,0.462,678,1964,0.345,2127,4108,0.518,1105,1566,0.706,744,2403,3147,1626,550,1044,1459,7393
8917,2018-3-16,Philadelphia 76ers,67,16180,2668,5707,0.467,712,1949,0.365,1956,3758,0.52,1182,1562,0.757,735,2393,3128,1736,541,1103,1496,7230
8918,2018-3-16,Washington Wizards,69,16735,2771,5920,0.468,679,1821,0.373,2092,4099,0.51,1195,1545,0.773,695,2279,2974,1712,547,960,1487,7416
8919,2018-3-16,Charlotte Hornets,69,16635,2680,5980,0.448,685,1858,0.369,1995,4122,0.484,1357,1842,0.737,688,2408,3096,1485,482,842,1227,7402
8920,2018-3-16,Oklahoma City Thunder,70,16925,2792,6147,0.454,741,2103,0.352,2051,4044,0.507,1157,1628,0.711,866,2278,3144,1486,620,945,1403,7482
8921,2018-3-16,Portland Trail Blazers,68,16395,2662,5885,0.452,713,1876,0.38,1949,4009,0.486,1163,1452,0.801,680,2402,3082,1312,463,898,1319,7200
8922,2018-3-16,Brooklyn Nets,68,16470,2584,5923,0.436,832,2387,0.349,1752,3536,0.495,1196,1535,0.779,688,2360,3048,1571,422,978,1404,7196
8923,2018-3-16,Indiana Pacers,69,16610,2814,5931,0.474,624,1689,0.369,2190,4242,0.516,1050,1356,0.774,649,2270,2919,1517,604,899,1305,7302
8924,2018-3-16,Milwaukee Bucks,68,16420,2655,5559,0.478,591,1664,0.355,2064,3895,0.53,1255,1620,0.775,558,2134,2692,1530,581,901,1464,7156
8925,2018-3-16,Orlando Magic,69,16610,2706,5892,0.459,728,2016,0.361,1978,3876,0.51,1103,1448,0.762,598,2234,2832,1619,516,984,1354,7243
8926,2018-3-16,Boston Celtics,68,16445,2623,5808,0.452,800,2138,0.374,1823,3670,0.497,1076,1398,0.77,623,2391,3014,1538,487,892,1369,7122
8927,2018-3-16,Phoenix Suns,70,16825,2691,6111,0.44,648,1928,0.336,2043,4183,0.488,1274,1706,0.747,736,2350,3086,1473,477,1050,1584,7304
8928,2018-3-16,New York Knicks,69,16685,2784,5997,0.464,537,1540,0.349,2247,4457,0.504,1070,1360,0.787,724,2304,3028,1576,471,1002,1408,7175
8929,2018-3-16,Atlanta Hawks,69,16585,2634,5875,0.448,768,2097,0.366,1866,3778,0.494,1129,1424,0.793,639,2200,2839,1640,551,1041,1373,7165
8930,2018-3-16,Chicago Bulls,68,16495,2645,6037,0.438,747,2094,0.357,1898,3943,0.481,1007,1319,0.763,635,2402,3037,1599,505,883,1315,7044
8931,2018-3-16,Utah Jazz,69,16610,2612,5706,0.458,750,2036,0.368,1862,3670,0.507,1140,1454,0.784,614,2349,2963,1507,603,967,1352,7114
8932,2018-3-16,Detroit Pistons,68,16395,2642,5898,0.448,714,1928,0.37,1928,3970,0.486,997,1339,0.745,696,2239,2935,1536,520,894,1278,6995
8933,2018-3-16,Miami Heat,69,16685,2651,5826,0.455,760,2116,0.359,1891,3710,0.51,1019,1356,0.751,643,2340,2983,1543,515,952,1385,7081
8934,2018-3-16,Dallas Mavericks,68,16395,2581,5799,0.445,800,2201,0.363,1781,3598,0.495,1002,1302,0.77,548,2245,2793,1539,488,813,1315,6964
8935,2018-3-16,San Antonio Spurs,69,16560,2681,5866,0.457,597,1679,0.356,2084,4187,0.498,1091,1406,0.776,697,2359,3056,1577,516,895,1167,7050
8936,2018-3-16,Sacramento Kings,69,16635,2690,5946,0.452,621,1644,0.378,2069,4302,0.481,871,1179,0.739,658,2147,2805,1475,557,916,1366,6872
8937,2018-3-16,Memphis Grizzlies,68,16345,2468,5585,0.442,621,1785,0.348,1847,3800,0.486,1156,1460,0.792,635,2121,2756,1458,503,977,1604,6713
8938,2018-3-17,Golden State Warriors,69,16610,2980,5862,0.508,805,2041,0.394,2175,3821,0.569,1193,1466,0.814,583,2449,3032,2070,557,1054,1364,7958
8939,2018-3-17,Houston Rockets,68,16370,2647,5720,0.463,1045,2869,0.364,1602,2851,0.562,1380,1750,0.789,625,2336,2961,1476,587,910,1341,7719
8940,2018-3-17,Toronto Raptors,69,16685,2844,6046,0.47,805,2264,0.356,2039,3782,0.539,1258,1566,0.803,687,2349,3036,1650,553,876,1508,7751
8941,2018-3-17,New Orleans Pelicans,68,16595,2887,5994,0.482,708,1945,0.364,2179,4049,0.538,1125,1463,0.769,589,2402,2991,1804,530,995,1322,7607
8942,2018-3-17,Cleveland Cavaliers,68,16370,2730,5743,0.475,815,2216,0.368,1915,3527,0.543,1221,1564,0.781,560,2290,2850,1599,485,923,1295,7496
8943,2018-3-17,Minnesota Timberwolves,69,16660,2844,5930,0.48,548,1541,0.356,2296,4389,0.523,1341,1671,0.803,716,2175,2891,1565,587,810,1245,7577
8944,2018-3-17,Denver Nuggets,69,16635,2804,5954,0.471,779,2113,0.369,2025,3841,0.527,1152,1509,0.763,757,2295,3052,1723,543,1013,1268,7539
8945,2018-3-17,Los Angeles Clippers,68,16345,2729,5799,0.471,669,1907,0.351,2060,3892,0.529,1305,1728,0.755,675,2321,2996,1517,531,965,1370,7432
8946,2018-3-17,Los Angeles Lakers,69,16735,2837,6148,0.461,687,1983,0.346,2150,4165,0.516,1123,1588,0.707,751,2445,3196,1648,555,1064,1476,7484
8947,2018-3-17,Philadelphia 76ers,68,16420,2711,5802,0.467,724,1976,0.366,1987,3826,0.519,1204,1588,0.758,748,2422,3170,1766,550,1108,1517,7350
8948,2018-3-17,Washington Wizards,69,16735,2771,5920,0.468,679,1821,0.373,2092,4099,0.51,1195,1545,0.773,695,2279,2974,1712,547,960,1487,7416
8949,2018-3-17,Charlotte Hornets,69,16635,2680,5980,0.448,685,1858,0.369,1995,4122,0.484,1357,1842,0.737,688,2408,3096,1485,482,842,1227,7402
8950,2018-3-17,Oklahoma City Thunder,71,17165,2838,6241,0.455,752,2135,0.352,2086,4106,0.508,1175,1650,0.712,883,2307,3190,1516,637,959,1423,7603
8951,2018-3-17,Brooklyn Nets,69,16710,2624,6012,0.436,847,2417,0.35,1777,3595,0.494,1217,1562,0.779,699,2396,3095,1596,426,990,1426,7312
8952,2018-3-17,Portland Trail Blazers,68,16395,2662,5885,0.452,713,1876,0.38,1949,4009,0.486,1163,1452,0.801,680,2402,3082,1312,463,898,1319,7200
8953,2018-3-17,Indiana Pacers,69,16610,2814,5931,0.474,624,1689,0.369,2190,4242,0.516,1050,1356,0.774,649,2270,2919,1517,604,899,1305,7302
8954,2018-3-17,Milwaukee Bucks,68,16420,2655,5559,0.478,591,1664,0.355,2064,3895,0.53,1255,1620,0.775,558,2134,2692,1530,581,901,1464,7156
8955,2018-3-17,Orlando Magic,70,16850,2740,5979,0.458,733,2044,0.359,2007,3935,0.51,1113,1459,0.763,605,2267,2872,1633,528,999,1377,7326
8956,2018-3-17,Boston Celtics,69,16685,2654,5890,0.451,809,2164,0.374,1845,3726,0.495,1097,1426,0.769,639,2430,3069,1554,494,910,1386,7214
8957,2018-3-17,Phoenix Suns,70,16825,2691,6111,0.44,648,1928,0.336,2043,4183,0.488,1274,1706,0.747,736,2350,3086,1473,477,1050,1584,7304
8958,2018-3-17,New York Knicks,69,16685,2784,5997,0.464,537,1540,0.349,2247,4457,0.504,1070,1360,0.787,724,2304,3028,1576,471,1002,1408,7175
8959,2018-3-17,Atlanta Hawks,69,16585,2634,5875,0.448,768,2097,0.366,1866,3778,0.494,1129,1424,0.793,639,2200,2839,1640,551,1041,1373,7165
8960,2018-3-17,Chicago Bulls,68,16495,2645,6037,0.438,747,2094,0.357,1898,3943,0.481,1007,1319,0.763,635,2402,3037,1599,505,883,1315,7044
8961,2018-3-17,Utah Jazz,69,16610,2612,5706,0.458,750,2036,0.368,1862,3670,0.507,1140,1454,0.784,614,2349,2963,1507,603,967,1352,7114
8962,2018-3-17,Detroit Pistons,68,16395,2642,5898,0.448,714,1928,0.37,1928,3970,0.486,997,1339,0.745,696,2239,2935,1536,520,894,1278,6995
8963,2018-3-17,Dallas Mavericks,69,16660,2629,5890,0.446,806,2223,0.363,1823,3667,0.497,1015,1320,0.769,554,2275,2829,1564,495,823,1342,7079
8964,2018-3-17,Miami Heat,70,16925,2687,5920,0.454,770,2152,0.358,1917,3768,0.509,1029,1370,0.751,655,2371,3026,1566,529,963,1403,7173
8965,2018-3-17,San Antonio Spurs,69,16560,2681,5866,0.457,597,1679,0.356,2084,4187,0.498,1091,1406,0.776,697,2359,3056,1577,516,895,1167,7050
8966,2018-3-17,Sacramento Kings,70,16875,2726,6029,0.452,635,1675,0.379,2091,4354,0.48,883,1196,0.738,669,2183,2852,1500,564,929,1382,6970
8967,2018-3-17,Memphis Grizzlies,68,16345,2468,5585,0.442,621,1785,0.348,1847,3800,0.486,1156,1460,0.792,635,2121,2756,1458,503,977,1604,6713
8968,2018-3-18,Golden State Warriors,70,16850,3030,5957,0.509,818,2072,0.395,2212,3885,0.569,1204,1480,0.814,592,2483,3075,2099,565,1067,1385,8082
8969,2018-3-18,Houston Rockets,69,16610,2686,5813,0.462,1060,2910,0.364,1626,2903,0.56,1394,1768,0.788,638,2369,3007,1495,595,917,1360,7826
8970,2018-3-18,Toronto Raptors,69,16685,2844,6046,0.47,805,2264,0.356,2039,3782,0.539,1258,1566,0.803,687,2349,3036,1650,553,876,1508,7751
8971,2018-3-18,New Orleans Pelicans,69,16835,2928,6077,0.482,716,1969,0.364,2212,4108,0.538,1136,1475,0.77,595,2436,3031,1822,534,1007,1341,7708
8972,2018-3-18,Cleveland Cavaliers,69,16610,2774,5830,0.476,828,2253,0.368,1946,3577,0.544,1234,1584,0.779,571,2323,2894,1624,489,936,1309,7610
8973,2018-3-18,Minnesota Timberwolves,70,16900,2883,6011,0.48,555,1553,0.357,2328,4458,0.522,1357,1691,0.802,726,2199,2925,1587,590,826,1261,7678
8974,2018-3-18,Los Angeles Clippers,68,16345,2729,5799,0.471,669,1907,0.351,2060,3892,0.529,1305,1728,0.755,675,2321,2996,1517,531,965,1370,7432
8975,2018-3-18,Denver Nuggets,70,16875,2836,6041,0.469,788,2146,0.367,2048,3895,0.526,1173,1538,0.763,775,2326,3101,1740,553,1020,1293,7633
8976,2018-3-18,Los Angeles Lakers,69,16735,2837,6148,0.461,687,1983,0.346,2150,4165,0.516,1123,1588,0.707,751,2445,3196,1648,555,1064,1476,7484
8977,2018-3-18,Philadelphia 76ers,68,16420,2711,5802,0.467,724,1976,0.366,1987,3826,0.519,1204,1588,0.758,748,2422,3170,1766,550,1108,1517,7350
8978,2018-3-18,Washington Wizards,70,16975,2811,5994,0.469,689,1841,0.374,2122,4153,0.511,1214,1568,0.774,701,2311,3012,1741,556,974,1504,7525
8979,2018-3-18,Charlotte Hornets,70,16875,2713,6070,0.447,694,1891,0.367,2019,4179,0.483,1383,1874,0.738,701,2445,3146,1496,489,852,1240,7503
8980,2018-3-18,Oklahoma City Thunder,71,17165,2838,6241,0.455,752,2135,0.352,2086,4106,0.508,1175,1650,0.712,883,2307,3190,1516,637,959,1423,7603
8981,2018-3-18,Brooklyn Nets,70,16950,2667,6096,0.438,861,2453,0.351,1806,3643,0.496,1231,1581,0.779,709,2429,3138,1621,430,1000,1440,7426
8982,2018-3-18,Portland Trail Blazers,69,16635,2700,5972,0.452,721,1907,0.378,1979,4065,0.487,1179,1470,0.802,689,2442,3131,1335,471,909,1336,7300
8983,2018-3-18,Indiana Pacers,70,16850,2853,6017,0.474,636,1713,0.371,2217,4304,0.515,1062,1371,0.775,659,2298,2957,1541,610,914,1323,7404
8984,2018-3-18,Milwaukee Bucks,69,16660,2696,5645,0.478,602,1689,0.356,2094,3956,0.529,1284,1652,0.777,567,2169,2736,1561,593,913,1488,7278
8985,2018-3-18,Orlando Magic,70,16850,2740,5979,0.458,733,2044,0.359,2007,3935,0.51,1113,1459,0.763,605,2267,2872,1633,528,999,1377,7326
8986,2018-3-18,Boston Celtics,69,16685,2654,5890,0.451,809,2164,0.374,1845,3726,0.495,1097,1426,0.769,639,2430,3069,1554,494,910,1386,7214
8987,2018-3-18,Phoenix Suns,71,17065,2730,6193,0.441,659,1952,0.338,2071,4241,0.488,1294,1735,0.746,745,2383,3128,1495,485,1069,1603,7413
8988,2018-3-18,New York Knicks,70,16925,2833,6097,0.465,549,1566,0.351,2284,4531,0.504,1084,1378,0.787,736,2348,3084,1600,478,1010,1430,7299
8989,2018-3-18,Atlanta Hawks,70,16825,2673,5960,0.448,780,2133,0.366,1893,3827,0.495,1156,1452,0.796,647,2236,2883,1663,558,1060,1398,7282
8990,2018-3-18,Chicago Bulls,69,16735,2686,6128,0.438,763,2128,0.359,1923,4000,0.481,1018,1334,0.763,646,2436,3082,1629,509,895,1336,7153
8991,2018-3-18,Utah Jazz,70,16850,2645,5780,0.458,756,2060,0.367,1889,3720,0.508,1171,1492,0.785,622,2389,3011,1528,611,982,1365,7217
8992,2018-3-18,Detroit Pistons,69,16635,2673,5978,0.447,724,1953,0.371,1949,4025,0.484,1012,1359,0.745,704,2274,2978,1553,526,906,1294,7082
8993,2018-3-18,Dallas Mavericks,70,16900,2670,5982,0.446,818,2245,0.364,1852,3737,0.496,1027,1334,0.77,567,2307,2874,1589,500,833,1363,7185
8994,2018-3-18,Miami Heat,70,16925,2687,5920,0.454,770,2152,0.358,1917,3768,0.509,1029,1370,0.751,655,2371,3026,1566,529,963,1403,7173
8995,2018-3-18,San Antonio Spurs,70,16800,2730,5962,0.458,603,1705,0.354,2127,4257,0.5,1104,1420,0.777,711,2386,3097,1609,527,900,1184,7167
8996,2018-3-18,Sacramento Kings,71,17115,2763,6115,0.452,649,1696,0.383,2114,4419,0.478,892,1210,0.737,672,2213,2885,1523,575,942,1412,7067
8997,2018-3-18,Memphis Grizzlies,69,16585,2501,5666,0.441,634,1817,0.349,1867,3849,0.485,1178,1488,0.792,649,2154,2803,1479,508,988,1624,6814
8998,2018-3-19,Golden State Warriors,70,16850,3030,5957,0.509,818,2072,0.395,2212,3885,0.569,1204,1480,0.814,592,2483,3075,2099,565,1067,1385,8082
8999,2018-3-19,Houston Rockets,70,16850,2729,5891,0.463,1076,2945,0.365,1653,2946,0.561,1421,1804,0.788,646,2394,3040,1523,602,928,1386,7955
9000,2018-3-19,Toronto Raptors,70,16925,2890,6127,0.472,820,2294,0.357,2070,3833,0.54,1276,1589,0.803,695,2372,3067,1681,558,895,1533,7876
9001,2018-3-19,New Orleans Pelicans,70,17075,2969,6159,0.482,722,1987,0.363,2247,4172,0.539,1156,1500,0.771,600,2475,3075,1855,543,1017,1354,7816
9002,2018-3-19,Cleveland Cavaliers,69,16610,2774,5830,0.476,828,2253,0.368,1946,3577,0.544,1234,1584,0.779,571,2323,2894,1624,489,936,1309,7610
9003,2018-3-19,Minnesota Timberwolves,71,17140,2928,6097,0.48,565,1573,0.359,2363,4524,0.522,1377,1717,0.802,740,2226,2966,1611,597,838,1287,7798
9004,2018-3-19,Los Angeles Clippers,69,16585,2769,5888,0.47,678,1930,0.351,2091,3958,0.528,1325,1755,0.755,683,2351,3034,1538,539,973,1387,7541
9005,2018-3-19,Denver Nuggets,70,16875,2836,6041,0.469,788,2146,0.367,2048,3895,0.526,1173,1538,0.763,775,2326,3101,1740,553,1020,1293,7633
9006,2018-3-19,Los Angeles Lakers,69,16735,2837,6148,0.461,687,1983,0.346,2150,4165,0.516,1123,1588,0.707,751,2445,3196,1648,555,1064,1476,7484
9007,2018-3-19,Philadelphia 76ers,68,16420,2711,5802,0.467,724,1976,0.366,1987,3826,0.519,1204,1588,0.758,748,2422,3170,1766,550,1108,1517,7350
9008,2018-3-19,Washington Wizards,70,16975,2811,5994,0.469,689,1841,0.374,2122,4153,0.511,1214,1568,0.774,701,2311,3012,1741,556,974,1504,7525
9009,2018-3-19,Oklahoma City Thunder,72,17405,2887,6329,0.456,762,2156,0.353,2125,4173,0.509,1199,1684,0.712,897,2332,3229,1543,648,976,1447,7735
9010,2018-3-19,Charlotte Hornets,70,16875,2713,6070,0.447,694,1891,0.367,2019,4179,0.483,1383,1874,0.738,701,2445,3146,1496,489,852,1240,7503
9011,2018-3-19,Brooklyn Nets,70,16950,2667,6096,0.438,861,2453,0.351,1806,3643,0.496,1231,1581,0.779,709,2429,3138,1621,430,1000,1440,7426
9012,2018-3-19,Portland Trail Blazers,70,16875,2746,6064,0.453,735,1936,0.38,2011,4128,0.487,1195,1490,0.802,697,2481,3178,1359,478,922,1358,7422
9013,2018-3-19,Indiana Pacers,70,16850,2853,6017,0.474,636,1713,0.371,2217,4304,0.515,1062,1371,0.775,659,2298,2957,1541,610,914,1323,7404
9014,2018-3-19,Milwaukee Bucks,69,16660,2696,5645,0.478,602,1689,0.356,2094,3956,0.529,1284,1652,0.777,567,2169,2736,1561,593,913,1488,7278
9015,2018-3-19,Orlando Magic,70,16850,2740,5979,0.458,733,2044,0.359,2007,3935,0.51,1113,1459,0.763,605,2267,2872,1633,528,999,1377,7326
9016,2018-3-19,Phoenix Suns,71,17065,2730,6193,0.441,659,1952,0.338,2071,4241,0.488,1294,1735,0.746,745,2383,3128,1495,485,1069,1603,7413
9017,2018-3-19,Boston Celtics,70,16925,2689,5977,0.45,818,2190,0.374,1871,3787,0.494,1107,1446,0.766,648,2465,3113,1571,502,922,1407,7303
9018,2018-3-19,New York Knicks,70,16925,2833,6097,0.465,549,1566,0.351,2284,4531,0.504,1084,1378,0.787,736,2348,3084,1600,478,1010,1430,7299
9019,2018-3-19,Atlanta Hawks,70,16825,2673,5960,0.448,780,2133,0.366,1893,3827,0.495,1156,1452,0.796,647,2236,2883,1663,558,1060,1398,7282
9020,2018-3-19,Chicago Bulls,69,16735,2686,6128,0.438,763,2128,0.359,1923,4000,0.481,1018,1334,0.763,646,2436,3082,1629,509,895,1336,7153
9021,2018-3-19,Utah Jazz,70,16850,2645,5780,0.458,756,2060,0.367,1889,3720,0.508,1171,1492,0.785,622,2389,3011,1528,611,982,1365,7217
9022,2018-3-19,Detroit Pistons,69,16635,2673,5978,0.447,724,1953,0.371,1949,4025,0.484,1012,1359,0.745,704,2274,2978,1553,526,906,1294,7082
9023,2018-3-19,Dallas Mavericks,70,16900,2670,5982,0.446,818,2245,0.364,1852,3737,0.496,1027,1334,0.77,567,2307,2874,1589,500,833,1363,7185
9024,2018-3-19,Miami Heat,70,16925,2687,5920,0.454,770,2152,0.358,1917,3768,0.509,1029,1370,0.751,655,2371,3026,1566,529,963,1403,7173
9025,2018-3-19,San Antonio Spurs,70,16800,2730,5962,0.458,603,1705,0.354,2127,4257,0.5,1104,1420,0.777,711,2386,3097,1609,527,900,1184,7167
9026,2018-3-19,Sacramento Kings,71,17115,2763,6115,0.452,649,1696,0.383,2114,4419,0.478,892,1210,0.737,672,2213,2885,1523,575,942,1412,7067
9027,2018-3-19,Memphis Grizzlies,69,16585,2501,5666,0.441,634,1817,0.349,1867,3849,0.485,1178,1488,0.792,649,2154,2803,1479,508,988,1624,6814
9028,2018-3-20,Golden State Warriors,71,17090,3060,6031,0.507,821,2091,0.393,2239,3940,0.568,1216,1496,0.813,594,2517,3111,2116,572,1082,1409,8157
9029,2018-3-20,Houston Rockets,70,16850,2729,5891,0.463,1076,2945,0.365,1653,2946,0.561,1421,1804,0.788,646,2394,3040,1523,602,928,1386,7955
9030,2018-3-20,Toronto Raptors,70,16925,2890,6127,0.472,820,2294,0.357,2070,3833,0.54,1276,1589,0.803,695,2372,3067,1681,558,895,1533,7876
9031,2018-3-20,New Orleans Pelicans,70,17075,2969,6159,0.482,722,1987,0.363,2247,4172,0.539,1156,1500,0.771,600,2475,3075,1855,543,1017,1354,7816
9032,2018-3-20,Cleveland Cavaliers,70,16850,2817,5917,0.476,843,2291,0.368,1974,3626,0.544,1257,1611,0.78,583,2353,2936,1648,493,949,1326,7734
9033,2018-3-20,Minnesota Timberwolves,71,17140,2928,6097,0.48,565,1573,0.359,2363,4524,0.522,1377,1717,0.802,740,2226,2966,1611,597,838,1287,7798
9034,2018-3-20,Denver Nuggets,71,17165,2882,6141,0.469,806,2184,0.369,2076,3957,0.525,1204,1575,0.764,786,2361,3147,1763,563,1033,1318,7774
9035,2018-3-20,Los Angeles Clippers,69,16585,2769,5888,0.47,678,1930,0.351,2091,3958,0.528,1325,1755,0.755,683,2351,3034,1538,539,973,1387,7541
9036,2018-3-20,Los Angeles Lakers,70,16975,2875,6234,0.461,695,2016,0.345,2180,4218,0.517,1139,1611,0.707,765,2478,3243,1668,559,1077,1494,7584
9037,2018-3-20,Philadelphia 76ers,69,16660,2753,5895,0.467,742,2020,0.367,2011,3875,0.519,1210,1596,0.758,765,2465,3230,1796,555,1123,1539,7458
9038,2018-3-20,Washington Wizards,70,16975,2811,5994,0.469,689,1841,0.374,2122,4153,0.511,1214,1568,0.774,701,2311,3012,1741,556,974,1504,7525
9039,2018-3-20,Oklahoma City Thunder,72,17405,2887,6329,0.456,762,2156,0.353,2125,4173,0.509,1199,1684,0.712,897,2332,3229,1543,648,976,1447,7735
9040,2018-3-20,Charlotte Hornets,71,17115,2745,6154,0.446,700,1913,0.366,2045,4241,0.482,1407,1904,0.739,707,2478,3185,1512,497,861,1252,7597
9041,2018-3-20,Brooklyn Nets,71,17190,2703,6168,0.438,877,2493,0.352,1826,3675,0.497,1261,1621,0.778,718,2461,3179,1648,435,1022,1462,7544
9042,2018-3-20,Portland Trail Blazers,70,16875,2746,6064,0.453,735,1936,0.38,2011,4128,0.487,1195,1490,0.802,697,2481,3178,1359,478,922,1358,7422
9043,2018-3-20,Indiana Pacers,71,17090,2896,6104,0.474,642,1734,0.37,2254,4370,0.516,1080,1390,0.777,668,2333,3001,1565,619,920,1339,7514
9044,2018-3-20,Milwaukee Bucks,70,16900,2741,5733,0.478,610,1720,0.355,2131,4013,0.531,1303,1672,0.779,575,2193,2768,1587,604,928,1511,7395
9045,2018-3-20,Orlando Magic,70,16850,2740,5979,0.458,733,2044,0.359,2007,3935,0.51,1113,1459,0.763,605,2267,2872,1633,528,999,1377,7326
9046,2018-3-20,Phoenix Suns,71,17065,2730,6193,0.441,659,1952,0.338,2071,4241,0.488,1294,1735,0.746,745,2383,3128,1495,485,1069,1603,7413
9047,2018-3-20,New York Knicks,71,17165,2876,6193,0.464,560,1601,0.35,2316,4592,0.504,1097,1395,0.786,751,2394,3145,1628,484,1026,1454,7409
9048,2018-3-20,Boston Celtics,70,16925,2689,5977,0.45,818,2190,0.374,1871,3787,0.494,1107,1446,0.766,648,2465,3113,1571,502,922,1407,7303
9049,2018-3-20,Atlanta Hawks,70,16825,2673,5960,0.448,780,2133,0.366,1893,3827,0.495,1156,1452,0.796,647,2236,2883,1663,558,1060,1398,7282
9050,2018-3-20,Chicago Bulls,70,16975,2719,6220,0.437,766,2158,0.355,1953,4062,0.481,1041,1365,0.763,660,2470,3130,1650,518,906,1351,7245
9051,2018-3-20,Miami Heat,71,17215,2743,6022,0.455,790,2188,0.361,1953,3834,0.509,1046,1397,0.749,662,2410,3072,1602,534,974,1429,7322
9052,2018-3-20,Utah Jazz,70,16850,2645,5780,0.458,756,2060,0.367,1889,3720,0.508,1171,1492,0.785,622,2389,3011,1528,611,982,1365,7217
9053,2018-3-20,Detroit Pistons,70,16875,2710,6057,0.447,738,1982,0.372,1972,4075,0.484,1030,1381,0.746,710,2312,3022,1570,532,915,1305,7188
9054,2018-3-20,Dallas Mavericks,70,16900,2670,5982,0.446,818,2245,0.364,1852,3737,0.496,1027,1334,0.77,567,2307,2874,1589,500,833,1363,7185
9055,2018-3-20,San Antonio Spurs,71,17040,2763,6044,0.457,611,1728,0.354,2152,4316,0.499,1119,1441,0.777,722,2423,3145,1630,533,914,1204,7256
9056,2018-3-20,Sacramento Kings,72,17355,2803,6203,0.452,655,1719,0.381,2148,4484,0.479,896,1219,0.735,680,2244,2924,1546,582,955,1433,7157
9057,2018-3-20,Memphis Grizzlies,70,16825,2547,5754,0.443,644,1840,0.35,1903,3914,0.486,1191,1508,0.79,660,2185,2845,1500,519,1004,1657,6929
9058,2018-3-21,Golden State Warriors,71,17090,3060,6031,0.507,821,2091,0.393,2239,3940,0.568,1216,1496,0.813,594,2517,3111,2116,572,1082,1409,8157
9059,2018-3-21,Houston Rockets,71,17090,2767,5970,0.463,1095,2981,0.367,1672,2989,0.559,1441,1833,0.786,653,2425,3078,1541,605,937,1409,8070
9060,2018-3-21,Toronto Raptors,71,17165,2925,6204,0.471,834,2330,0.358,2091,3874,0.54,1285,1606,0.8,701,2411,3112,1700,565,912,1543,7969
9061,2018-3-21,New Orleans Pelicans,71,17315,3017,6250,0.483,732,2012,0.364,2285,4238,0.539,1165,1515,0.769,609,2512,3121,1888,548,1026,1365,7931
9062,2018-3-21,Cleveland Cavaliers,70,16850,2817,5917,0.476,843,2291,0.368,1974,3626,0.544,1257,1611,0.78,583,2353,2936,1648,493,949,1326,7734
9063,2018-3-21,Minnesota Timberwolves,72,17380,2973,6183,0.481,575,1598,0.36,2398,4585,0.523,1400,1741,0.804,746,2260,3006,1634,602,849,1308,7921
9064,2018-3-21,Denver Nuggets,71,17165,2882,6141,0.469,806,2184,0.369,2076,3957,0.525,1204,1575,0.764,786,2361,3147,1763,563,1033,1318,7774
9065,2018-3-21,Los Angeles Clippers,70,16825,2809,5981,0.47,686,1954,0.351,2123,4027,0.527,1346,1781,0.756,694,2381,3075,1559,543,983,1409,7650
9066,2018-3-21,Los Angeles Lakers,70,16975,2875,6234,0.461,695,2016,0.345,2180,4218,0.517,1139,1611,0.707,765,2478,3243,1668,559,1077,1494,7584
9067,2018-3-21,Philadelphia 76ers,69,16660,2753,5895,0.467,742,2020,0.367,2011,3875,0.519,1210,1596,0.758,765,2465,3230,1796,555,1123,1539,7458
9068,2018-3-21,Washington Wizards,70,16975,2811,5994,0.469,689,1841,0.374,2122,4153,0.511,1214,1568,0.774,701,2311,3012,1741,556,974,1504,7525
9069,2018-3-21,Oklahoma City Thunder,73,17645,2922,6414,0.456,772,2183,0.354,2150,4231,0.508,1218,1713,0.711,905,2368,3273,1562,654,989,1467,7834
9070,2018-3-21,Charlotte Hornets,71,17115,2745,6154,0.446,700,1913,0.366,2045,4241,0.482,1407,1904,0.739,707,2478,3185,1512,497,861,1252,7597
9071,2018-3-21,Brooklyn Nets,71,17190,2703,6168,0.438,877,2493,0.352,1826,3675,0.497,1261,1621,0.778,718,2461,3179,1648,435,1022,1462,7544
9072,2018-3-21,Portland Trail Blazers,71,17115,2786,6145,0.453,746,1964,0.38,2040,4181,0.488,1215,1517,0.801,707,2515,3222,1379,484,930,1376,7533
9073,2018-3-21,Indiana Pacers,71,17090,2896,6104,0.474,642,1734,0.37,2254,4370,0.516,1080,1390,0.777,668,2333,3001,1565,619,920,1339,7514
9074,2018-3-21,Milwaukee Bucks,70,16900,2741,5733,0.478,610,1720,0.355,2131,4013,0.531,1303,1672,0.779,575,2193,2768,1587,604,928,1511,7395
9075,2018-3-21,Orlando Magic,71,17090,2777,6069,0.458,742,2069,0.359,2035,4000,0.509,1116,1464,0.762,615,2302,2917,1655,541,1011,1393,7412
9076,2018-3-21,New York Knicks,71,17165,2876,6193,0.464,560,1601,0.35,2316,4592,0.504,1097,1395,0.786,751,2394,3145,1628,484,1026,1454,7409
9077,2018-3-21,Boston Celtics,71,17165,2725,6064,0.449,831,2226,0.373,1894,3838,0.493,1122,1462,0.767,659,2506,3165,1593,508,939,1431,7403
9078,2018-3-21,Phoenix Suns,72,17305,2764,6283,0.44,666,1986,0.335,2098,4297,0.488,1307,1755,0.745,757,2420,3177,1517,486,1088,1619,7501
9079,2018-3-21,Atlanta Hawks,71,17065,2711,6054,0.448,789,2166,0.364,1922,3888,0.494,1170,1471,0.795,658,2277,2935,1684,565,1073,1421,7381
9080,2018-3-21,Chicago Bulls,70,16975,2719,6220,0.437,766,2158,0.355,1953,4062,0.481,1041,1365,0.763,660,2470,3130,1650,518,906,1351,7245
9081,2018-3-21,Miami Heat,71,17215,2743,6022,0.455,790,2188,0.361,1953,3834,0.509,1046,1397,0.749,662,2410,3072,1602,534,974,1429,7322
9082,2018-3-21,Utah Jazz,71,17090,2678,5869,0.456,762,2094,0.364,1916,3775,0.508,1193,1517,0.786,634,2428,3062,1544,619,998,1387,7311
9083,2018-3-21,Detroit Pistons,71,17115,2753,6154,0.447,753,2018,0.373,2000,4136,0.484,1044,1397,0.747,722,2350,3072,1592,544,923,1321,7303
9084,2018-3-21,Dallas Mavericks,71,17140,2713,6072,0.447,828,2280,0.363,1885,3792,0.497,1036,1345,0.77,576,2338,2914,1614,504,841,1377,7290
9085,2018-3-21,San Antonio Spurs,71,17040,2763,6044,0.457,611,1728,0.354,2152,4316,0.499,1119,1441,0.777,722,2423,3145,1630,533,914,1204,7256
9086,2018-3-21,Sacramento Kings,72,17355,2803,6203,0.452,655,1719,0.381,2148,4484,0.479,896,1219,0.735,680,2244,2924,1546,582,955,1433,7157
9087,2018-3-21,Memphis Grizzlies,70,16825,2547,5754,0.443,644,1840,0.35,1903,3914,0.486,1191,1508,0.79,660,2185,2845,1500,519,1004,1657,6929
9088,2018-3-22,Golden State Warriors,71,17090,3060,6031,0.507,821,2091,0.393,2239,3940,0.568,1216,1496,0.813,594,2517,3111,2116,572,1082,1409,8157
9089,2018-3-22,Houston Rockets,71,17090,2767,5970,0.463,1095,2981,0.367,1672,2989,0.559,1441,1833,0.786,653,2425,3078,1541,605,937,1409,8070
9090,2018-3-22,Toronto Raptors,72,17405,2972,6292,0.472,849,2364,0.359,2123,3928,0.54,1305,1629,0.801,711,2434,3145,1732,569,918,1566,8098
9091,2018-3-22,New Orleans Pelicans,72,17555,3051,6329,0.482,740,2035,0.364,2311,4294,0.538,1185,1539,0.77,619,2552,3171,1903,552,1044,1384,8027
9092,2018-3-22,Cleveland Cavaliers,71,17090,2864,5995,0.478,858,2315,0.371,2006,3680,0.545,1280,1639,0.781,587,2382,2969,1676,496,958,1344,7866
9093,2018-3-22,Minnesota Timberwolves,72,17380,2973,6183,0.481,575,1598,0.36,2398,4585,0.523,1400,1741,0.804,746,2260,3006,1634,602,849,1308,7921
9094,2018-3-22,Denver Nuggets,72,17405,2933,6224,0.471,826,2219,0.372,2107,4005,0.526,1217,1591,0.765,794,2398,3192,1797,572,1050,1331,7909
9095,2018-3-22,Los Angeles Clippers,71,17065,2854,6067,0.47,701,1984,0.353,2153,4083,0.527,1368,1810,0.756,710,2412,3122,1585,555,1002,1425,7777
9096,2018-3-22,Los Angeles Lakers,70,16975,2875,6234,0.461,695,2016,0.345,2180,4218,0.517,1139,1611,0.707,765,2478,3243,1668,559,1077,1494,7584
9097,2018-3-22,Philadelphia 76ers,70,16900,2799,5979,0.468,753,2051,0.367,2046,3928,0.521,1226,1616,0.759,769,2499,3268,1828,563,1137,1560,7577
9098,2018-3-22,Washington Wizards,71,17215,2846,6077,0.468,697,1866,0.374,2149,4211,0.51,1226,1584,0.774,710,2337,3047,1768,567,986,1520,7615
9099,2018-3-22,Oklahoma City Thunder,73,17645,2922,6414,0.456,772,2183,0.354,2150,4231,0.508,1218,1713,0.711,905,2368,3273,1562,654,989,1467,7834
9100,2018-3-22,Charlotte Hornets,72,17355,2781,6248,0.445,703,1929,0.364,2078,4319,0.481,1443,1951,0.74,730,2523,3253,1530,500,874,1268,7708
9101,2018-3-22,Brooklyn Nets,72,17430,2742,6261,0.438,890,2530,0.352,1852,3731,0.496,1275,1642,0.776,728,2497,3225,1670,441,1034,1498,7649
9102,2018-3-22,Portland Trail Blazers,71,17115,2786,6145,0.453,746,1964,0.38,2040,4181,0.488,1215,1517,0.801,707,2515,3222,1379,484,930,1376,7533
9103,2018-3-22,Milwaukee Bucks,71,17140,2791,5824,0.479,618,1746,0.354,2173,4078,0.533,1315,1689,0.779,583,2218,2801,1620,614,942,1531,7515
9104,2018-3-22,Indiana Pacers,72,17330,2930,6197,0.473,649,1756,0.37,2281,4441,0.514,1097,1408,0.779,683,2366,3049,1580,632,934,1360,7606
9105,2018-3-22,Orlando Magic,71,17090,2777,6069,0.458,742,2069,0.359,2035,4000,0.509,1116,1464,0.762,615,2302,2917,1655,541,1011,1393,7412
9106,2018-3-22,Boston Celtics,71,17165,2725,6064,0.449,831,2226,0.373,1894,3838,0.493,1122,1462,0.767,659,2506,3165,1593,508,939,1431,7403
9107,2018-3-22,New York Knicks,72,17405,2915,6282,0.464,570,1632,0.349,2345,4650,0.504,1107,1407,0.787,764,2421,3185,1649,490,1040,1470,7507
9108,2018-3-22,Phoenix Suns,72,17305,2764,6283,0.44,666,1986,0.335,2098,4297,0.488,1307,1755,0.745,757,2420,3177,1517,486,1088,1619,7501
9109,2018-3-22,Atlanta Hawks,71,17065,2711,6054,0.448,789,2166,0.364,1922,3888,0.494,1170,1471,0.795,658,2277,2935,1684,565,1073,1421,7381
9110,2018-3-22,Chicago Bulls,71,17215,2758,6309,0.437,779,2196,0.355,1979,4113,0.481,1052,1379,0.763,669,2495,3164,1679,530,921,1373,7347
9111,2018-3-22,Miami Heat,72,17455,2788,6103,0.457,805,2222,0.362,1983,3881,0.511,1060,1416,0.749,667,2437,3104,1633,543,981,1446,7441
9112,2018-3-22,Utah Jazz,71,17090,2678,5869,0.456,762,2094,0.364,1916,3775,0.508,1193,1517,0.786,634,2428,3062,1544,619,998,1387,7311
9113,2018-3-22,Detroit Pistons,71,17115,2753,6154,0.447,753,2018,0.373,2000,4136,0.484,1044,1397,0.747,722,2350,3072,1592,544,923,1321,7303
9114,2018-3-22,Dallas Mavericks,71,17140,2713,6072,0.447,828,2280,0.363,1885,3792,0.497,1036,1345,0.77,576,2338,2914,1614,504,841,1377,7290
9115,2018-3-22,San Antonio Spurs,72,17280,2802,6123,0.458,618,1751,0.353,2184,4372,0.5,1132,1459,0.776,734,2453,3187,1651,540,929,1221,7354
9116,2018-3-22,Sacramento Kings,72,17355,2803,6203,0.452,655,1719,0.381,2148,4484,0.479,896,1219,0.735,680,2244,2924,1546,582,955,1433,7157
9117,2018-3-22,Memphis Grizzlies,71,17065,2587,5853,0.442,653,1867,0.35,1934,3986,0.485,1207,1528,0.79,675,2217,2892,1525,525,1017,1677,7034
9118,2018-3-23,Golden State Warriors,71,17090,3060,6031,0.507,821,2091,0.393,2239,3940,0.568,1216,1496,0.813,594,2517,3111,2116,572,1082,1409,8157
9119,2018-3-23,Houston Rockets,72,17355,2802,6069,0.462,1107,3032,0.365,1695,3037,0.558,1459,1861,0.784,665,2465,3130,1560,614,949,1428,8170
9120,2018-3-23,Toronto Raptors,72,17405,2972,6292,0.472,849,2364,0.359,2123,3928,0.54,1305,1629,0.801,711,2434,3145,1732,569,918,1566,8098
9121,2018-3-23,New Orleans Pelicans,73,17795,3103,6424,0.483,746,2059,0.362,2357,4365,0.54,1203,1561,0.771,627,2586,3213,1931,565,1053,1403,8155
9122,2018-3-23,Cleveland Cavaliers,71,17090,2864,5995,0.478,858,2315,0.371,2006,3680,0.545,1280,1639,0.781,587,2382,2969,1676,496,958,1344,7866
9123,2018-3-23,Minnesota Timberwolves,72,17380,2973,6183,0.481,575,1598,0.36,2398,4585,0.523,1400,1741,0.804,746,2260,3006,1634,602,849,1308,7921
9124,2018-3-23,Denver Nuggets,72,17405,2933,6224,0.471,826,2219,0.372,2107,4005,0.526,1217,1591,0.765,794,2398,3192,1797,572,1050,1331,7909
9125,2018-3-23,Los Angeles Clippers,71,17065,2854,6067,0.47,701,1984,0.353,2153,4083,0.527,1368,1810,0.756,710,2412,3122,1585,555,1002,1425,7777
9126,2018-3-23,Los Angeles Lakers,71,17215,2918,6321,0.462,712,2055,0.346,2206,4266,0.517,1161,1639,0.708,772,2511,3283,1687,563,1093,1514,7709
9127,2018-3-23,Philadelphia 76ers,71,17140,2841,6068,0.468,768,2088,0.368,2073,3980,0.521,1245,1640,0.759,780,2544,3324,1858,570,1153,1575,7695
9128,2018-3-23,Charlotte Hornets,73,17595,2830,6340,0.446,722,1969,0.367,2108,4371,0.482,1466,1978,0.741,741,2565,3306,1555,510,882,1285,7848
9129,2018-3-23,Washington Wizards,71,17215,2846,6077,0.468,697,1866,0.374,2149,4211,0.51,1226,1584,0.774,710,2337,3047,1768,567,986,1520,7615
9130,2018-3-23,Oklahoma City Thunder,73,17645,2922,6414,0.456,772,2183,0.354,2150,4231,0.508,1218,1713,0.711,905,2368,3273,1562,654,989,1467,7834
9131,2018-3-23,Brooklyn Nets,72,17430,2742,6261,0.438,890,2530,0.352,1852,3731,0.496,1275,1642,0.776,728,2497,3225,1670,441,1034,1498,7649
9132,2018-3-23,Portland Trail Blazers,71,17115,2786,6145,0.453,746,1964,0.38,2040,4181,0.488,1215,1517,0.801,707,2515,3222,1379,484,930,1376,7533
9133,2018-3-23,Milwaukee Bucks,71,17140,2791,5824,0.479,618,1746,0.354,2173,4078,0.533,1315,1689,0.779,583,2218,2801,1620,614,942,1531,7515
9134,2018-3-23,Indiana Pacers,72,17330,2930,6197,0.473,649,1756,0.37,2281,4441,0.514,1097,1408,0.779,683,2366,3049,1580,632,934,1360,7606
9135,2018-3-23,Orlando Magic,72,17330,2814,6160,0.457,752,2102,0.358,2062,4058,0.508,1130,1486,0.76,622,2335,2957,1681,551,1021,1412,7510
9136,2018-3-23,Boston Celtics,71,17165,2725,6064,0.449,831,2226,0.373,1894,3838,0.493,1122,1462,0.767,659,2506,3165,1593,508,939,1431,7403
9137,2018-3-23,New York Knicks,72,17405,2915,6282,0.464,570,1632,0.349,2345,4650,0.504,1107,1407,0.787,764,2421,3185,1649,490,1040,1470,7507
9138,2018-3-23,Phoenix Suns,72,17305,2764,6283,0.44,666,1986,0.335,2098,4297,0.488,1307,1755,0.745,757,2420,3177,1517,486,1088,1619,7501
9139,2018-3-23,Atlanta Hawks,72,17305,2744,6138,0.447,801,2202,0.364,1943,3936,0.494,1182,1489,0.794,664,2311,2975,1703,572,1085,1431,7471
9140,2018-3-23,Chicago Bulls,71,17215,2758,6309,0.437,779,2196,0.355,1979,4113,0.481,1052,1379,0.763,669,2495,3164,1679,530,921,1373,7347
9141,2018-3-23,Miami Heat,72,17455,2788,6103,0.457,805,2222,0.362,1983,3881,0.511,1060,1416,0.749,667,2437,3104,1633,543,981,1446,7441
9142,2018-3-23,Utah Jazz,72,17330,2724,5956,0.457,774,2123,0.365,1950,3833,0.509,1208,1533,0.788,642,2459,3101,1576,630,1009,1406,7430
9143,2018-3-23,Detroit Pistons,72,17380,2793,6249,0.447,759,2056,0.369,2034,4193,0.485,1054,1416,0.744,738,2400,3138,1614,553,938,1338,7399
9144,2018-3-23,Dallas Mavericks,72,17380,2755,6157,0.447,845,2312,0.365,1910,3845,0.497,1047,1359,0.77,584,2365,2949,1636,509,855,1393,7402
9145,2018-3-23,San Antonio Spurs,72,17280,2802,6123,0.458,618,1751,0.353,2184,4372,0.5,1132,1459,0.776,734,2453,3187,1651,540,929,1221,7354
9146,2018-3-23,Sacramento Kings,73,17595,2846,6296,0.452,665,1740,0.382,2181,4556,0.479,905,1228,0.737,692,2283,2975,1574,590,968,1451,7262
9147,2018-3-23,Memphis Grizzlies,72,17305,2617,5931,0.441,657,1885,0.349,1960,4046,0.484,1222,1549,0.789,684,2246,2930,1538,529,1036,1701,7113
9148,2018-3-24,Golden State Warriors,72,17330,3102,6124,0.507,833,2121,0.393,2269,4003,0.567,1226,1507,0.814,604,2553,3157,2144,580,1089,1426,8263
9149,2018-3-24,Houston Rockets,72,17355,2802,6069,0.462,1107,3032,0.365,1695,3037,0.558,1459,1861,0.784,665,2465,3130,1560,614,949,1428,8170
9150,2018-3-24,Toronto Raptors,73,17645,3013,6378,0.472,863,2392,0.361,2150,3986,0.539,1325,1658,0.799,716,2472,3188,1758,574,928,1590,8214
9151,2018-3-24,New Orleans Pelicans,73,17795,3103,6424,0.483,746,2059,0.362,2357,4365,0.54,1203,1561,0.771,627,2586,3213,1931,565,1053,1403,8155
9152,2018-3-24,Cleveland Cavaliers,72,17330,2911,6090,0.478,866,2344,0.369,2045,3746,0.546,1298,1663,0.781,602,2421,3023,1699,505,972,1358,7986
9153,2018-3-24,Minnesota Timberwolves,73,17620,3008,6258,0.481,585,1624,0.36,2423,4634,0.523,1428,1773,0.805,752,2299,3051,1657,608,863,1323,8029
9154,2018-3-24,Denver Nuggets,73,17645,2970,6309,0.471,843,2253,0.374,2127,4056,0.524,1234,1609,0.767,801,2429,3230,1822,577,1060,1347,8017
9155,2018-3-24,Los Angeles Clippers,72,17305,2896,6143,0.471,711,2010,0.354,2185,4133,0.529,1378,1824,0.755,715,2439,3154,1609,559,1016,1445,7881
9156,2018-3-24,Los Angeles Lakers,71,17215,2918,6321,0.462,712,2055,0.346,2206,4266,0.517,1161,1639,0.708,772,2511,3283,1687,563,1093,1514,7709
9157,2018-3-24,Philadelphia 76ers,71,17140,2841,6068,0.468,768,2088,0.368,2073,3980,0.521,1245,1640,0.759,780,2544,3324,1858,570,1153,1575,7695
9158,2018-3-24,Charlotte Hornets,73,17595,2830,6340,0.446,722,1969,0.367,2108,4371,0.482,1466,1978,0.741,741,2565,3306,1555,510,882,1285,7848
9159,2018-3-24,Oklahoma City Thunder,74,17885,2958,6498,0.455,780,2209,0.353,2178,4289,0.508,1243,1746,0.712,917,2407,3324,1579,661,1000,1490,7939
9160,2018-3-24,Washington Wizards,72,17455,2884,6157,0.468,711,1894,0.375,2173,4263,0.51,1236,1598,0.773,718,2375,3093,1796,570,1003,1541,7715
9161,2018-3-24,Brooklyn Nets,73,17670,2783,6345,0.439,901,2557,0.352,1882,3788,0.497,1294,1673,0.773,733,2532,3265,1691,446,1043,1521,7761
9162,2018-3-24,Milwaukee Bucks,72,17380,2834,5911,0.479,633,1776,0.356,2201,4135,0.532,1332,1708,0.78,590,2247,2837,1647,622,947,1551,7633
9163,2018-3-24,Portland Trail Blazers,72,17355,2826,6236,0.453,754,1997,0.378,2072,4239,0.489,1227,1532,0.801,718,2547,3265,1395,492,938,1396,7633
9164,2018-3-24,Indiana Pacers,73,17570,2973,6290,0.473,660,1787,0.369,2313,4503,0.514,1109,1422,0.78,697,2394,3091,1605,638,943,1376,7715
9165,2018-3-24,Orlando Magic,72,17330,2814,6160,0.457,752,2102,0.358,2062,4058,0.508,1130,1486,0.76,622,2335,2957,1681,551,1021,1412,7510
9166,2018-3-24,Boston Celtics,72,17405,2760,6141,0.449,842,2244,0.375,1918,3897,0.492,1146,1488,0.77,668,2542,3210,1615,513,952,1449,7508
9167,2018-3-24,New York Knicks,73,17645,2955,6374,0.464,582,1660,0.351,2373,4714,0.503,1119,1424,0.786,774,2453,3227,1674,499,1050,1497,7611
9168,2018-3-24,Phoenix Suns,73,17545,2802,6370,0.44,673,2014,0.334,2129,4356,0.489,1319,1775,0.743,764,2449,3213,1541,495,1105,1642,7596
9169,2018-3-24,Atlanta Hawks,73,17545,2781,6222,0.447,812,2234,0.363,1969,3988,0.494,1191,1509,0.789,669,2350,3019,1727,577,1096,1445,7565
9170,2018-3-24,Chicago Bulls,72,17455,2794,6396,0.437,791,2222,0.356,2003,4174,0.48,1073,1402,0.765,686,2529,3215,1700,533,935,1394,7452
9171,2018-3-24,Utah Jazz,73,17595,2767,6044,0.458,785,2151,0.365,1982,3893,0.509,1231,1562,0.788,647,2488,3135,1600,640,1024,1429,7550
9172,2018-3-24,Miami Heat,73,17695,2822,6190,0.456,818,2252,0.363,2004,3938,0.509,1078,1436,0.751,675,2470,3145,1655,547,991,1471,7540
9173,2018-3-24,Detroit Pistons,72,17380,2793,6249,0.447,759,2056,0.369,2034,4193,0.485,1054,1416,0.744,738,2400,3138,1614,553,938,1338,7399
9174,2018-3-24,Dallas Mavericks,72,17380,2755,6157,0.447,845,2312,0.365,1910,3845,0.497,1047,1359,0.77,584,2365,2949,1636,509,855,1393,7402
9175,2018-3-24,San Antonio Spurs,73,17545,2849,6215,0.458,625,1768,0.354,2224,4447,0.5,1155,1486,0.777,745,2491,3236,1672,549,942,1246,7478
9176,2018-3-24,Sacramento Kings,73,17595,2846,6296,0.452,665,1740,0.382,2181,4556,0.479,905,1228,0.737,692,2283,2975,1574,590,968,1451,7262
9177,2018-3-24,Memphis Grizzlies,72,17305,2617,5931,0.441,657,1885,0.349,1960,4046,0.484,1222,1549,0.789,684,2246,2930,1538,529,1036,1701,7113
9178,2018-3-25,Golden State Warriors,72,17330,3102,6124,0.507,833,2121,0.393,2269,4003,0.567,1226,1507,0.814,604,2553,3157,2144,580,1089,1426,8263
9179,2018-3-25,Houston Rockets,73,17595,2847,6162,0.462,1125,3079,0.365,1722,3083,0.559,1465,1869,0.784,670,2508,3178,1582,624,968,1445,8284
9180,2018-3-25,Toronto Raptors,73,17645,3013,6378,0.472,863,2392,0.361,2150,3986,0.539,1325,1658,0.799,716,2472,3188,1758,574,928,1590,8214
9181,2018-3-25,New Orleans Pelicans,74,18035,3141,6520,0.482,752,2080,0.362,2389,4440,0.538,1212,1573,0.771,639,2620,3259,1950,575,1069,1417,8246
9182,2018-3-25,Cleveland Cavaliers,72,17330,2911,6090,0.478,866,2344,0.369,2045,3746,0.546,1298,1663,0.781,602,2421,3023,1699,505,972,1358,7986
9183,2018-3-25,Minnesota Timberwolves,74,17860,3045,6354,0.479,591,1647,0.359,2454,4707,0.521,1456,1811,0.804,765,2339,3104,1676,615,877,1350,8137
9184,2018-3-25,Denver Nuggets,73,17645,2970,6309,0.471,843,2253,0.374,2127,4056,0.524,1234,1609,0.767,801,2429,3230,1822,577,1060,1347,8017
9185,2018-3-25,Los Angeles Clippers,72,17305,2896,6143,0.471,711,2010,0.354,2185,4133,0.529,1378,1824,0.755,715,2439,3154,1609,559,1016,1445,7881
9186,2018-3-25,Los Angeles Lakers,72,17455,2953,6407,0.461,725,2093,0.346,2228,4314,0.516,1178,1664,0.708,783,2544,3327,1706,570,1104,1534,7809
9187,2018-3-25,Philadelphia 76ers,72,17380,2883,6156,0.468,781,2125,0.368,2102,4031,0.521,1268,1676,0.757,787,2588,3375,1891,579,1168,1604,7815
9188,2018-3-25,Charlotte Hornets,74,17835,2865,6432,0.445,734,1994,0.368,2131,4438,0.48,1486,2007,0.74,754,2614,3368,1576,520,895,1299,7950
9189,2018-3-25,Oklahoma City Thunder,74,17885,2958,6498,0.455,780,2209,0.353,2178,4289,0.508,1243,1746,0.712,917,2407,3324,1579,661,1000,1490,7939
9190,2018-3-25,Washington Wizards,72,17455,2884,6157,0.468,711,1894,0.375,2173,4263,0.51,1236,1598,0.773,718,2375,3093,1796,570,1003,1541,7715
9191,2018-3-25,Brooklyn Nets,73,17670,2783,6345,0.439,901,2557,0.352,1882,3788,0.497,1294,1673,0.773,733,2532,3265,1691,446,1043,1521,7761
9192,2018-3-25,Milwaukee Bucks,72,17380,2834,5911,0.479,633,1776,0.356,2201,4135,0.532,1332,1708,0.78,590,2247,2837,1647,622,947,1551,7633
9193,2018-3-25,Portland Trail Blazers,72,17355,2826,6236,0.453,754,1997,0.378,2072,4239,0.489,1227,1532,0.801,718,2547,3265,1395,492,938,1396,7633
9194,2018-3-25,Indiana Pacers,73,17570,2973,6290,0.473,660,1787,0.369,2313,4503,0.514,1109,1422,0.78,697,2394,3091,1605,638,943,1376,7715
9195,2018-3-25,Orlando Magic,73,17570,2851,6244,0.457,763,2132,0.358,2088,4112,0.508,1150,1513,0.76,636,2375,3011,1710,560,1040,1430,7615
9196,2018-3-25,Boston Celtics,72,17405,2760,6141,0.449,842,2244,0.375,1918,3897,0.492,1146,1488,0.77,668,2542,3210,1615,513,952,1449,7508
9197,2018-3-25,New York Knicks,73,17645,2955,6374,0.464,582,1660,0.351,2373,4714,0.503,1119,1424,0.786,774,2453,3227,1674,499,1050,1497,7611
9198,2018-3-25,Phoenix Suns,74,17785,2838,6459,0.439,680,2043,0.333,2158,4416,0.489,1339,1801,0.743,774,2480,3254,1562,509,1119,1664,7695
9199,2018-3-25,Atlanta Hawks,73,17545,2781,6222,0.447,812,2234,0.363,1969,3988,0.494,1191,1509,0.789,669,2350,3019,1727,577,1096,1445,7565
9200,2018-3-25,Utah Jazz,73,17595,2767,6044,0.458,785,2151,0.365,1982,3893,0.509,1231,1562,0.788,647,2488,3135,1600,640,1024,1429,7550
9201,2018-3-25,Chicago Bulls,73,17695,2833,6493,0.436,802,2257,0.355,2031,4236,0.479,1079,1411,0.765,700,2559,3259,1727,543,947,1414,7547
9202,2018-3-25,Miami Heat,73,17695,2822,6190,0.456,818,2252,0.363,2004,3938,0.509,1078,1436,0.751,675,2470,3145,1655,547,991,1471,7540
9203,2018-3-25,Detroit Pistons,73,17620,2836,6336,0.448,775,2098,0.369,2061,4238,0.486,1069,1434,0.745,750,2437,3187,1647,559,951,1349,7516
9204,2018-3-25,Dallas Mavericks,73,17620,2791,6248,0.447,857,2353,0.364,1934,3895,0.497,1061,1378,0.77,589,2412,3001,1658,519,867,1415,7500
9205,2018-3-25,San Antonio Spurs,73,17545,2849,6215,0.458,625,1768,0.354,2224,4447,0.5,1155,1486,0.777,745,2491,3236,1672,549,942,1246,7478
9206,2018-3-25,Sacramento Kings,73,17595,2846,6296,0.452,665,1740,0.382,2181,4556,0.479,905,1228,0.737,692,2283,2975,1574,590,968,1451,7262
9207,2018-3-25,Memphis Grizzlies,73,17545,2652,6015,0.441,662,1914,0.346,1990,4101,0.485,1240,1571,0.789,695,2278,2973,1558,536,1046,1722,7206
9208,2018-3-26,Golden State Warriors,73,17570,3140,6215,0.505,839,2136,0.393,2301,4079,0.564,1235,1517,0.814,618,2580,3198,2168,589,1100,1445,8354
9209,2018-3-26,Houston Rockets,74,17835,2891,6252,0.462,1145,3131,0.366,1746,3121,0.559,1475,1880,0.785,676,2547,3223,1610,631,979,1457,8402
9210,2018-3-26,Toronto Raptors,74,17885,3054,6470,0.472,879,2428,0.362,2175,4042,0.538,1333,1672,0.797,729,2507,3236,1782,577,942,1613,8320
9211,2018-3-26,New Orleans Pelicans,74,18035,3141,6520,0.482,752,2080,0.362,2389,4440,0.538,1212,1573,0.771,639,2620,3259,1950,575,1069,1417,8246
9212,2018-3-26,Cleveland Cavaliers,73,17570,2955,6177,0.478,878,2372,0.37,2077,3805,0.546,1319,1689,0.781,613,2459,3072,1724,510,983,1379,8107
9213,2018-3-26,Minnesota Timberwolves,74,17860,3045,6354,0.479,591,1647,0.359,2454,4707,0.521,1456,1811,0.804,765,2339,3104,1676,615,877,1350,8137
9214,2018-3-26,Denver Nuggets,73,17645,2970,6309,0.471,843,2253,0.374,2127,4056,0.524,1234,1609,0.767,801,2429,3230,1822,577,1060,1347,8017
9215,2018-3-26,Los Angeles Clippers,73,17545,2940,6238,0.471,719,2028,0.355,2221,4210,0.528,1399,1851,0.756,727,2471,3198,1626,566,1024,1461,7998
9216,2018-3-26,Los Angeles Lakers,72,17455,2953,6407,0.461,725,2093,0.346,2228,4314,0.516,1178,1664,0.708,783,2544,3327,1706,570,1104,1534,7809
9217,2018-3-26,Philadelphia 76ers,72,17380,2883,6156,0.468,781,2125,0.368,2102,4031,0.521,1268,1676,0.757,787,2588,3375,1891,579,1168,1604,7815
9218,2018-3-26,Charlotte Hornets,74,17835,2865,6432,0.445,734,1994,0.368,2131,4438,0.48,1486,2007,0.74,754,2614,3368,1576,520,895,1299,7950
9219,2018-3-26,Oklahoma City Thunder,75,18125,2995,6582,0.455,788,2236,0.352,2207,4346,0.508,1266,1774,0.714,930,2433,3363,1595,670,1010,1509,8044
9220,2018-3-26,Washington Wizards,73,17695,2921,6244,0.468,717,1913,0.375,2204,4331,0.509,1253,1621,0.773,732,2407,3139,1821,580,1017,1557,7812
9221,2018-3-26,Brooklyn Nets,74,17910,2821,6428,0.439,918,2594,0.354,1903,3834,0.496,1315,1699,0.774,740,2563,3303,1718,453,1052,1544,7875
9222,2018-3-26,Milwaukee Bucks,73,17620,2876,5997,0.48,642,1803,0.356,2234,4194,0.533,1345,1726,0.779,599,2275,2874,1674,628,957,1569,7739
9223,2018-3-26,Portland Trail Blazers,73,17595,2868,6326,0.453,763,2031,0.376,2105,4295,0.49,1242,1551,0.801,736,2578,3314,1415,500,951,1415,7741
9224,2018-3-26,Indiana Pacers,74,17835,3017,6380,0.473,668,1810,0.369,2349,4570,0.514,1126,1443,0.78,707,2435,3142,1631,650,960,1393,7828
9225,2018-3-26,Orlando Magic,73,17570,2851,6244,0.457,763,2132,0.358,2088,4112,0.508,1150,1513,0.76,636,2375,3011,1710,560,1040,1430,7615
9226,2018-3-26,Boston Celtics,73,17645,2800,6213,0.451,854,2266,0.377,1946,3947,0.493,1158,1505,0.769,671,2574,3245,1638,522,967,1460,7612
9227,2018-3-26,New York Knicks,74,17885,2996,6462,0.464,588,1682,0.35,2408,4780,0.504,1132,1439,0.787,784,2487,3271,1700,509,1064,1516,7712
9228,2018-3-26,Phoenix Suns,74,17785,2838,6459,0.439,680,2043,0.333,2158,4416,0.489,1339,1801,0.743,774,2480,3254,1562,509,1119,1664,7695
9229,2018-3-26,Atlanta Hawks,74,17785,2820,6310,0.447,823,2274,0.362,1997,4036,0.495,1201,1520,0.79,676,2388,3064,1745,582,1109,1459,7664
9230,2018-3-26,Utah Jazz,74,17835,2809,6131,0.458,797,2179,0.366,2012,3952,0.509,1245,1580,0.788,658,2524,3182,1627,646,1038,1445,7660
9231,2018-3-26,Chicago Bulls,73,17695,2833,6493,0.436,802,2257,0.355,2031,4236,0.479,1079,1411,0.765,700,2559,3259,1727,543,947,1414,7547
9232,2018-3-26,Miami Heat,74,17960,2863,6276,0.456,832,2287,0.364,2031,3989,0.509,1089,1450,0.751,682,2502,3184,1687,557,1008,1491,7647
9233,2018-3-26,Detroit Pistons,73,17620,2836,6336,0.448,775,2098,0.369,2061,4238,0.486,1069,1434,0.745,750,2437,3187,1647,559,951,1349,7516
9234,2018-3-26,Dallas Mavericks,73,17620,2791,6248,0.447,857,2353,0.364,1934,3895,0.497,1061,1378,0.77,589,2412,3001,1658,519,867,1415,7500
9235,2018-3-26,San Antonio Spurs,74,17785,2890,6307,0.458,629,1785,0.352,2261,4522,0.5,1172,1507,0.778,765,2524,3289,1688,553,954,1263,7581
9236,2018-3-26,Sacramento Kings,74,17835,2884,6378,0.452,672,1766,0.381,2212,4612,0.48,915,1238,0.739,699,2310,3009,1592,597,982,1467,7355
9237,2018-3-26,Memphis Grizzlies,73,17545,2652,6015,0.441,662,1914,0.346,1990,4101,0.485,1240,1571,0.789,695,2278,2973,1558,536,1046,1722,7206
9238,2018-3-27,Golden State Warriors,73,17570,3140,6215,0.505,839,2136,0.393,2301,4079,0.564,1235,1517,0.814,618,2580,3198,2168,589,1100,1445,8354
9239,2018-3-27,Houston Rockets,74,17835,2891,6252,0.462,1145,3131,0.366,1746,3121,0.559,1475,1880,0.785,676,2547,3223,1610,631,979,1457,8402
9240,2018-3-27,Toronto Raptors,74,17885,3054,6470,0.472,879,2428,0.362,2175,4042,0.538,1333,1672,0.797,729,2507,3236,1782,577,942,1613,8320
9241,2018-3-27,New Orleans Pelicans,74,18035,3141,6520,0.482,752,2080,0.362,2389,4440,0.538,1212,1573,0.771,639,2620,3259,1950,575,1069,1417,8246
9242,2018-3-27,Cleveland Cavaliers,73,17570,2955,6177,0.478,878,2372,0.37,2077,3805,0.546,1319,1689,0.781,613,2459,3072,1724,510,983,1379,8107
9243,2018-3-27,Denver Nuggets,74,17885,3006,6393,0.47,854,2285,0.374,2152,4108,0.524,1255,1643,0.764,810,2457,3267,1849,587,1075,1368,8121
9244,2018-3-27,Minnesota Timberwolves,75,18100,3078,6433,0.478,599,1671,0.358,2479,4762,0.521,1475,1835,0.804,772,2369,3141,1697,622,891,1365,8230
9245,2018-3-27,Los Angeles Clippers,73,17545,2940,6238,0.471,719,2028,0.355,2221,4210,0.528,1399,1851,0.756,727,2471,3198,1626,566,1024,1461,7998
9246,2018-3-27,Philadelphia 76ers,73,17620,2929,6247,0.469,794,2154,0.369,2135,4093,0.522,1286,1701,0.756,801,2627,3428,1926,585,1185,1632,7938
9247,2018-3-27,Los Angeles Lakers,73,17695,2993,6492,0.461,731,2116,0.345,2262,4376,0.517,1198,1689,0.709,789,2585,3374,1735,573,1114,1554,7915
9248,2018-3-27,Charlotte Hornets,75,18100,2916,6525,0.447,745,2022,0.368,2171,4503,0.482,1510,2035,0.742,765,2646,3411,1601,525,909,1311,8087
9249,2018-3-27,Oklahoma City Thunder,75,18125,2995,6582,0.455,788,2236,0.352,2207,4346,0.508,1266,1774,0.714,930,2433,3363,1595,670,1010,1509,8044
9250,2018-3-27,Washington Wizards,73,17695,2921,6244,0.468,717,1913,0.375,2204,4331,0.509,1253,1621,0.773,732,2407,3139,1821,580,1017,1557,7812
9251,2018-3-27,Brooklyn Nets,74,17910,2821,6428,0.439,918,2594,0.354,1903,3834,0.496,1315,1699,0.774,740,2563,3303,1718,453,1052,1544,7875
9252,2018-3-27,Milwaukee Bucks,73,17620,2876,5997,0.48,642,1803,0.356,2234,4194,0.533,1345,1726,0.779,599,2275,2874,1674,628,957,1569,7739
9253,2018-3-27,Portland Trail Blazers,73,17595,2868,6326,0.453,763,2031,0.376,2105,4295,0.49,1242,1551,0.801,736,2578,3314,1415,500,951,1415,7741
9254,2018-3-27,Indiana Pacers,74,17835,3017,6380,0.473,668,1810,0.369,2349,4570,0.514,1126,1443,0.78,707,2435,3142,1631,650,960,1393,7828
9255,2018-3-27,New York Knicks,75,18150,3050,6567,0.464,597,1712,0.349,2453,4855,0.505,1143,1450,0.788,795,2517,3312,1725,515,1074,1543,7840
9256,2018-3-27,Orlando Magic,73,17570,2851,6244,0.457,763,2132,0.358,2088,4112,0.508,1150,1513,0.76,636,2375,3011,1710,560,1040,1430,7615
9257,2018-3-27,Boston Celtics,74,17885,2837,6300,0.45,868,2295,0.378,1969,4005,0.492,1172,1519,0.772,681,2608,3289,1662,532,979,1479,7714
9258,2018-3-27,Phoenix Suns,75,18025,2874,6540,0.439,692,2078,0.333,2182,4462,0.489,1349,1820,0.741,785,2516,3301,1580,517,1134,1682,7789
9259,2018-3-27,Atlanta Hawks,74,17785,2820,6310,0.447,823,2274,0.362,1997,4036,0.495,1201,1520,0.79,676,2388,3064,1745,582,1109,1459,7664
9260,2018-3-27,Utah Jazz,74,17835,2809,6131,0.458,797,2179,0.366,2012,3952,0.509,1245,1580,0.788,658,2524,3182,1627,646,1038,1445,7660
9261,2018-3-27,Chicago Bulls,73,17695,2833,6493,0.436,802,2257,0.355,2031,4236,0.479,1079,1411,0.765,700,2559,3259,1727,543,947,1414,7547
9262,2018-3-27,Miami Heat,74,17960,2863,6276,0.456,832,2287,0.364,2031,3989,0.509,1089,1450,0.751,682,2502,3184,1687,557,1008,1491,7647
9263,2018-3-27,Detroit Pistons,74,17860,2880,6436,0.447,788,2131,0.37,2092,4305,0.486,1080,1449,0.745,760,2477,3237,1668,563,958,1375,7628
9264,2018-3-27,Dallas Mavericks,73,17620,2791,6248,0.447,857,2353,0.364,1934,3895,0.497,1061,1378,0.77,589,2412,3001,1658,519,867,1415,7500
9265,2018-3-27,San Antonio Spurs,74,17785,2890,6307,0.458,629,1785,0.352,2261,4522,0.5,1172,1507,0.778,765,2524,3289,1688,553,954,1263,7581
9266,2018-3-27,Sacramento Kings,74,17835,2884,6378,0.452,672,1766,0.381,2212,4612,0.48,915,1238,0.739,699,2310,3009,1592,597,982,1467,7355
9267,2018-3-27,Memphis Grizzlies,74,17785,2692,6099,0.441,677,1945,0.348,2015,4154,0.485,1246,1580,0.789,702,2306,3008,1583,544,1059,1745,7307
9268,2018-3-28,Golden State Warriors,74,17810,3175,6301,0.504,844,2153,0.392,2331,4148,0.562,1241,1526,0.813,635,2614,3249,2189,593,1116,1462,8435
9269,2018-3-28,Houston Rockets,75,18075,2932,6345,0.462,1163,3188,0.365,1769,3157,0.56,1493,1901,0.785,685,2584,3269,1638,646,989,1469,8520
9270,2018-3-28,Toronto Raptors,75,18125,3101,6562,0.473,892,2462,0.362,2209,4100,0.539,1340,1681,0.797,738,2535,3273,1815,583,951,1631,8434
9271,2018-3-28,New Orleans Pelicans,75,18275,3184,6614,0.481,756,2104,0.359,2428,4510,0.538,1225,1587,0.772,650,2663,3313,1978,578,1085,1436,8349
9272,2018-3-28,Cleveland Cavaliers,74,17810,2986,6262,0.477,882,2398,0.368,2104,3864,0.545,1332,1708,0.78,625,2489,3114,1739,518,997,1397,8186
9273,2018-3-28,Denver Nuggets,75,18125,3048,6482,0.47,867,2315,0.375,2181,4167,0.523,1268,1657,0.765,820,2487,3307,1875,593,1086,1384,8231
9274,2018-3-28,Minnesota Timberwolves,75,18100,3078,6433,0.478,599,1671,0.358,2479,4762,0.521,1475,1835,0.804,772,2369,3141,1697,622,891,1365,8230
9275,2018-3-28,Los Angeles Clippers,74,17785,2980,6324,0.471,734,2056,0.357,2246,4268,0.526,1409,1869,0.754,735,2504,3239,1649,574,1037,1484,8103
9276,2018-3-28,Philadelphia 76ers,73,17620,2929,6247,0.469,794,2154,0.369,2135,4093,0.522,1286,1701,0.756,801,2627,3428,1926,585,1185,1632,7938
9277,2018-3-28,Los Angeles Lakers,73,17695,2993,6492,0.461,731,2116,0.345,2262,4376,0.517,1198,1689,0.709,789,2585,3374,1735,573,1114,1554,7915
9278,2018-3-28,Charlotte Hornets,75,18100,2916,6525,0.447,745,2022,0.368,2171,4503,0.482,1510,2035,0.742,765,2646,3411,1601,525,909,1311,8087
9279,2018-3-28,Oklahoma City Thunder,75,18125,2995,6582,0.455,788,2236,0.352,2207,4346,0.508,1266,1774,0.714,930,2433,3363,1595,670,1010,1509,8044
9280,2018-3-28,Washington Wizards,74,17935,2967,6329,0.469,727,1937,0.375,2240,4392,0.51,1267,1639,0.773,742,2447,3189,1854,585,1033,1584,7928
9281,2018-3-28,Brooklyn Nets,74,17910,2821,6428,0.439,918,2594,0.354,1903,3834,0.496,1315,1699,0.774,740,2563,3303,1718,453,1052,1544,7875
9282,2018-3-28,Portland Trail Blazers,74,17835,2912,6431,0.453,773,2063,0.375,2139,4368,0.49,1251,1561,0.801,753,2608,3361,1435,511,961,1432,7848
9283,2018-3-28,Milwaukee Bucks,74,17860,2914,6080,0.479,648,1826,0.355,2266,4254,0.533,1361,1749,0.778,607,2311,2918,1698,640,973,1583,7837
9284,2018-3-28,Indiana Pacers,75,18075,3056,6461,0.473,674,1831,0.368,2382,4630,0.514,1134,1455,0.779,715,2465,3180,1653,660,970,1407,7920
9285,2018-3-28,New York Knicks,75,18150,3050,6567,0.464,597,1712,0.349,2453,4855,0.505,1143,1450,0.788,795,2517,3312,1725,515,1074,1543,7840
9286,2018-3-28,Orlando Magic,73,17570,2851,6244,0.457,763,2132,0.358,2088,4112,0.508,1150,1513,0.76,636,2375,3011,1710,560,1040,1430,7615
9287,2018-3-28,Boston Celtics,74,17885,2837,6300,0.45,868,2295,0.378,1969,4005,0.492,1172,1519,0.772,681,2608,3289,1662,532,979,1479,7714
9288,2018-3-28,Phoenix Suns,75,18025,2874,6540,0.439,692,2078,0.333,2182,4462,0.489,1349,1820,0.741,785,2516,3301,1580,517,1134,1682,7789
9289,2018-3-28,Atlanta Hawks,74,17785,2820,6310,0.447,823,2274,0.362,1997,4036,0.495,1201,1520,0.79,676,2388,3064,1745,582,1109,1459,7664
9290,2018-3-28,Utah Jazz,74,17835,2809,6131,0.458,797,2179,0.366,2012,3952,0.509,1245,1580,0.788,658,2524,3182,1627,646,1038,1445,7660
9291,2018-3-28,Miami Heat,75,18200,2900,6354,0.456,841,2316,0.363,2059,4038,0.51,1104,1470,0.751,691,2537,3228,1711,567,1022,1509,7745
9292,2018-3-28,Detroit Pistons,74,17860,2880,6436,0.447,788,2131,0.37,2092,4305,0.486,1080,1449,0.745,760,2477,3237,1668,563,958,1375,7628
9293,2018-3-28,Chicago Bulls,74,17935,2867,6582,0.436,810,2294,0.353,2057,4288,0.48,1089,1428,0.763,713,2597,3310,1744,551,965,1431,7633
9294,2018-3-28,Dallas Mavericks,74,17860,2827,6328,0.447,871,2393,0.364,1956,3935,0.497,1078,1403,0.768,593,2451,3044,1683,526,877,1432,7603
9295,2018-3-28,San Antonio Spurs,75,18025,2929,6394,0.458,639,1810,0.353,2290,4584,0.5,1190,1540,0.773,775,2551,3326,1717,560,962,1280,7687
9296,2018-3-28,Sacramento Kings,75,18075,2922,6471,0.452,678,1789,0.379,2244,4682,0.479,930,1257,0.74,709,2345,3054,1617,603,992,1489,7452
9297,2018-3-28,Memphis Grizzlies,74,17785,2692,6099,0.441,677,1945,0.348,2015,4154,0.485,1246,1580,0.789,702,2306,3008,1583,544,1059,1745,7307
9298,2018-3-29,Golden State Warriors,74,17810,3175,6301,0.504,844,2153,0.392,2331,4148,0.562,1241,1526,0.813,635,2614,3249,2189,593,1116,1462,8435
9299,2018-3-29,Houston Rockets,75,18075,2932,6345,0.462,1163,3188,0.365,1769,3157,0.56,1493,1901,0.785,685,2584,3269,1638,646,989,1469,8520
9300,2018-3-29,Toronto Raptors,75,18125,3101,6562,0.473,892,2462,0.362,2209,4100,0.539,1340,1681,0.797,738,2535,3273,1815,583,951,1631,8434
9301,2018-3-29,New Orleans Pelicans,75,18275,3184,6614,0.481,756,2104,0.359,2428,4510,0.538,1225,1587,0.772,650,2663,3313,1978,578,1085,1436,8349
9302,2018-3-29,Cleveland Cavaliers,75,18050,3031,6355,0.477,893,2426,0.368,2138,3929,0.544,1349,1728,0.781,636,2516,3152,1761,527,1003,1416,8304
9303,2018-3-29,Minnesota Timberwolves,76,18340,3126,6523,0.479,612,1701,0.36,2514,4822,0.521,1492,1856,0.804,779,2399,3178,1730,631,904,1385,8356
9304,2018-3-29,Denver Nuggets,75,18125,3048,6482,0.47,867,2315,0.375,2181,4167,0.523,1268,1657,0.765,820,2487,3307,1875,593,1086,1384,8231
9305,2018-3-29,Los Angeles Clippers,75,18025,3023,6404,0.472,742,2073,0.358,2281,4331,0.527,1426,1894,0.753,746,2544,3290,1675,581,1058,1501,8214
9306,2018-3-29,Philadelphia 76ers,74,17860,2974,6345,0.469,803,2185,0.368,2171,4160,0.522,1305,1728,0.755,815,2671,3486,1960,594,1197,1651,8056
9307,2018-3-29,Los Angeles Lakers,74,17935,3029,6569,0.461,740,2149,0.344,2289,4420,0.518,1220,1721,0.709,796,2627,3423,1760,579,1129,1570,8018
9308,2018-3-29,Charlotte Hornets,76,18340,2955,6601,0.448,750,2043,0.367,2205,4558,0.484,1532,2059,0.744,771,2680,3451,1621,527,922,1327,8192
9309,2018-3-29,Oklahoma City Thunder,75,18125,2995,6582,0.455,788,2236,0.352,2207,4346,0.508,1266,1774,0.714,930,2433,3363,1595,670,1010,1509,8044
9310,2018-3-29,Washington Wizards,74,17935,2967,6329,0.469,727,1937,0.375,2240,4392,0.51,1267,1639,0.773,742,2447,3189,1854,585,1033,1584,7928
9311,2018-3-29,Brooklyn Nets,75,18150,2861,6515,0.439,930,2628,0.354,1931,3887,0.497,1334,1721,0.775,751,2600,3351,1746,459,1060,1561,7986
9312,2018-3-29,Portland Trail Blazers,75,18075,2950,6510,0.453,781,2093,0.373,2169,4417,0.491,1270,1591,0.798,761,2638,3399,1450,518,973,1452,7951
9313,2018-3-29,Milwaukee Bucks,74,17860,2914,6080,0.479,648,1826,0.355,2266,4254,0.533,1361,1749,0.778,607,2311,2918,1698,640,973,1583,7837
9314,2018-3-29,Indiana Pacers,75,18075,3056,6461,0.473,674,1831,0.368,2382,4630,0.514,1134,1455,0.779,715,2465,3180,1653,660,970,1407,7920
9315,2018-3-29,New York Knicks,76,18390,3086,6661,0.463,606,1743,0.348,2480,4918,0.504,1163,1476,0.788,805,2553,3358,1745,519,1090,1565,7941
9316,2018-3-29,Orlando Magic,74,17810,2891,6336,0.456,774,2163,0.358,2117,4173,0.507,1163,1529,0.761,647,2408,3055,1735,564,1049,1448,7719
9317,2018-3-29,Boston Celtics,75,18125,2872,6379,0.45,880,2316,0.38,1992,4063,0.49,1187,1539,0.771,692,2639,3331,1682,543,995,1497,7811
9318,2018-3-29,Phoenix Suns,76,18265,2912,6628,0.439,702,2112,0.332,2210,4516,0.489,1362,1838,0.741,794,2546,3340,1597,530,1148,1702,7888
9319,2018-3-29,Atlanta Hawks,75,18025,2861,6387,0.448,836,2301,0.363,2025,4086,0.496,1220,1543,0.791,680,2421,3101,1771,592,1129,1481,7778
9320,2018-3-29,Utah Jazz,75,18075,2843,6213,0.458,806,2212,0.364,2037,4001,0.509,1262,1601,0.788,670,2557,3227,1652,653,1054,1463,7754
9321,2018-3-29,Miami Heat,75,18200,2900,6354,0.456,841,2316,0.363,2059,4038,0.51,1104,1470,0.751,691,2537,3228,1711,567,1022,1509,7745
9322,2018-3-29,Detroit Pistons,74,17860,2880,6436,0.447,788,2131,0.37,2092,4305,0.486,1080,1449,0.745,760,2477,3237,1668,563,958,1375,7628
9323,2018-3-29,Chicago Bulls,74,17935,2867,6582,0.436,810,2294,0.353,2057,4288,0.48,1089,1428,0.763,713,2597,3310,1744,551,965,1431,7633
9324,2018-3-29,Dallas Mavericks,75,18100,2860,6412,0.446,884,2437,0.363,1976,3975,0.497,1092,1422,0.768,599,2485,3084,1700,536,887,1454,7696
9325,2018-3-29,San Antonio Spurs,75,18025,2929,6394,0.458,639,1810,0.353,2290,4584,0.5,1190,1540,0.773,775,2551,3326,1717,560,962,1280,7687
9326,2018-3-29,Sacramento Kings,75,18075,2922,6471,0.452,678,1789,0.379,2244,4682,0.479,930,1257,0.74,709,2345,3054,1617,603,992,1489,7452
9327,2018-3-29,Memphis Grizzlies,75,18025,2733,6183,0.442,690,1970,0.35,2043,4213,0.485,1259,1603,0.785,713,2341,3054,1606,551,1074,1769,7415
9328,2018-3-30,Golden State Warriors,75,18050,3216,6376,0.504,854,2173,0.393,2362,4203,0.562,1256,1541,0.815,637,2643,3280,2215,603,1134,1481,8542
9329,2018-3-30,Houston Rockets,75,18075,2932,6345,0.462,1163,3188,0.365,1769,3157,0.56,1493,1901,0.785,685,2584,3269,1638,646,989,1469,8520
9330,2018-3-30,Toronto Raptors,75,18125,3101,6562,0.473,892,2462,0.362,2209,4100,0.539,1340,1681,0.797,738,2535,3273,1815,583,951,1631,8434
9331,2018-3-30,New Orleans Pelicans,75,18275,3184,6614,0.481,756,2104,0.359,2428,4510,0.538,1225,1587,0.772,650,2663,3313,1978,578,1085,1436,8349
9332,2018-3-30,Cleveland Cavaliers,75,18050,3031,6355,0.477,893,2426,0.368,2138,3929,0.544,1349,1728,0.781,636,2516,3152,1761,527,1003,1416,8304
9333,2018-3-30,Minnesota Timberwolves,76,18340,3126,6523,0.479,612,1701,0.36,2514,4822,0.521,1492,1856,0.804,779,2399,3178,1730,631,904,1385,8356
9334,2018-3-30,Denver Nuggets,75,18125,3048,6482,0.47,867,2315,0.375,2181,4167,0.523,1268,1657,0.765,820,2487,3307,1875,593,1086,1384,8231
9335,2018-3-30,Los Angeles Clippers,75,18025,3023,6404,0.472,742,2073,0.358,2281,4331,0.527,1426,1894,0.753,746,2544,3290,1675,581,1058,1501,8214
9336,2018-3-30,Philadelphia 76ers,74,17860,2974,6345,0.469,803,2185,0.368,2171,4160,0.522,1305,1728,0.755,815,2671,3486,1960,594,1197,1651,8056
9337,2018-3-30,Los Angeles Lakers,74,17935,3029,6569,0.461,740,2149,0.344,2289,4420,0.518,1220,1721,0.709,796,2627,3423,1760,579,1129,1570,8018
9338,2018-3-30,Charlotte Hornets,76,18340,2955,6601,0.448,750,2043,0.367,2205,4558,0.484,1532,2059,0.744,771,2680,3451,1621,527,922,1327,8192
9339,2018-3-30,Oklahoma City Thunder,76,18365,3032,6667,0.455,799,2266,0.353,2233,4401,0.507,1280,1795,0.713,940,2466,3406,1614,681,1025,1532,8143
9340,2018-3-30,Washington Wizards,75,18175,3004,6418,0.468,733,1969,0.372,2271,4449,0.51,1279,1654,0.773,754,2478,3232,1882,594,1048,1603,8020
9341,2018-3-30,Brooklyn Nets,75,18150,2861,6515,0.439,930,2628,0.354,1931,3887,0.497,1334,1721,0.775,751,2600,3351,1746,459,1060,1561,7986
9342,2018-3-30,Milwaukee Bucks,75,18100,2962,6167,0.48,659,1846,0.357,2303,4321,0.533,1370,1759,0.779,614,2340,2954,1728,656,988,1600,7953
9343,2018-3-30,Portland Trail Blazers,75,18075,2950,6510,0.453,781,2093,0.373,2169,4417,0.491,1270,1591,0.798,761,2638,3399,1450,518,973,1452,7951
9344,2018-3-30,Indiana Pacers,76,18315,3096,6541,0.473,682,1857,0.367,2414,4684,0.515,1152,1475,0.781,722,2492,3214,1676,669,980,1424,8026
9345,2018-3-30,New York Knicks,76,18390,3086,6661,0.463,606,1743,0.348,2480,4918,0.504,1163,1476,0.788,805,2553,3358,1745,519,1090,1565,7941
9346,2018-3-30,Orlando Magic,74,17810,2891,6336,0.456,774,2163,0.358,2117,4173,0.507,1163,1529,0.761,647,2408,3055,1735,564,1049,1448,7719
9347,2018-3-30,Boston Celtics,75,18125,2872,6379,0.45,880,2316,0.38,1992,4063,0.49,1187,1539,0.771,692,2639,3331,1682,543,995,1497,7811
9348,2018-3-30,Phoenix Suns,76,18265,2912,6628,0.439,702,2112,0.332,2210,4516,0.489,1362,1838,0.741,794,2546,3340,1597,530,1148,1702,7888
9349,2018-3-30,Atlanta Hawks,75,18025,2861,6387,0.448,836,2301,0.363,2025,4086,0.496,1220,1543,0.791,680,2421,3101,1771,592,1129,1481,7778
9350,2018-3-30,Utah Jazz,75,18075,2843,6213,0.458,806,2212,0.364,2037,4001,0.509,1262,1601,0.788,670,2557,3227,1652,653,1054,1463,7754
9351,2018-3-30,Miami Heat,76,18440,2937,6436,0.456,848,2343,0.362,2089,4093,0.51,1126,1494,0.754,698,2574,3272,1731,574,1039,1532,7848
9352,2018-3-30,Detroit Pistons,75,18100,2921,6520,0.448,794,2152,0.369,2127,4368,0.487,1095,1469,0.745,770,2511,3281,1694,572,974,1389,7731
9353,2018-3-30,Chicago Bulls,75,18175,2900,6672,0.435,816,2320,0.352,2084,4352,0.479,1109,1454,0.763,727,2633,3360,1763,561,983,1450,7725
9354,2018-3-30,Dallas Mavericks,75,18100,2860,6412,0.446,884,2437,0.363,1976,3975,0.497,1092,1422,0.768,599,2485,3084,1700,536,887,1454,7696
9355,2018-3-30,San Antonio Spurs,76,18265,2963,6475,0.458,652,1841,0.354,2311,4634,0.499,1212,1570,0.772,789,2585,3374,1739,573,978,1298,7790
9356,2018-3-30,Sacramento Kings,76,18315,2964,6549,0.453,691,1820,0.38,2273,4729,0.481,936,1266,0.739,715,2371,3086,1644,606,1010,1513,7555
9357,2018-3-30,Memphis Grizzlies,75,18025,2733,6183,0.442,690,1970,0.35,2043,4213,0.485,1259,1603,0.785,713,2341,3054,1606,551,1074,1769,7415
9358,2018-4-1,Golden State Warriors,76,18290,3257,6459,0.504,863,2199,0.392,2394,4260,0.562,1277,1569,0.814,643,2679,3322,2243,612,1144,1499,8654
9359,2018-4-1,Houston Rockets,76,18315,2967,6426,0.462,1177,3226,0.365,1790,3200,0.559,1513,1930,0.784,693,2615,3308,1660,655,999,1481,8624
9360,2018-4-1,Toronto Raptors,76,18365,3138,6642,0.472,900,2497,0.36,2238,4145,0.54,1357,1703,0.797,747,2572,3319,1838,584,966,1657,8533
9361,2018-4-1,New Orleans Pelicans,76,18515,3227,6703,0.481,767,2130,0.36,2460,4573,0.538,1230,1593,0.772,657,2697,3354,2003,582,1096,1455,8451
9362,2018-4-1,Cleveland Cavaliers,76,18290,3074,6445,0.477,903,2450,0.369,2171,3995,0.543,1360,1743,0.78,645,2552,3197,1783,533,1013,1430,8411
9363,2018-4-1,Denver Nuggets,76,18390,3097,6576,0.471,877,2345,0.374,2220,4231,0.525,1286,1678,0.766,832,2533,3365,1902,597,1101,1408,8357
9364,2018-4-1,Minnesota Timberwolves,77,18580,3161,6606,0.479,620,1726,0.359,2541,4880,0.521,1507,1873,0.805,785,2437,3222,1744,641,913,1398,8449
9365,2018-4-1,Los Angeles Clippers,76,18265,3059,6493,0.471,746,2086,0.358,2313,4407,0.525,1446,1929,0.75,757,2579,3336,1688,586,1068,1517,8310
9366,2018-4-1,Philadelphia 76ers,75,18100,3016,6440,0.468,811,2223,0.365,2205,4217,0.523,1314,1741,0.755,824,2715,3539,1994,604,1212,1669,8157
9367,2018-4-1,Los Angeles Lakers,75,18200,3077,6663,0.462,748,2176,0.344,2329,4487,0.519,1238,1746,0.709,811,2668,3479,1793,584,1147,1593,8140
9368,2018-4-1,Charlotte Hornets,77,18580,2990,6678,0.448,756,2066,0.366,2234,4612,0.484,1549,2086,0.743,780,2717,3497,1643,533,939,1341,8285
9369,2018-4-1,Oklahoma City Thunder,77,18630,3077,6775,0.454,819,2310,0.355,2258,4465,0.506,1295,1822,0.711,958,2498,3456,1639,694,1033,1554,8268
9370,2018-4-1,Washington Wizards,76,18415,3044,6506,0.468,751,2008,0.374,2293,4498,0.51,1288,1666,0.773,765,2511,3276,1912,605,1060,1626,8127
9371,2018-4-1,Brooklyn Nets,76,18415,2900,6606,0.439,940,2663,0.353,1960,3943,0.497,1356,1749,0.775,758,2640,3398,1774,470,1075,1585,8096
9372,2018-4-1,Milwaukee Bucks,76,18365,3007,6261,0.48,670,1875,0.357,2337,4386,0.533,1393,1787,0.78,622,2371,2993,1752,670,1000,1625,8077
9373,2018-4-1,Portland Trail Blazers,76,18315,2991,6605,0.453,789,2123,0.372,2202,4482,0.491,1285,1607,0.8,774,2675,3449,1480,527,983,1477,8056
9374,2018-4-1,Indiana Pacers,76,18315,3096,6541,0.473,682,1857,0.367,2414,4684,0.515,1152,1475,0.781,722,2492,3214,1676,669,980,1424,8026
9375,2018-4-1,New York Knicks,77,18630,3129,6752,0.463,619,1772,0.349,2510,4980,0.504,1173,1488,0.788,814,2584,3398,1776,523,1104,1583,8050
9376,2018-4-1,Boston Celtics,76,18365,2912,6467,0.45,887,2333,0.38,2025,4134,0.49,1210,1566,0.773,700,2672,3372,1701,549,1000,1520,7921
9377,2018-4-1,Orlando Magic,75,18050,2922,6430,0.454,781,2202,0.355,2141,4228,0.506,1176,1543,0.762,659,2451,3110,1751,575,1061,1466,7801
9378,2018-4-1,Phoenix Suns,77,18505,2953,6712,0.44,714,2144,0.333,2239,4568,0.49,1371,1851,0.741,802,2584,3386,1620,538,1165,1723,7991
9379,2018-4-1,Atlanta Hawks,76,18265,2897,6488,0.447,845,2340,0.361,2052,4148,0.495,1230,1558,0.789,695,2465,3160,1795,601,1145,1495,7869
9380,2018-4-1,Utah Jazz,76,18315,2883,6287,0.459,818,2243,0.365,2065,4044,0.511,1277,1627,0.785,677,2588,3265,1676,660,1069,1482,7861
9381,2018-4-1,Miami Heat,77,18705,2980,6531,0.456,855,2360,0.362,2125,4171,0.509,1142,1515,0.754,708,2615,3323,1750,580,1057,1554,7957
9382,2018-4-1,Detroit Pistons,76,18340,2965,6605,0.449,804,2176,0.369,2161,4429,0.488,1112,1491,0.746,780,2544,3324,1718,580,983,1404,7846
9383,2018-4-1,Chicago Bulls,76,18415,2930,6756,0.434,830,2361,0.352,2100,4395,0.478,1125,1477,0.762,738,2675,3413,1779,572,999,1467,7815
9384,2018-4-1,San Antonio Spurs,76,18265,2963,6475,0.458,652,1841,0.354,2311,4634,0.499,1212,1570,0.772,789,2585,3374,1739,573,978,1298,7790
9385,2018-4-1,Dallas Mavericks,76,18340,2898,6498,0.446,895,2465,0.363,2003,4033,0.497,1097,1429,0.768,605,2525,3130,1722,541,901,1471,7788
9386,2018-4-1,Sacramento Kings,77,18555,3000,6636,0.452,699,1848,0.378,2301,4788,0.481,952,1285,0.741,726,2407,3133,1671,611,1025,1536,7651
9387,2018-4-1,Memphis Grizzlies,76,18265,2772,6264,0.443,699,1993,0.351,2073,4271,0.485,1269,1618,0.784,720,2367,3087,1630,559,1087,1790,7512
9388,2018-4-2,Golden State Warriors,77,18530,3305,6548,0.505,876,2227,0.393,2429,4321,0.562,1285,1578,0.814,650,2717,3367,2274,622,1158,1513,8771
9389,2018-4-2,Houston Rockets,77,18555,2993,6503,0.46,1184,3257,0.364,1809,3246,0.557,1537,1959,0.785,701,2649,3350,1672,658,1008,1500,8707
9390,2018-4-2,Toronto Raptors,76,18365,3138,6642,0.472,900,2497,0.36,2238,4145,0.54,1357,1703,0.797,747,2572,3319,1838,584,966,1657,8533
9391,2018-4-2,New Orleans Pelicans,77,18755,3265,6786,0.481,778,2162,0.36,2487,4624,0.538,1247,1616,0.772,664,2734,3398,2031,595,1117,1475,8555
9392,2018-4-2,Cleveland Cavaliers,77,18530,3109,6530,0.476,914,2476,0.369,2195,4054,0.541,1377,1766,0.78,655,2592,3247,1804,540,1024,1442,8509
9393,2018-4-2,Denver Nuggets,77,18655,3137,6666,0.471,888,2381,0.373,2249,4285,0.525,1323,1724,0.767,849,2573,3422,1929,599,1118,1431,8485
9394,2018-4-2,Minnesota Timberwolves,78,18820,3199,6696,0.478,628,1750,0.359,2571,4946,0.52,1520,1887,0.806,792,2462,3254,1763,651,925,1415,8546
9395,2018-4-2,Los Angeles Clippers,77,18505,3101,6575,0.472,755,2111,0.358,2346,4464,0.526,1457,1943,0.75,769,2603,3372,1712,592,1081,1536,8414
9396,2018-4-2,Philadelphia 76ers,76,18340,3064,6534,0.469,825,2255,0.366,2239,4279,0.523,1323,1751,0.756,831,2752,3583,2030,619,1226,1693,8276
9397,2018-4-2,Los Angeles Lakers,76,18440,3107,6738,0.461,755,2208,0.342,2352,4530,0.519,1254,1771,0.708,821,2705,3526,1811,589,1161,1608,8223
9398,2018-4-2,Charlotte Hornets,78,18820,3023,6760,0.447,765,2096,0.365,2258,4664,0.484,1576,2120,0.743,789,2748,3537,1660,541,955,1354,8387
9399,2018-4-2,Oklahoma City Thunder,78,18870,3118,6870,0.454,828,2341,0.354,2290,4529,0.506,1313,1847,0.711,972,2535,3507,1663,707,1051,1576,8377
9400,2018-4-2,Washington Wizards,77,18655,3081,6587,0.468,759,2038,0.372,2322,4549,0.51,1300,1678,0.775,771,2542,3313,1939,610,1076,1638,8221
9401,2018-4-2,Milwaukee Bucks,77,18630,3052,6361,0.48,682,1908,0.357,2370,4453,0.532,1416,1814,0.781,633,2405,3038,1779,679,1009,1662,8202
9402,2018-4-2,Brooklyn Nets,77,18655,2937,6693,0.439,952,2706,0.352,1985,3987,0.498,1366,1764,0.774,764,2674,3438,1797,475,1087,1607,8192
9403,2018-4-2,Portland Trail Blazers,77,18555,3030,6689,0.453,801,2161,0.371,2229,4528,0.492,1308,1632,0.801,782,2710,3492,1508,536,996,1492,8169
9404,2018-4-2,Indiana Pacers,77,18555,3138,6627,0.474,693,1885,0.368,2445,4742,0.516,1168,1496,0.781,737,2517,3254,1699,677,990,1436,8137
9405,2018-4-2,New York Knicks,77,18630,3129,6752,0.463,619,1772,0.349,2510,4980,0.504,1173,1488,0.788,814,2584,3398,1776,523,1104,1583,8050
9406,2018-4-2,Boston Celtics,76,18365,2912,6467,0.45,887,2333,0.38,2025,4134,0.49,1210,1566,0.773,700,2672,3372,1701,549,1000,1520,7921
9407,2018-4-2,Orlando Magic,76,18290,2955,6526,0.453,791,2238,0.353,2164,4288,0.505,1188,1556,0.763,670,2481,3151,1770,583,1066,1476,7889
9408,2018-4-2,Phoenix Suns,78,18745,2994,6802,0.44,725,2175,0.333,2269,4627,0.49,1385,1867,0.742,811,2617,3428,1646,546,1180,1735,8098
9409,2018-4-2,Utah Jazz,77,18555,2929,6363,0.46,829,2271,0.365,2100,4092,0.513,1295,1652,0.784,683,2627,3310,1705,668,1085,1501,7982
9410,2018-4-2,Atlanta Hawks,77,18505,2938,6573,0.447,856,2376,0.36,2082,4197,0.496,1231,1559,0.79,700,2512,3212,1828,601,1159,1510,7963
9411,2018-4-2,Detroit Pistons,77,18580,3003,6689,0.449,811,2195,0.369,2192,4494,0.488,1137,1523,0.747,790,2587,3377,1735,589,992,1420,7954
9412,2018-4-2,Miami Heat,77,18705,2980,6531,0.456,855,2360,0.362,2125,4171,0.509,1142,1515,0.754,708,2615,3323,1750,580,1057,1554,7957
9413,2018-4-2,Chicago Bulls,77,18655,2973,6838,0.435,848,2395,0.354,2125,4443,0.478,1134,1490,0.761,744,2709,3453,1809,579,1016,1484,7928
9414,2018-4-2,San Antonio Spurs,77,18505,3003,6556,0.458,658,1858,0.354,2345,4698,0.499,1226,1591,0.771,797,2625,3422,1758,581,986,1317,7890
9415,2018-4-2,Dallas Mavericks,77,18580,2930,6577,0.445,908,2502,0.363,2022,4075,0.496,1107,1440,0.769,609,2559,3168,1737,546,916,1491,7875
9416,2018-4-2,Sacramento Kings,78,18795,3035,6728,0.451,706,1872,0.377,2329,4856,0.48,959,1299,0.738,739,2441,3180,1688,620,1035,1556,7735
9417,2018-4-2,Memphis Grizzlies,77,18505,2812,6352,0.443,708,2014,0.352,2104,4338,0.485,1278,1630,0.784,729,2400,3129,1650,566,1104,1809,7610
9418,2018-4-3,Golden State Warriors,77,18530,3305,6548,0.505,876,2227,0.393,2429,4321,0.562,1285,1578,0.814,650,2717,3367,2274,622,1158,1513,8771
9419,2018-4-3,Houston Rockets,77,18555,2993,6503,0.46,1184,3257,0.364,1809,3246,0.557,1537,1959,0.785,701,2649,3350,1672,658,1008,1500,8707
9420,2018-4-3,Toronto Raptors,76,18365,3138,6642,0.472,900,2497,0.36,2238,4145,0.54,1357,1703,0.797,747,2572,3319,1838,584,966,1657,8533
9421,2018-4-3,New Orleans Pelicans,77,18755,3265,6786,0.481,778,2162,0.36,2487,4624,0.538,1247,1616,0.772,664,2734,3398,2031,595,1117,1475,8555
9422,2018-4-3,Cleveland Cavaliers,77,18530,3109,6530,0.476,914,2476,0.369,2195,4054,0.541,1377,1766,0.78,655,2592,3247,1804,540,1024,1442,8509
9423,2018-4-3,Denver Nuggets,77,18655,3137,6666,0.471,888,2381,0.373,2249,4285,0.525,1323,1724,0.767,849,2573,3422,1929,599,1118,1431,8485
9424,2018-4-3,Minnesota Timberwolves,78,18820,3199,6696,0.478,628,1750,0.359,2571,4946,0.52,1520,1887,0.806,792,2462,3254,1763,651,925,1415,8546
9425,2018-4-3,Los Angeles Clippers,77,18505,3101,6575,0.472,755,2111,0.358,2346,4464,0.526,1457,1943,0.75,769,2603,3372,1712,592,1081,1536,8414
9426,2018-4-3,Philadelphia 76ers,76,18340,3064,6534,0.469,825,2255,0.366,2239,4279,0.523,1323,1751,0.756,831,2752,3583,2030,619,1226,1693,8276
9427,2018-4-3,Los Angeles Lakers,76,18440,3107,6738,0.461,755,2208,0.342,2352,4530,0.519,1254,1771,0.708,821,2705,3526,1811,589,1161,1608,8223
9428,2018-4-3,Charlotte Hornets,78,18820,3023,6760,0.447,765,2096,0.365,2258,4664,0.484,1576,2120,0.743,789,2748,3537,1660,541,955,1354,8387
9429,2018-4-3,Oklahoma City Thunder,78,18870,3118,6870,0.454,828,2341,0.354,2290,4529,0.506,1313,1847,0.711,972,2535,3507,1663,707,1051,1576,8377
9430,2018-4-3,Washington Wizards,77,18655,3081,6587,0.468,759,2038,0.372,2322,4549,0.51,1300,1678,0.775,771,2542,3313,1939,610,1076,1638,8221
9431,2018-4-3,Milwaukee Bucks,77,18630,3052,6361,0.48,682,1908,0.357,2370,4453,0.532,1416,1814,0.781,633,2405,3038,1779,679,1009,1662,8202
9432,2018-4-3,Brooklyn Nets,77,18655,2937,6693,0.439,952,2706,0.352,1985,3987,0.498,1366,1764,0.774,764,2674,3438,1797,475,1087,1607,8192
9433,2018-4-3,Portland Trail Blazers,77,18555,3030,6689,0.453,801,2161,0.371,2229,4528,0.492,1308,1632,0.801,782,2710,3492,1508,536,996,1492,8169
9434,2018-4-3,Indiana Pacers,77,18555,3138,6627,0.474,693,1885,0.368,2445,4742,0.516,1168,1496,0.781,737,2517,3254,1699,677,990,1436,8137
9435,2018-4-3,New York Knicks,77,18630,3129,6752,0.463,619,1772,0.349,2510,4980,0.504,1173,1488,0.788,814,2584,3398,1776,523,1104,1583,8050
9436,2018-4-3,Boston Celtics,76,18365,2912,6467,0.45,887,2333,0.38,2025,4134,0.49,1210,1566,0.773,700,2672,3372,1701,549,1000,1520,7921
9437,2018-4-3,Orlando Magic,76,18290,2955,6526,0.453,791,2238,0.353,2164,4288,0.505,1188,1556,0.763,670,2481,3151,1770,583,1066,1476,7889
9438,2018-4-3,Phoenix Suns,78,18745,2994,6802,0.44,725,2175,0.333,2269,4627,0.49,1385,1867,0.742,811,2617,3428,1646,546,1180,1735,8098
9439,2018-4-3,Utah Jazz,77,18555,2929,6363,0.46,829,2271,0.365,2100,4092,0.513,1295,1652,0.784,683,2627,3310,1705,668,1085,1501,7982
9440,2018-4-3,Atlanta Hawks,77,18505,2938,6573,0.447,856,2376,0.36,2082,4197,0.496,1231,1559,0.79,700,2512,3212,1828,601,1159,1510,7963
9441,2018-4-3,Detroit Pistons,77,18580,3003,6689,0.449,811,2195,0.369,2192,4494,0.488,1137,1523,0.747,790,2587,3377,1735,589,992,1420,7954
9442,2018-4-3,Miami Heat,77,18705,2980,6531,0.456,855,2360,0.362,2125,4171,0.509,1142,1515,0.754,708,2615,3323,1750,580,1057,1554,7957
9443,2018-4-3,Chicago Bulls,77,18655,2973,6838,0.435,848,2395,0.354,2125,4443,0.478,1134,1490,0.761,744,2709,3453,1809,579,1016,1484,7928
9444,2018-4-3,San Antonio Spurs,77,18505,3003,6556,0.458,658,1858,0.354,2345,4698,0.499,1226,1591,0.771,797,2625,3422,1758,581,986,1317,7890
9445,2018-4-3,Dallas Mavericks,77,18580,2930,6577,0.445,908,2502,0.363,2022,4075,0.496,1107,1440,0.769,609,2559,3168,1737,546,916,1491,7875
9446,2018-4-3,Sacramento Kings,78,18795,3035,6728,0.451,706,1872,0.377,2329,4856,0.48,959,1299,0.738,739,2441,3180,1688,620,1035,1556,7735
9447,2018-4-3,Memphis Grizzlies,77,18505,2812,6352,0.443,708,2014,0.352,2104,4338,0.485,1278,1630,0.784,729,2400,3129,1650,566,1104,1809,7610
9448,2018-4-4,Golden State Warriors,78,18770,3346,6631,0.505,884,2256,0.392,2462,4375,0.563,1306,1602,0.815,656,2751,3407,2301,631,1171,1538,8882
9449,2018-4-4,Houston Rockets,78,18795,3036,6587,0.461,1200,3303,0.363,1836,3284,0.559,1555,1986,0.783,711,2685,3396,1698,671,1017,1514,8827
9450,2018-4-4,Toronto Raptors,77,18605,3180,6736,0.472,911,2531,0.36,2269,4205,0.54,1368,1717,0.797,756,2609,3365,1866,591,977,1680,8639
9451,2018-4-4,New Orleans Pelicans,77,18755,3265,6786,0.481,778,2162,0.36,2487,4624,0.538,1247,1616,0.772,664,2734,3398,2031,595,1117,1475,8555
9452,2018-4-4,Cleveland Cavaliers,78,18770,3147,6607,0.476,927,2506,0.37,2220,4101,0.541,1400,1792,0.781,657,2632,3289,1822,548,1036,1459,8621
9453,2018-4-4,Denver Nuggets,78,18895,3178,6755,0.47,898,2413,0.372,2280,4342,0.525,1338,1744,0.767,862,2609,3471,1960,609,1134,1450,8592
9454,2018-4-4,Minnesota Timberwolves,78,18820,3199,6696,0.478,628,1750,0.359,2571,4946,0.52,1520,1887,0.806,792,2462,3254,1763,651,925,1415,8546
9455,2018-4-4,Los Angeles Clippers,78,18745,3138,6657,0.471,760,2127,0.357,2378,4530,0.525,1491,1986,0.751,781,2638,3419,1733,600,1095,1559,8527
9456,2018-4-4,Philadelphia 76ers,77,18580,3114,6625,0.47,834,2276,0.366,2280,4349,0.524,1335,1769,0.755,838,2800,3638,2058,629,1236,1715,8397
9457,2018-4-4,Los Angeles Lakers,77,18680,3143,6812,0.461,769,2236,0.344,2374,4576,0.519,1278,1807,0.707,828,2737,3565,1834,596,1177,1631,8333
9458,2018-4-4,Charlotte Hornets,79,19060,3063,6841,0.448,778,2130,0.365,2285,4711,0.485,1597,2148,0.743,799,2787,3586,1684,544,975,1370,8501
9459,2018-4-4,Oklahoma City Thunder,79,19110,3153,6963,0.453,837,2379,0.352,2316,4584,0.505,1341,1884,0.712,994,2571,3565,1676,715,1067,1596,8484
9460,2018-4-4,Washington Wizards,78,18895,3119,6659,0.468,771,2063,0.374,2348,4596,0.511,1316,1701,0.774,774,2575,3349,1964,616,1093,1659,8325
9461,2018-4-4,Milwaukee Bucks,78,18870,3095,6440,0.481,687,1928,0.356,2408,4512,0.534,1431,1835,0.78,642,2437,3079,1806,685,1024,1685,8308
9462,2018-4-4,Brooklyn Nets,78,18895,2971,6774,0.439,969,2748,0.353,2002,4026,0.497,1376,1787,0.77,767,2707,3474,1817,480,1105,1622,8287
9463,2018-4-4,Portland Trail Blazers,78,18795,3069,6776,0.453,811,2201,0.368,2258,4575,0.494,1329,1656,0.803,787,2751,3538,1536,542,1009,1512,8278
9464,2018-4-4,Indiana Pacers,78,18795,3179,6711,0.474,702,1904,0.369,2477,4807,0.515,1181,1512,0.781,743,2546,3289,1722,688,1003,1460,8241
9465,2018-4-4,Boston Celtics,77,18605,2950,6548,0.451,894,2356,0.379,2056,4192,0.49,1229,1590,0.773,710,2699,3409,1720,559,1017,1537,8023
9466,2018-4-4,New York Knicks,78,18870,3159,6838,0.462,623,1799,0.346,2536,5039,0.503,1182,1500,0.788,821,2619,3440,1793,528,1115,1600,8123
9467,2018-4-4,Utah Jazz,78,18795,2972,6452,0.461,843,2304,0.366,2129,4148,0.513,1312,1679,0.781,697,2660,3357,1734,678,1099,1523,8099
9468,2018-4-4,Orlando Magic,77,18530,2992,6614,0.452,802,2274,0.353,2190,4340,0.505,1200,1574,0.762,681,2523,3204,1798,590,1077,1488,7986
9469,2018-4-4,Phoenix Suns,79,18985,3029,6879,0.44,731,2192,0.333,2298,4687,0.49,1406,1900,0.74,817,2663,3480,1664,552,1194,1757,8195
9470,2018-4-4,Atlanta Hawks,78,18745,2975,6661,0.447,869,2409,0.361,2106,4252,0.495,1242,1574,0.789,712,2549,3261,1852,611,1174,1525,8061
9471,2018-4-4,Detroit Pistons,77,18580,3003,6689,0.449,811,2195,0.369,2192,4494,0.488,1137,1523,0.747,790,2587,3377,1735,589,992,1420,7954
9472,2018-4-4,Miami Heat,78,18945,3021,6622,0.456,863,2393,0.361,2158,4229,0.51,1153,1528,0.755,719,2650,3369,1772,590,1071,1570,8058
9473,2018-4-4,Chicago Bulls,78,18895,3019,6937,0.435,863,2429,0.355,2156,4508,0.478,1147,1508,0.761,755,2742,3497,1835,588,1023,1504,8048
9474,2018-4-4,San Antonio Spurs,78,18745,3042,6644,0.458,666,1882,0.354,2376,4762,0.499,1250,1619,0.772,807,2654,3461,1782,594,998,1346,8000
9475,2018-4-4,Dallas Mavericks,78,18820,2972,6669,0.446,925,2546,0.363,2047,4123,0.496,1121,1460,0.768,617,2594,3211,1764,554,923,1507,7990
9476,2018-4-4,Sacramento Kings,79,19035,3068,6817,0.45,717,1899,0.378,2351,4918,0.478,976,1322,0.738,749,2471,3220,1708,625,1045,1580,7829
9477,2018-4-4,Memphis Grizzlies,77,18505,2812,6352,0.443,708,2014,0.352,2104,4338,0.485,1278,1630,0.784,729,2400,3129,1650,566,1104,1809,7610
9478,2018-4-5,Golden State Warriors,78,18770,3346,6631,0.505,884,2256,0.392,2462,4375,0.563,1306,1602,0.815,656,2751,3407,2301,631,1171,1538,8882
9479,2018-4-5,Houston Rockets,78,18795,3036,6587,0.461,1200,3303,0.363,1836,3284,0.559,1555,1986,0.783,711,2685,3396,1698,671,1017,1514,8827
9480,2018-4-5,Toronto Raptors,78,18845,3220,6828,0.472,921,2564,0.359,2299,4264,0.539,1374,1725,0.797,768,2645,3413,1889,601,987,1705,8735
9481,2018-4-5,New Orleans Pelicans,78,18995,3310,6872,0.482,794,2198,0.361,2516,4674,0.538,1264,1635,0.773,675,2771,3446,2063,609,1133,1494,8678
9482,2018-4-5,Cleveland Cavaliers,78,18770,3147,6607,0.476,927,2506,0.37,2220,4101,0.541,1400,1792,0.781,657,2632,3289,1822,548,1036,1459,8621
9483,2018-4-5,Denver Nuggets,78,18895,3178,6755,0.47,898,2413,0.372,2280,4342,0.525,1338,1744,0.767,862,2609,3471,1960,609,1134,1450,8592
9484,2018-4-5,Minnesota Timberwolves,78,18820,3199,6696,0.478,628,1750,0.359,2571,4946,0.52,1520,1887,0.806,792,2462,3254,1763,651,925,1415,8546
9485,2018-4-5,Los Angeles Clippers,78,18745,3138,6657,0.471,760,2127,0.357,2378,4530,0.525,1491,1986,0.751,781,2638,3419,1733,600,1095,1559,8527
9486,2018-4-5,Philadelphia 76ers,78,18820,3158,6714,0.47,847,2306,0.367,2311,4408,0.524,1349,1788,0.754,845,2837,3682,2090,640,1249,1732,8512
9487,2018-4-5,Los Angeles Lakers,78,18945,3190,6898,0.462,782,2260,0.346,2408,4638,0.519,1293,1825,0.708,832,2777,3609,1866,600,1190,1653,8455
9488,2018-4-5,Charlotte Hornets,79,19060,3063,6841,0.448,778,2130,0.365,2285,4711,0.485,1597,2148,0.743,799,2787,3586,1684,544,975,1370,8501
9489,2018-4-5,Oklahoma City Thunder,79,19110,3153,6963,0.453,837,2379,0.352,2316,4584,0.505,1341,1884,0.712,994,2571,3565,1676,715,1067,1596,8484
9490,2018-4-5,Washington Wizards,78,18895,3119,6659,0.468,771,2063,0.374,2348,4596,0.511,1316,1701,0.774,774,2575,3349,1964,616,1093,1659,8325
9491,2018-4-5,Milwaukee Bucks,78,18870,3095,6440,0.481,687,1928,0.356,2408,4512,0.534,1431,1835,0.78,642,2437,3079,1806,685,1024,1685,8308
9492,2018-4-5,Brooklyn Nets,78,18895,2971,6774,0.439,969,2748,0.353,2002,4026,0.497,1376,1787,0.77,767,2707,3474,1817,480,1105,1622,8287
9493,2018-4-5,Portland Trail Blazers,78,18795,3069,6776,0.453,811,2201,0.368,2258,4575,0.494,1329,1656,0.803,787,2751,3538,1536,542,1009,1512,8278
9494,2018-4-5,Indiana Pacers,78,18795,3179,6711,0.474,702,1904,0.369,2477,4807,0.515,1181,1512,0.781,743,2546,3289,1722,688,1003,1460,8241
9495,2018-4-5,New York Knicks,78,18870,3159,6838,0.462,623,1799,0.346,2536,5039,0.503,1182,1500,0.788,821,2619,3440,1793,528,1115,1600,8123
9496,2018-4-5,Boston Celtics,78,18845,2975,6623,0.449,897,2378,0.377,2078,4245,0.49,1254,1618,0.775,718,2734,3452,1730,566,1033,1553,8101
9497,2018-4-5,Utah Jazz,78,18795,2972,6452,0.461,843,2304,0.366,2129,4148,0.513,1312,1679,0.781,697,2660,3357,1734,678,1099,1523,8099
9498,2018-4-5,Orlando Magic,78,18770,3031,6700,0.452,810,2303,0.352,2221,4397,0.505,1219,1601,0.761,693,2558,3251,1825,594,1090,1503,8091
9499,2018-4-5,Phoenix Suns,79,18985,3029,6879,0.44,731,2192,0.333,2298,4687,0.49,1406,1900,0.74,817,2663,3480,1664,552,1194,1757,8195
9500,2018-4-5,Miami Heat,79,19185,3063,6716,0.456,880,2431,0.362,2183,4285,0.509,1167,1545,0.755,729,2694,3423,1795,599,1082,1587,8173
9501,2018-4-5,Detroit Pistons,78,18820,3042,6777,0.449,827,2231,0.371,2215,4546,0.487,1151,1546,0.745,799,2620,3419,1765,593,1009,1439,8062
9502,2018-4-5,Chicago Bulls,78,18895,3019,6937,0.435,863,2429,0.355,2156,4508,0.478,1147,1508,0.761,755,2742,3497,1835,588,1023,1504,8048
9503,2018-4-5,Atlanta Hawks,79,18985,3008,6751,0.446,878,2439,0.36,2130,4312,0.494,1253,1591,0.788,722,2587,3309,1872,616,1189,1541,8147
9504,2018-4-5,San Antonio Spurs,79,19010,3084,6741,0.457,675,1905,0.354,2409,4836,0.498,1269,1646,0.771,822,2685,3507,1807,601,1008,1366,8112
9505,2018-4-5,Dallas Mavericks,79,19060,3011,6758,0.446,935,2576,0.363,2076,4182,0.496,1133,1477,0.767,628,2626,3254,1788,557,934,1530,8090
9506,2018-4-5,Sacramento Kings,79,19035,3068,6817,0.45,717,1899,0.378,2351,4918,0.478,976,1322,0.738,749,2471,3220,1708,625,1045,1580,7829
9507,2018-4-5,Memphis Grizzlies,78,18745,2849,6445,0.442,718,2046,0.351,2131,4399,0.484,1289,1645,0.784,740,2426,3166,1669,575,1125,1828,7705
9508,2018-4-6,Golden State Warriors,79,19010,3383,6714,0.504,893,2285,0.391,2490,4429,0.562,1329,1626,0.817,669,2777,3446,2330,637,1187,1552,8988
9509,2018-4-6,Houston Rockets,79,19035,3070,6660,0.461,1213,3340,0.363,1857,3320,0.559,1570,2010,0.781,717,2717,3434,1714,681,1032,1530,8923
9510,2018-4-6,Toronto Raptors,78,18845,3220,6828,0.472,921,2564,0.359,2299,4264,0.539,1374,1725,0.797,768,2645,3413,1889,601,987,1705,8735
9511,2018-4-6,New Orleans Pelicans,78,18995,3310,6872,0.482,794,2198,0.361,2516,4674,0.538,1264,1635,0.773,675,2771,3446,2063,609,1133,1494,8678
9512,2018-4-6,Cleveland Cavaliers,79,19010,3189,6684,0.477,940,2533,0.371,2249,4151,0.542,1422,1820,0.781,662,2662,3324,1848,558,1052,1473,8740
9513,2018-4-6,Denver Nuggets,79,19135,3213,6844,0.469,909,2449,0.371,2304,4395,0.524,1357,1766,0.768,875,2643,3518,1981,612,1144,1467,8692
9514,2018-4-6,Minnesota Timberwolves,79,19060,3238,6787,0.477,634,1774,0.357,2604,5013,0.519,1532,1903,0.805,804,2497,3301,1785,655,933,1434,8642
9515,2018-4-6,Los Angeles Clippers,79,18985,3173,6736,0.471,763,2144,0.356,2410,4592,0.525,1513,2014,0.751,792,2666,3458,1751,607,1111,1584,8622
9516,2018-4-6,Philadelphia 76ers,78,18820,3158,6714,0.47,847,2306,0.367,2311,4408,0.524,1349,1788,0.754,845,2837,3682,2090,640,1249,1732,8512
9517,2018-4-6,Los Angeles Lakers,78,18945,3190,6898,0.462,782,2260,0.346,2408,4638,0.519,1293,1825,0.708,832,2777,3609,1866,600,1190,1653,8455
9518,2018-4-6,Charlotte Hornets,79,19060,3063,6841,0.448,778,2130,0.365,2285,4711,0.485,1597,2148,0.743,799,2787,3586,1684,544,975,1370,8501
9519,2018-4-6,Oklahoma City Thunder,79,19110,3153,6963,0.453,837,2379,0.352,2316,4584,0.505,1341,1884,0.712,994,2571,3565,1676,715,1067,1596,8484
9520,2018-4-6,Washington Wizards,79,19135,3166,6753,0.469,780,2084,0.374,2386,4669,0.511,1328,1715,0.774,786,2604,3390,1998,624,1108,1682,8440
9521,2018-4-6,Milwaukee Bucks,79,19110,3136,6533,0.48,692,1948,0.355,2444,4585,0.533,1455,1865,0.78,654,2466,3120,1827,697,1032,1704,8419
9522,2018-4-6,Brooklyn Nets,79,19135,3012,6849,0.44,988,2787,0.355,2024,4062,0.498,1394,1808,0.771,771,2744,3515,1847,483,1122,1643,8406
9523,2018-4-6,Portland Trail Blazers,79,19035,3108,6861,0.453,818,2223,0.368,2290,4638,0.494,1338,1670,0.801,799,2786,3585,1552,552,1027,1532,8372
9524,2018-4-6,Indiana Pacers,79,19035,3229,6804,0.475,717,1933,0.371,2512,4871,0.516,1192,1527,0.781,756,2580,3336,1754,699,1015,1484,8367
9525,2018-4-6,New York Knicks,78,18870,3159,6838,0.462,623,1799,0.346,2536,5039,0.503,1182,1500,0.788,821,2619,3440,1793,528,1115,1600,8123
9526,2018-4-6,Utah Jazz,79,19035,3016,6535,0.462,853,2331,0.366,2163,4204,0.515,1331,1707,0.78,707,2688,3395,1761,685,1108,1545,8216
9527,2018-4-6,Boston Celtics,78,18845,2975,6623,0.449,897,2378,0.377,2078,4245,0.49,1254,1618,0.775,718,2734,3452,1730,566,1033,1553,8101
9528,2018-4-6,Orlando Magic,78,18770,3031,6700,0.452,810,2303,0.352,2221,4397,0.505,1219,1601,0.761,693,2558,3251,1825,594,1090,1503,8091
9529,2018-4-6,Phoenix Suns,79,18985,3029,6879,0.44,731,2192,0.333,2298,4687,0.49,1406,1900,0.74,817,2663,3480,1664,552,1194,1757,8195
9530,2018-4-6,Miami Heat,79,19185,3063,6716,0.456,880,2431,0.362,2183,4285,0.509,1167,1545,0.755,729,2694,3423,1795,599,1082,1587,8173
9531,2018-4-6,Detroit Pistons,78,18820,3042,6777,0.449,827,2231,0.371,2215,4546,0.487,1151,1546,0.745,799,2620,3419,1765,593,1009,1439,8062
9532,2018-4-6,Chicago Bulls,78,18895,3019,6937,0.435,863,2429,0.355,2156,4508,0.478,1147,1508,0.761,755,2742,3497,1835,588,1023,1504,8048
9533,2018-4-6,Atlanta Hawks,79,18985,3008,6751,0.446,878,2439,0.36,2130,4312,0.494,1253,1591,0.788,722,2587,3309,1872,616,1189,1541,8147
9534,2018-4-6,San Antonio Spurs,79,19010,3084,6741,0.457,675,1905,0.354,2409,4836,0.498,1269,1646,0.771,822,2685,3507,1807,601,1008,1366,8112
9535,2018-4-6,Dallas Mavericks,79,19060,3011,6758,0.446,935,2576,0.363,2076,4182,0.496,1133,1477,0.767,628,2626,3254,1788,557,934,1530,8090
9536,2018-4-6,Sacramento Kings,79,19035,3068,6817,0.45,717,1899,0.378,2351,4918,0.478,976,1322,0.738,749,2471,3220,1708,625,1045,1580,7829
9537,2018-4-6,Memphis Grizzlies,78,18745,2849,6445,0.442,718,2046,0.351,2131,4399,0.484,1289,1645,0.784,740,2426,3166,1669,575,1125,1828,7705
9538,2018-4-7,Golden State Warriors,79,19010,3383,6714,0.504,893,2285,0.391,2490,4429,0.562,1329,1626,0.817,669,2777,3446,2330,637,1187,1552,8988
9539,2018-4-7,Houston Rockets,79,19035,3070,6660,0.461,1213,3340,0.363,1857,3320,0.559,1570,2010,0.781,717,2717,3434,1714,681,1032,1530,8923
9540,2018-4-7,Toronto Raptors,79,19085,3256,6912,0.471,930,2594,0.359,2326,4318,0.539,1385,1741,0.796,777,2688,3465,1916,610,1006,1722,8827
9541,2018-4-7,New Orleans Pelicans,79,19235,3355,6971,0.481,810,2236,0.362,2545,4735,0.537,1280,1655,0.773,688,2813,3501,2092,618,1148,1516,8800
9542,2018-4-7,Cleveland Cavaliers,80,19250,3234,6771,0.478,956,2567,0.372,2278,4204,0.542,1446,1853,0.78,670,2695,3365,1872,564,1067,1493,8870
9543,2018-4-7,Denver Nuggets,79,19135,3213,6844,0.469,909,2449,0.371,2304,4395,0.524,1357,1766,0.768,875,2643,3518,1981,612,1144,1467,8692
9544,2018-4-7,Minnesota Timberwolves,80,19300,3281,6887,0.476,642,1800,0.357,2639,5087,0.519,1551,1929,0.804,822,2527,3349,1810,669,938,1458,8755
9545,2018-4-7,Philadelphia 76ers,79,19060,3208,6815,0.471,861,2345,0.367,2347,4470,0.525,1367,1809,0.756,856,2870,3726,2125,651,1261,1755,8644
9546,2018-4-7,Los Angeles Clippers,79,18985,3173,6736,0.471,763,2144,0.356,2410,4592,0.525,1513,2014,0.751,792,2666,3458,1751,607,1111,1584,8622
9547,2018-4-7,Los Angeles Lakers,79,19185,3221,6977,0.462,790,2284,0.346,2431,4693,0.518,1319,1857,0.71,845,2817,3662,1882,603,1210,1674,8551
9548,2018-4-7,Charlotte Hornets,80,19300,3111,6927,0.449,795,2161,0.368,2316,4766,0.486,1621,2174,0.746,808,2828,3636,1716,548,984,1385,8638
9549,2018-4-7,Oklahoma City Thunder,79,19110,3153,6963,0.453,837,2379,0.352,2316,4584,0.505,1341,1884,0.712,994,2571,3565,1676,715,1067,1596,8484
9550,2018-4-7,Washington Wizards,80,19375,3201,6840,0.468,789,2109,0.374,2412,4731,0.51,1346,1738,0.774,795,2640,3435,2016,632,1120,1697,8537
9551,2018-4-7,Milwaukee Bucks,79,19110,3136,6533,0.48,692,1948,0.355,2444,4585,0.533,1455,1865,0.78,654,2466,3120,1827,697,1032,1704,8419
9552,2018-4-7,Brooklyn Nets,79,19135,3012,6849,0.44,988,2787,0.355,2024,4062,0.498,1394,1808,0.771,771,2744,3515,1847,483,1122,1643,8406
9553,2018-4-7,Portland Trail Blazers,79,19035,3108,6861,0.453,818,2223,0.368,2290,4638,0.494,1338,1670,0.801,799,2786,3585,1552,552,1027,1532,8372
9554,2018-4-7,Indiana Pacers,80,19275,3255,6891,0.472,724,1954,0.371,2531,4937,0.513,1206,1547,0.78,768,2612,3380,1770,707,1027,1505,8440
9555,2018-4-7,New York Knicks,79,19110,3204,6927,0.463,641,1836,0.349,2563,5091,0.503,1196,1521,0.786,830,2661,3491,1826,535,1127,1623,8245
9556,2018-4-7,Utah Jazz,79,19035,3016,6535,0.462,853,2331,0.366,2163,4204,0.515,1331,1707,0.78,707,2688,3395,1761,685,1108,1545,8216
9557,2018-4-7,Boston Celtics,79,19085,3020,6704,0.45,911,2412,0.378,2109,4292,0.491,1261,1635,0.771,724,2774,3498,1765,575,1051,1568,8212
9558,2018-4-7,Orlando Magic,79,19010,3073,6794,0.452,819,2326,0.352,2254,4468,0.504,1226,1614,0.76,705,2582,3287,1852,596,1098,1522,8191
9559,2018-4-7,Phoenix Suns,80,19225,3066,6973,0.44,740,2225,0.333,2326,4748,0.49,1426,1926,0.74,829,2699,3528,1684,560,1208,1775,8298
9560,2018-4-7,Detroit Pistons,79,19085,3088,6869,0.45,839,2261,0.371,2249,4608,0.488,1160,1563,0.742,805,2663,3468,1789,599,1020,1458,8175
9561,2018-4-7,Miami Heat,80,19425,3098,6804,0.455,887,2458,0.361,2211,4346,0.509,1188,1567,0.758,736,2729,3465,1815,606,1095,1606,8271
9562,2018-4-7,Chicago Bulls,79,19135,3059,7023,0.436,877,2459,0.357,2182,4564,0.478,1157,1525,0.759,764,2776,3540,1860,603,1040,1526,8152
9563,2018-4-7,Atlanta Hawks,80,19225,3046,6830,0.446,889,2472,0.36,2157,4358,0.495,1269,1614,0.786,729,2630,3359,1896,621,1207,1563,8250
9564,2018-4-7,San Antonio Spurs,79,19010,3084,6741,0.457,675,1905,0.354,2409,4836,0.498,1269,1646,0.771,822,2685,3507,1807,601,1008,1366,8112
9565,2018-4-7,Dallas Mavericks,80,19325,3051,6850,0.445,948,2615,0.363,2103,4235,0.497,1146,1495,0.767,638,2662,3300,1814,564,946,1550,8196
9566,2018-4-7,Sacramento Kings,80,19275,3108,6902,0.45,723,1923,0.376,2385,4979,0.479,984,1334,0.738,759,2503,3262,1731,633,1060,1601,7923
9567,2018-4-7,Memphis Grizzlies,79,18985,2886,6529,0.442,724,2070,0.35,2162,4459,0.485,1302,1663,0.783,752,2452,3204,1689,582,1140,1840,7798
9568,2018-4-8,Golden State Warriors,80,19250,3432,6804,0.504,908,2318,0.392,2524,4486,0.563,1336,1637,0.816,677,2811,3488,2361,640,1204,1573,9108
9569,2018-4-8,Houston Rockets,80,19275,3106,6736,0.461,1227,3377,0.363,1879,3359,0.559,1586,2033,0.78,723,2752,3475,1737,688,1049,1554,9025
9570,2018-4-8,Toronto Raptors,79,19085,3256,6912,0.471,930,2594,0.359,2326,4318,0.539,1385,1741,0.796,777,2688,3465,1916,610,1006,1722,8827
9571,2018-4-8,New Orleans Pelicans,80,19475,3404,7058,0.482,821,2263,0.363,2583,4795,0.539,1297,1677,0.773,692,2843,3535,2131,633,1156,1532,8926
9572,2018-4-8,Cleveland Cavaliers,80,19250,3234,6771,0.478,956,2567,0.372,2278,4204,0.542,1446,1853,0.78,670,2695,3365,1872,564,1067,1493,8870
9573,2018-4-8,Denver Nuggets,80,19375,3266,6929,0.471,921,2478,0.372,2345,4451,0.527,1373,1789,0.767,882,2669,3551,2017,616,1151,1493,8826
9574,2018-4-8,Minnesota Timberwolves,80,19300,3281,6887,0.476,642,1800,0.357,2639,5087,0.519,1551,1929,0.804,822,2527,3349,1810,669,938,1458,8755
9575,2018-4-8,Philadelphia 76ers,79,19060,3208,6815,0.471,861,2345,0.367,2347,4470,0.525,1367,1809,0.756,856,2870,3726,2125,651,1261,1755,8644
9576,2018-4-8,Los Angeles Clippers,80,19225,3216,6823,0.471,769,2161,0.356,2447,4662,0.525,1536,2048,0.75,807,2689,3496,1776,613,1121,1603,8737
9577,2018-4-8,Los Angeles Lakers,79,19185,3221,6977,0.462,790,2284,0.346,2431,4693,0.518,1319,1857,0.71,845,2817,3662,1882,603,1210,1674,8551
9578,2018-4-8,Charlotte Hornets,80,19300,3111,6927,0.449,795,2161,0.368,2316,4766,0.486,1621,2174,0.746,808,2828,3636,1716,548,984,1385,8638
9579,2018-4-8,Oklahoma City Thunder,80,19350,3189,7054,0.452,847,2412,0.351,2342,4642,0.505,1367,1917,0.713,1009,2598,3607,1697,726,1079,1616,8592
9580,2018-4-8,Milwaukee Bucks,80,19350,3181,6626,0.48,702,1973,0.356,2479,4653,0.533,1470,1882,0.781,666,2502,3168,1857,703,1042,1717,8534
9581,2018-4-8,Washington Wizards,80,19375,3201,6840,0.468,789,2109,0.374,2412,4731,0.51,1346,1738,0.774,795,2640,3435,2016,632,1120,1697,8537
9582,2018-4-8,Brooklyn Nets,80,19375,3058,6941,0.441,1012,2842,0.356,2046,4099,0.499,1402,1819,0.771,776,2785,3561,1883,494,1135,1661,8530
9583,2018-4-8,Portland Trail Blazers,80,19275,3150,6949,0.453,829,2251,0.368,2321,4698,0.494,1348,1681,0.802,810,2815,3625,1570,556,1040,1549,8477
9584,2018-4-8,Indiana Pacers,80,19275,3255,6891,0.472,724,1954,0.371,2531,4937,0.513,1206,1547,0.78,768,2612,3380,1770,707,1027,1505,8440
9585,2018-4-8,New York Knicks,80,19350,3245,7022,0.462,650,1857,0.35,2595,5165,0.502,1207,1532,0.788,843,2692,3535,1856,538,1135,1640,8347
9586,2018-4-8,Utah Jazz,79,19035,3016,6535,0.462,853,2331,0.366,2163,4204,0.515,1331,1707,0.78,707,2688,3395,1761,685,1108,1545,8216
9587,2018-4-8,Boston Celtics,79,19085,3020,6704,0.45,911,2412,0.378,2109,4292,0.491,1261,1635,0.771,724,2774,3498,1765,575,1051,1568,8212
9588,2018-4-8,Orlando Magic,79,19010,3073,6794,0.452,819,2326,0.352,2254,4468,0.504,1226,1614,0.76,705,2582,3287,1852,596,1098,1522,8191
9589,2018-4-8,Phoenix Suns,80,19225,3066,6973,0.44,740,2225,0.333,2326,4748,0.49,1426,1926,0.74,829,2699,3528,1684,560,1208,1775,8298
9590,2018-4-8,Detroit Pistons,79,19085,3088,6869,0.45,839,2261,0.371,2249,4608,0.488,1160,1563,0.742,805,2663,3468,1789,599,1020,1458,8175
9591,2018-4-8,Miami Heat,80,19425,3098,6804,0.455,887,2458,0.361,2211,4346,0.509,1188,1567,0.758,736,2729,3465,1815,606,1095,1606,8271
9592,2018-4-8,Atlanta Hawks,80,19225,3046,6830,0.446,889,2472,0.36,2157,4358,0.495,1269,1614,0.786,729,2630,3359,1896,621,1207,1563,8250
9593,2018-4-8,Chicago Bulls,80,19375,3095,7111,0.435,883,2488,0.355,2212,4623,0.478,1175,1546,0.76,768,2811,3579,1876,611,1053,1540,8248
9594,2018-4-8,San Antonio Spurs,80,19250,3131,6825,0.459,682,1926,0.354,2449,4899,0.5,1284,1667,0.77,826,2717,3543,1828,613,1015,1378,8228
9595,2018-4-8,Dallas Mavericks,80,19325,3051,6850,0.445,948,2615,0.363,2103,4235,0.497,1146,1495,0.767,638,2662,3300,1814,564,946,1550,8196
9596,2018-4-8,Sacramento Kings,80,19275,3108,6902,0.45,723,1923,0.376,2385,4979,0.479,984,1334,0.738,759,2503,3262,1731,633,1060,1601,7923
9597,2018-4-8,Memphis Grizzlies,79,18985,2886,6529,0.442,724,2070,0.35,2162,4459,0.485,1302,1663,0.783,752,2452,3204,1689,582,1140,1840,7798
9598,2018-4-9,Golden State Warriors,81,19490,3479,6894,0.505,921,2350,0.392,2558,4544,0.563,1346,1652,0.815,682,2847,3529,2388,649,1215,1588,9225
9599,2018-4-9,Houston Rockets,80,19275,3106,6736,0.461,1227,3377,0.363,1879,3359,0.559,1586,2033,0.78,723,2752,3475,1737,688,1049,1554,9025
9600,2018-4-9,Toronto Raptors,80,19325,3295,6990,0.471,947,2634,0.36,2348,4356,0.539,1402,1765,0.794,783,2729,3512,1944,618,1023,1743,8939
9601,2018-4-9,New Orleans Pelicans,80,19475,3404,7058,0.482,821,2263,0.363,2583,4795,0.539,1297,1677,0.773,692,2843,3535,2131,633,1156,1532,8926
9602,2018-4-9,Cleveland Cavaliers,80,19250,3234,6771,0.478,956,2567,0.372,2278,4204,0.542,1446,1853,0.78,670,2695,3365,1872,564,1067,1493,8870
9603,2018-4-9,Denver Nuggets,80,19375,3266,6929,0.471,921,2478,0.372,2345,4451,0.527,1373,1789,0.767,882,2669,3551,2017,616,1151,1493,8826
9604,2018-4-9,Minnesota Timberwolves,80,19300,3281,6887,0.476,642,1800,0.357,2639,5087,0.519,1551,1929,0.804,822,2527,3349,1810,669,938,1458,8755
9605,2018-4-9,Philadelphia 76ers,80,19300,3254,6906,0.471,869,2372,0.366,2385,4534,0.526,1376,1823,0.755,865,2913,3778,2157,660,1271,1774,8753
9606,2018-4-9,Los Angeles Clippers,80,19225,3216,6823,0.471,769,2161,0.356,2447,4662,0.525,1536,2048,0.75,807,2689,3496,1776,613,1121,1603,8737
9607,2018-4-9,Los Angeles Lakers,80,19425,3258,7070,0.461,795,2309,0.344,2463,4761,0.517,1337,1879,0.712,857,2849,3706,1902,611,1222,1696,8648
9608,2018-4-9,Charlotte Hornets,81,19540,3151,7007,0.45,806,2191,0.368,2345,4816,0.487,1647,2204,0.747,813,2859,3672,1743,554,1005,1402,8755
9609,2018-4-9,Oklahoma City Thunder,80,19350,3189,7054,0.452,847,2412,0.351,2342,4642,0.505,1367,1917,0.713,1009,2598,3607,1697,726,1079,1616,8592
9610,2018-4-9,Milwaukee Bucks,80,19350,3181,6626,0.48,702,1973,0.356,2479,4653,0.533,1470,1882,0.781,666,2502,3168,1857,703,1042,1717,8534
9611,2018-4-9,Washington Wizards,80,19375,3201,6840,0.468,789,2109,0.374,2412,4731,0.51,1346,1738,0.774,795,2640,3435,2016,632,1120,1697,8537
9612,2018-4-9,Brooklyn Nets,80,19375,3058,6941,0.441,1012,2842,0.356,2046,4099,0.499,1402,1819,0.771,776,2785,3561,1883,494,1135,1661,8530
9613,2018-4-9,Portland Trail Blazers,80,19275,3150,6949,0.453,829,2251,0.368,2321,4698,0.494,1348,1681,0.802,810,2815,3625,1570,556,1040,1549,8477
9614,2018-4-9,Indiana Pacers,81,19515,3305,6984,0.473,733,1979,0.37,2572,5005,0.514,1220,1565,0.78,775,2644,3419,1797,718,1041,1527,8563
9615,2018-4-9,New York Knicks,80,19350,3245,7022,0.462,650,1857,0.35,2595,5165,0.502,1207,1532,0.788,843,2692,3535,1856,538,1135,1640,8347
9616,2018-4-9,Utah Jazz,80,19275,3058,6618,0.462,866,2367,0.366,2192,4251,0.516,1346,1729,0.778,714,2726,3440,1796,693,1126,1569,8328
9617,2018-4-9,Boston Celtics,80,19325,3062,6786,0.451,920,2435,0.378,2142,4351,0.492,1274,1655,0.77,734,2805,3539,1798,584,1063,1586,8318
9618,2018-4-9,Detroit Pistons,80,19325,3126,6962,0.449,862,2308,0.373,2264,4654,0.486,1178,1586,0.743,819,2687,3506,1819,609,1032,1476,8292
9619,2018-4-9,Orlando Magic,80,19250,3115,6883,0.453,826,2349,0.352,2289,4534,0.505,1236,1631,0.758,711,2618,3329,1877,608,1108,1539,8292
9620,2018-4-9,Phoenix Suns,81,19465,3105,7065,0.439,750,2260,0.332,2355,4805,0.49,1438,1942,0.74,837,2735,3572,1708,564,1221,1791,8398
9621,2018-4-9,Miami Heat,80,19425,3098,6804,0.455,887,2458,0.361,2211,4346,0.509,1188,1567,0.758,736,2729,3465,1815,606,1095,1606,8271
9622,2018-4-9,Atlanta Hawks,81,19465,3089,6916,0.447,904,2507,0.361,2185,4409,0.496,1280,1628,0.786,734,2662,3396,1919,628,1220,1582,8362
9623,2018-4-9,Chicago Bulls,80,19375,3095,7111,0.435,883,2488,0.355,2212,4623,0.478,1175,1546,0.76,768,2811,3579,1876,611,1053,1540,8248
9624,2018-4-9,San Antonio Spurs,80,19250,3131,6825,0.459,682,1926,0.354,2449,4899,0.5,1284,1667,0.77,826,2717,3543,1828,613,1015,1378,8228
9625,2018-4-9,Dallas Mavericks,81,19565,3091,6944,0.445,959,2655,0.361,2132,4289,0.497,1152,1508,0.764,648,2695,3343,1838,570,957,1559,8293
9626,2018-4-9,Memphis Grizzlies,80,19225,2934,6612,0.444,740,2103,0.352,2194,4509,0.487,1320,1687,0.782,760,2487,3247,1725,593,1152,1858,7928
9627,2018-4-9,Sacramento Kings,80,19275,3108,6902,0.45,723,1923,0.376,2385,4979,0.479,984,1334,0.738,759,2503,3262,1731,633,1060,1601,7923
9628,2018-4-10,Golden State Warriors,81,19490,3479,6894,0.505,921,2350,0.392,2558,4544,0.563,1346,1652,0.815,682,2847,3529,2388,649,1215,1588,9225
9629,2018-4-10,Houston Rockets,80,19275,3106,6736,0.461,1227,3377,0.363,1879,3359,0.559,1586,2033,0.78,723,2752,3475,1737,688,1049,1554,9025
9630,2018-4-10,Toronto Raptors,81,19565,3341,7077,0.472,959,2673,0.359,2382,4404,0.541,1406,1769,0.795,791,2769,3560,1971,621,1032,1760,9047
9631,2018-4-10,New Orleans Pelicans,81,19715,3448,7153,0.482,832,2293,0.363,2616,4860,0.538,1311,1697,0.773,701,2884,3585,2165,646,1163,1550,9039
9632,2018-4-10,Cleveland Cavaliers,81,19490,3274,6856,0.478,975,2612,0.373,2299,4244,0.542,1470,1881,0.781,677,2730,3407,1901,573,1077,1508,8993
9633,2018-4-10,Denver Nuggets,81,19615,3297,7012,0.47,927,2504,0.37,2370,4508,0.526,1393,1815,0.767,892,2711,3603,2039,623,1163,1511,8914
9634,2018-4-10,Minnesota Timberwolves,81,19540,3323,6974,0.476,649,1822,0.356,2674,5152,0.519,1573,1955,0.805,840,2561,3401,1837,679,955,1476,8868
9635,2018-4-10,Philadelphia 76ers,80,19300,3254,6906,0.471,869,2372,0.366,2385,4534,0.526,1376,1823,0.755,865,2913,3778,2157,660,1271,1774,8753
9636,2018-4-10,Los Angeles Clippers,81,19465,3261,6921,0.471,771,2178,0.354,2490,4743,0.525,1544,2067,0.747,824,2733,3557,1805,619,1137,1621,8837
9637,2018-4-10,Los Angeles Lakers,80,19425,3258,7070,0.461,795,2309,0.344,2463,4761,0.517,1337,1879,0.712,857,2849,3706,1902,611,1222,1696,8648
9638,2018-4-10,Charlotte Hornets,81,19540,3151,7007,0.45,806,2191,0.368,2345,4816,0.487,1647,2204,0.747,813,2859,3672,1743,554,1005,1402,8755
9639,2018-4-10,Oklahoma City Thunder,81,19590,3224,7135,0.452,861,2447,0.352,2363,4688,0.504,1398,1955,0.715,1016,2634,3650,1718,735,1088,1631,8707
9640,2018-4-10,Washington Wizards,80,19375,3201,6840,0.468,789,2109,0.374,2412,4731,0.51,1346,1738,0.774,795,2640,3435,2016,632,1120,1697,8537
9641,2018-4-10,Brooklyn Nets,81,19615,3099,7023,0.441,1030,2884,0.357,2069,4139,0.5,1416,1834,0.772,782,2817,3599,1915,502,1152,1676,8644
9642,2018-4-10,Milwaukee Bucks,81,19590,3220,6717,0.479,711,1999,0.356,2509,4718,0.532,1485,1900,0.782,678,2546,3224,1883,716,1058,1735,8636
9643,2018-4-10,Portland Trail Blazers,81,19515,3181,7043,0.452,836,2284,0.366,2345,4759,0.493,1361,1699,0.801,828,2854,3682,1580,564,1057,1577,8559
9644,2018-4-10,Indiana Pacers,81,19515,3305,6984,0.473,733,1979,0.37,2572,5005,0.514,1220,1565,0.78,775,2644,3419,1797,718,1041,1527,8563
9645,2018-4-10,New York Knicks,81,19590,3291,7109,0.463,661,1887,0.35,2630,5222,0.504,1213,1544,0.786,851,2721,3572,1882,542,1149,1660,8456
9646,2018-4-10,Utah Jazz,80,19275,3058,6618,0.462,866,2367,0.366,2192,4251,0.516,1346,1729,0.778,714,2726,3440,1796,693,1126,1569,8328
9647,2018-4-10,Boston Celtics,80,19325,3062,6786,0.451,920,2435,0.378,2142,4351,0.492,1274,1655,0.77,734,2805,3539,1798,584,1063,1586,8318
9648,2018-4-10,Phoenix Suns,81,19465,3105,7065,0.439,750,2260,0.332,2355,4805,0.49,1438,1942,0.74,837,2735,3572,1708,564,1221,1791,8398
9649,2018-4-10,Detroit Pistons,81,19565,3161,7040,0.449,871,2338,0.373,2290,4702,0.487,1197,1611,0.743,823,2716,3539,1841,616,1035,1487,8390
9650,2018-4-10,Orlando Magic,81,19490,3149,6965,0.452,831,2373,0.35,2318,4592,0.505,1249,1651,0.757,716,2656,3372,1901,616,1127,1553,8378
9651,2018-4-10,Miami Heat,81,19665,3138,6891,0.455,892,2480,0.36,2246,4411,0.509,1196,1581,0.756,744,2764,3508,1836,612,1110,1630,8364
9652,2018-4-10,Atlanta Hawks,81,19465,3089,6916,0.447,904,2507,0.361,2185,4409,0.496,1280,1628,0.786,734,2662,3396,1919,628,1220,1582,8362
9653,2018-4-10,Chicago Bulls,81,19615,3138,7200,0.436,895,2516,0.356,2243,4684,0.479,1182,1558,0.759,778,2845,3623,1902,618,1072,1557,8353
9654,2018-4-10,San Antonio Spurs,81,19490,3165,6907,0.458,688,1953,0.352,2477,4954,0.5,1308,1696,0.771,837,2751,3588,1846,619,1023,1392,8326
9655,2018-4-10,Dallas Mavericks,81,19565,3091,6944,0.445,959,2655,0.361,2132,4289,0.497,1152,1508,0.764,648,2695,3343,1838,570,957,1559,8293
9656,2018-4-10,Memphis Grizzlies,81,19465,2969,6697,0.443,745,2121,0.351,2224,4576,0.486,1339,1708,0.784,770,2512,3282,1745,604,1169,1878,8022
9657,2018-4-10,Sacramento Kings,81,19515,3141,6983,0.45,731,1941,0.377,2410,5042,0.478,995,1351,0.736,771,2536,3307,1747,637,1072,1625,8008
9658,2018-4-11,Golden State Warriors,82,19730,3509,6980,0.503,926,2369,0.391,2583,4611,0.56,1360,1668,0.815,691,2877,3568,2402,656,1230,1606,9304
9659,2018-4-11,Houston Rockets,81,19515,3143,6824,0.461,1243,3424,0.363,1900,3400,0.559,1601,2049,0.781,731,2793,3524,1756,697,1067,1573,9130
9660,2018-4-11,Toronto Raptors,81,19565,3341,7077,0.472,959,2673,0.359,2382,4404,0.541,1406,1769,0.795,791,2769,3560,1971,621,1032,1760,9047
9661,2018-4-11,New Orleans Pelicans,81,19715,3448,7153,0.482,832,2293,0.363,2616,4860,0.538,1311,1697,0.773,701,2884,3585,2165,646,1163,1550,9039
9662,2018-4-11,Cleveland Cavaliers,81,19490,3274,6856,0.478,975,2612,0.373,2299,4244,0.542,1470,1881,0.781,677,2730,3407,1901,573,1077,1508,8993
9663,2018-4-11,Denver Nuggets,81,19615,3297,7012,0.47,927,2504,0.37,2370,4508,0.526,1393,1815,0.767,892,2711,3603,2039,623,1163,1511,8914
9664,2018-4-11,Philadelphia 76ers,81,19540,3297,6993,0.471,886,2409,0.368,2411,4584,0.526,1394,1853,0.752,876,2956,3832,2186,667,1289,1796,8874
9665,2018-4-11,Minnesota Timberwolves,81,19540,3323,6974,0.476,649,1822,0.356,2674,5152,0.519,1573,1955,0.805,840,2561,3401,1837,679,955,1476,8868
9666,2018-4-11,Los Angeles Clippers,81,19465,3261,6921,0.471,771,2178,0.354,2490,4743,0.525,1544,2067,0.747,824,2733,3557,1805,619,1137,1621,8837
9667,2018-4-11,Charlotte Hornets,82,19780,3197,7106,0.45,824,2233,0.369,2373,4873,0.487,1656,2216,0.747,826,2901,3727,1770,559,1011,1410,8874
9668,2018-4-11,Los Angeles Lakers,81,19665,3296,7160,0.46,805,2345,0.343,2491,4815,0.517,1350,1894,0.713,866,2887,3753,1924,625,1239,1715,8747
9669,2018-4-11,Oklahoma City Thunder,81,19590,3224,7135,0.452,861,2447,0.352,2363,4688,0.504,1398,1955,0.715,1016,2634,3650,1718,735,1088,1631,8707
9670,2018-4-11,Washington Wizards,81,19615,3242,6923,0.468,804,2139,0.376,2438,4784,0.51,1362,1758,0.775,805,2681,3486,2048,640,1140,1721,8650
9671,2018-4-11,Brooklyn Nets,81,19615,3099,7023,0.441,1030,2884,0.357,2069,4139,0.5,1416,1834,0.772,782,2817,3599,1915,502,1152,1676,8644
9672,2018-4-11,Milwaukee Bucks,81,19590,3220,6717,0.479,711,1999,0.356,2509,4718,0.532,1485,1900,0.782,678,2546,3224,1883,716,1058,1735,8636
9673,2018-4-11,Portland Trail Blazers,81,19515,3181,7043,0.452,836,2284,0.366,2345,4759,0.493,1361,1699,0.801,828,2854,3682,1580,564,1057,1577,8559
9674,2018-4-11,Indiana Pacers,82,19755,3345,7083,0.472,741,2010,0.369,2604,5073,0.513,1225,1573,0.779,788,2684,3472,1819,721,1048,1543,8656
9675,2018-4-11,New York Knicks,81,19590,3291,7109,0.463,661,1887,0.35,2630,5222,0.504,1213,1544,0.786,851,2721,3572,1882,542,1149,1660,8456
9676,2018-4-11,Utah Jazz,81,19515,3106,6708,0.463,879,2402,0.366,2227,4306,0.517,1356,1742,0.778,726,2768,3494,1821,703,1141,1589,8447
9677,2018-4-11,Phoenix Suns,82,19705,3153,7141,0.442,763,2286,0.334,2390,4855,0.492,1453,1963,0.74,842,2776,3618,1743,569,1235,1807,8522
9678,2018-4-11,Boston Celtics,81,19565,3095,6873,0.45,933,2468,0.378,2162,4405,0.491,1296,1682,0.771,747,2836,3583,1820,598,1079,1604,8419
9679,2018-4-11,Detroit Pistons,81,19565,3161,7040,0.449,871,2338,0.373,2290,4702,0.487,1197,1611,0.743,823,2716,3539,1841,616,1035,1487,8390
9680,2018-4-11,Atlanta Hawks,82,19705,3130,7014,0.446,917,2544,0.36,2213,4470,0.495,1298,1654,0.785,742,2693,3435,1946,638,1230,1606,8475
9681,2018-4-11,Orlando Magic,81,19490,3149,6965,0.452,831,2373,0.35,2318,4592,0.505,1249,1651,0.757,716,2656,3372,1901,616,1127,1553,8378
9682,2018-4-11,Miami Heat,81,19665,3138,6891,0.455,892,2480,0.36,2246,4411,0.509,1196,1581,0.756,744,2764,3508,1836,612,1110,1630,8364
9683,2018-4-11,Chicago Bulls,81,19615,3138,7200,0.436,895,2516,0.356,2243,4684,0.479,1182,1558,0.759,778,2845,3623,1902,618,1072,1557,8353
9684,2018-4-11,San Antonio Spurs,81,19490,3165,6907,0.458,688,1953,0.352,2477,4954,0.5,1308,1696,0.771,837,2751,3588,1846,619,1023,1392,8326
9685,2018-4-11,Dallas Mavericks,82,19805,3128,7041,0.444,967,2688,0.36,2161,4353,0.496,1167,1530,0.763,666,2717,3383,1858,578,965,1578,8390
9686,2018-4-11,Memphis Grizzlies,81,19465,2969,6697,0.443,745,2121,0.351,2224,4576,0.486,1339,1708,0.784,770,2512,3282,1745,604,1169,1878,8022
9687,2018-4-11,Sacramento Kings,81,19515,3141,6983,0.45,731,1941,0.377,2410,5042,0.478,995,1351,0.736,771,2536,3307,1747,637,1072,1625,8008
9688,2018-4-12,Golden State Warriors,82,19730,3509,6980,0.503,926,2369,0.391,2583,4611,0.56,1360,1668,0.815,691,2877,3568,2402,656,1230,1606,9304
9689,2018-4-12,Houston Rockets,82,19755,3174,6906,0.46,1256,3470,0.362,1918,3436,0.558,1609,2061,0.781,739,2825,3564,1767,699,1081,1597,9213
9690,2018-4-12,New Orleans Pelicans,82,19955,3500,7241,0.483,837,2312,0.362,2663,4929,0.54,1324,1716,0.772,712,2924,3636,2195,657,1182,1570,9161
9691,2018-4-12,Toronto Raptors,82,19830,3383,7169,0.472,968,2703,0.358,2415,4466,0.541,1422,1790,0.794,800,2807,3607,1995,626,1045,1784,9156
9692,2018-4-12,Cleveland Cavaliers,82,19730,3311,6950,0.476,981,2636,0.372,2330,4314,0.54,1488,1909,0.779,694,2761,3455,1916,582,1091,1523,9091
9693,2018-4-12,Denver Nuggets,82,19880,3338,7102,0.47,940,2536,0.371,2398,4566,0.525,1404,1833,0.766,902,2748,3650,2058,627,1175,1533,9020
9694,2018-4-12,Philadelphia 76ers,82,19780,3349,7098,0.472,901,2445,0.369,2448,4653,0.526,1405,1868,0.752,893,2996,3889,2221,682,1301,1813,9004
9695,2018-4-12,Minnesota Timberwolves,82,19805,3365,7063,0.476,658,1845,0.357,2707,5218,0.519,1592,1980,0.804,848,2593,3441,1861,689,963,1495,8980
9696,2018-4-12,Los Angeles Clippers,82,19705,3302,7004,0.471,777,2196,0.354,2525,4808,0.525,1556,2095,0.743,832,2766,3598,1832,627,1154,1638,8937
9697,2018-4-12,Charlotte Hornets,82,19780,3197,7106,0.45,824,2233,0.369,2373,4873,0.487,1656,2216,0.747,826,2901,3727,1770,559,1011,1410,8874
9698,2018-4-12,Los Angeles Lakers,82,19905,3338,7248,0.461,822,2384,0.345,2516,4864,0.517,1364,1910,0.714,876,2926,3802,1949,633,1256,1738,8862
9699,2018-4-12,Oklahoma City Thunder,82,19830,3271,7220,0.453,881,2490,0.354,2390,4730,0.505,1421,1987,0.715,1024,2671,3695,1750,743,1102,1654,8844
9700,2018-4-12,Washington Wizards,82,19855,3275,7018,0.467,814,2173,0.375,2461,4845,0.508,1378,1785,0.772,823,2713,3536,2065,645,1152,1746,8742
9701,2018-4-12,Brooklyn Nets,82,19855,3136,7114,0.441,1041,2924,0.356,2095,4190,0.5,1428,1850,0.772,792,2851,3643,1942,512,1167,1688,8741
9702,2018-4-12,Milwaukee Bucks,82,19830,3257,6807,0.478,718,2024,0.355,2539,4783,0.531,1499,1916,0.782,688,2579,3267,1905,722,1078,1752,8731
9703,2018-4-12,Portland Trail Blazers,82,19755,3222,7132,0.452,845,2308,0.366,2377,4824,0.493,1372,1715,0.8,835,2893,3728,1599,573,1067,1599,8661
9704,2018-4-12,Indiana Pacers,82,19755,3345,7083,0.472,741,2010,0.369,2604,5073,0.513,1225,1573,0.779,788,2684,3472,1819,721,1048,1543,8656
9705,2018-4-12,New York Knicks,82,19830,3334,7194,0.463,673,1914,0.352,2661,5280,0.504,1225,1557,0.787,859,2752,3611,1912,552,1164,1682,8566
9706,2018-4-12,Utah Jazz,82,19755,3139,6797,0.462,887,2425,0.366,2252,4372,0.515,1375,1766,0.779,740,2807,3547,1839,708,1155,1608,8540
9707,2018-4-12,Boston Celtics,82,19805,3141,6975,0.45,939,2492,0.377,2202,4483,0.491,1308,1697,0.771,767,2878,3645,1842,604,1092,1618,8529
9708,2018-4-12,Phoenix Suns,82,19705,3153,7141,0.442,763,2286,0.334,2390,4855,0.492,1453,1963,0.74,842,2776,3618,1743,569,1235,1807,8522
9709,2018-4-12,Detroit Pistons,82,19805,3208,7129,0.45,886,2373,0.373,2322,4756,0.488,1207,1621,0.745,830,2756,3586,1868,628,1046,1508,8509
9710,2018-4-12,Atlanta Hawks,82,19705,3130,7014,0.446,917,2544,0.36,2213,4470,0.495,1298,1654,0.785,742,2693,3435,1946,638,1230,1606,8475
9711,2018-4-12,Orlando Magic,82,19730,3182,7042,0.452,844,2405,0.351,2338,4637,0.504,1271,1678,0.757,722,2692,3414,1921,622,1143,1580,8479
9712,2018-4-12,Miami Heat,82,19930,3184,6997,0.455,903,2506,0.36,2281,4491,0.508,1209,1601,0.755,763,2801,3564,1862,620,1119,1648,8480
9713,2018-4-12,Chicago Bulls,82,19855,3170,7286,0.435,906,2550,0.355,2264,4736,0.478,1194,1576,0.758,790,2873,3663,1923,626,1090,1572,8440
9714,2018-4-12,San Antonio Spurs,82,19730,3202,6999,0.457,696,1977,0.352,2506,5022,0.499,1324,1715,0.772,849,2777,3626,1868,628,1040,1409,8424
9715,2018-4-12,Dallas Mavericks,82,19805,3128,7041,0.444,967,2688,0.36,2161,4353,0.496,1167,1530,0.763,666,2717,3383,1858,578,965,1578,8390
9716,2018-4-12,Memphis Grizzlies,82,19705,3013,6788,0.444,758,2152,0.352,2255,4636,0.486,1361,1732,0.786,779,2544,3323,1767,613,1182,1900,8145
9717,2018-4-12,Sacramento Kings,82,19755,3179,7063,0.45,738,1967,0.375,2441,5096,0.479,1008,1371,0.735,777,2578,3355,1769,643,1083,1639,8104
9718,2018-4-13,Golden State Warriors,82,19730,3509,6980,0.503,926,2369,0.391,2583,4611,0.56,1360,1668,0.815,691,2877,3568,2402,656,1230,1606,9304
9719,2018-4-13,Houston Rockets,82,19755,3174,6906,0.46,1256,3470,0.362,1918,3436,0.558,1609,2061,0.781,739,2825,3564,1767,699,1081,1597,9213
9720,2018-4-13,New Orleans Pelicans,82,19955,3500,7241,0.483,837,2312,0.362,2663,4929,0.54,1324,1716,0.772,712,2924,3636,2195,657,1182,1570,9161
9721,2018-4-13,Toronto Raptors,82,19830,3383,7169,0.472,968,2703,0.358,2415,4466,0.541,1422,1790,0.794,800,2807,3607,1995,626,1045,1784,9156
9722,2018-4-13,Cleveland Cavaliers,82,19730,3311,6950,0.476,981,2636,0.372,2330,4314,0.54,1488,1909,0.779,694,2761,3455,1916,582,1091,1523,9091
9723,2018-4-13,Denver Nuggets,82,19880,3338,7102,0.47,940,2536,0.371,2398,4566,0.525,1404,1833,0.766,902,2748,3650,2058,627,1175,1533,9020
9724,2018-4-13,Philadelphia 76ers,82,19780,3349,7098,0.472,901,2445,0.369,2448,4653,0.526,1405,1868,0.752,893,2996,3889,2221,682,1301,1813,9004
9725,2018-4-13,Minnesota Timberwolves,82,19805,3365,7063,0.476,658,1845,0.357,2707,5218,0.519,1592,1980,0.804,848,2593,3441,1861,689,963,1495,8980
9726,2018-4-13,Los Angeles Clippers,82,19705,3302,7004,0.471,777,2196,0.354,2525,4808,0.525,1556,2095,0.743,832,2766,3598,1832,627,1154,1638,8937
9727,2018-4-13,Charlotte Hornets,82,19780,3197,7106,0.45,824,2233,0.369,2373,4873,0.487,1656,2216,0.747,826,2901,3727,1770,559,1011,1410,8874
9728,2018-4-13,Los Angeles Lakers,82,19905,3338,7248,0.461,822,2384,0.345,2516,4864,0.517,1364,1910,0.714,876,2926,3802,1949,633,1256,1738,8862
9729,2018-4-13,Oklahoma City Thunder,82,19830,3271,7220,0.453,881,2490,0.354,2390,4730,0.505,1421,1987,0.715,1024,2671,3695,1750,743,1102,1654,8844
9730,2018-4-13,Washington Wizards,82,19855,3275,7018,0.467,814,2173,0.375,2461,4845,0.508,1378,1785,0.772,823,2713,3536,2065,645,1152,1746,8742
9731,2018-4-13,Brooklyn Nets,82,19855,3136,7114,0.441,1041,2924,0.356,2095,4190,0.5,1428,1850,0.772,792,2851,3643,1942,512,1167,1688,8741
9732,2018-4-13,Milwaukee Bucks,82,19830,3257,6807,0.478,718,2024,0.355,2539,4783,0.531,1499,1916,0.782,688,2579,3267,1905,722,1078,1752,8731
9733,2018-4-13,Portland Trail Blazers,82,19755,3222,7132,0.452,845,2308,0.366,2377,4824,0.493,1372,1715,0.8,835,2893,3728,1599,573,1067,1599,8661
9734,2018-4-13,Indiana Pacers,82,19755,3345,7083,0.472,741,2010,0.369,2604,5073,0.513,1225,1573,0.779,788,2684,3472,1819,721,1048,1543,8656
9735,2018-4-13,New York Knicks,82,19830,3334,7194,0.463,673,1914,0.352,2661,5280,0.504,1225,1557,0.787,859,2752,3611,1912,552,1164,1682,8566
9736,2018-4-13,Utah Jazz,82,19755,3139,6797,0.462,887,2425,0.366,2252,4372,0.515,1375,1766,0.779,740,2807,3547,1839,708,1155,1608,8540
9737,2018-4-13,Boston Celtics,82,19805,3141,6975,0.45,939,2492,0.377,2202,4483,0.491,1308,1697,0.771,767,2878,3645,1842,604,1092,1618,8529
9738,2018-4-13,Phoenix Suns,82,19705,3153,7141,0.442,763,2286,0.334,2390,4855,0.492,1453,1963,0.74,842,2776,3618,1743,569,1235,1807,8522
9739,2018-4-13,Detroit Pistons,82,19805,3208,7129,0.45,886,2373,0.373,2322,4756,0.488,1207,1621,0.745,830,2756,3586,1868,628,1046,1508,8509
9740,2018-4-13,Atlanta Hawks,82,19705,3130,7014,0.446,917,2544,0.36,2213,4470,0.495,1298,1654,0.785,742,2693,3435,1946,638,1230,1606,8475
9741,2018-4-13,Orlando Magic,82,19730,3182,7042,0.452,844,2405,0.351,2338,4637,0.504,1271,1678,0.757,722,2692,3414,1921,622,1143,1580,8479
9742,2018-4-13,Miami Heat,82,19930,3184,6997,0.455,903,2506,0.36,2281,4491,0.508,1209,1601,0.755,763,2801,3564,1862,620,1119,1648,8480
9743,2018-4-13,Chicago Bulls,82,19855,3170,7286,0.435,906,2550,0.355,2264,4736,0.478,1194,1576,0.758,790,2873,3663,1923,626,1090,1572,8440
9744,2018-4-13,San Antonio Spurs,82,19730,3202,6999,0.457,696,1977,0.352,2506,5022,0.499,1324,1715,0.772,849,2777,3626,1868,628,1040,1409,8424
9745,2018-4-13,Dallas Mavericks,82,19805,3128,7041,0.444,967,2688,0.36,2161,4353,0.496,1167,1530,0.763,666,2717,3383,1858,578,965,1578,8390
9746,2018-4-13,Memphis Grizzlies,82,19705,3013,6788,0.444,758,2152,0.352,2255,4636,0.486,1361,1732,0.786,779,2544,3323,1767,613,1182,1900,8145
9747,2018-4-13,Sacramento Kings,82,19755,3179,7063,0.45,738,1967,0.375,2441,5096,0.479,1008,1371,0.735,777,2578,3355,1769,643,1083,1639,8104
9748,2018-4-14,Golden State Warriors,82,19730,3509,6980,0.503,926,2369,0.391,2583,4611,0.56,1360,1668,0.815,691,2877,3568,2402,656,1230,1606,9304
9749,2018-4-14,Houston Rockets,82,19755,3174,6906,0.46,1256,3470,0.362,1918,3436,0.558,1609,2061,0.781,739,2825,3564,1767,699,1081,1597,9213
9750,2018-4-14,New Orleans Pelicans,82,19955,3500,7241,0.483,837,2312,0.362,2663,4929,0.54,1324,1716,0.772,712,2924,3636,2195,657,1182,1570,9161
9751,2018-4-14,Toronto Raptors,82,19830,3383,7169,0.472,968,2703,0.358,2415,4466,0.541,1422,1790,0.794,800,2807,3607,1995,626,1045,1784,9156
9752,2018-4-14,Cleveland Cavaliers,82,19730,3311,6950,0.476,981,2636,0.372,2330,4314,0.54,1488,1909,0.779,694,2761,3455,1916,582,1091,1523,9091
9753,2018-4-14,Denver Nuggets,82,19880,3338,7102,0.47,940,2536,0.371,2398,4566,0.525,1404,1833,0.766,902,2748,3650,2058,627,1175,1533,9020
9754,2018-4-14,Philadelphia 76ers,82,19780,3349,7098,0.472,901,2445,0.369,2448,4653,0.526,1405,1868,0.752,893,2996,3889,2221,682,1301,1813,9004
9755,2018-4-14,Minnesota Timberwolves,82,19805,3365,7063,0.476,658,1845,0.357,2707,5218,0.519,1592,1980,0.804,848,2593,3441,1861,689,963,1495,8980
9756,2018-4-14,Los Angeles Clippers,82,19705,3302,7004,0.471,777,2196,0.354,2525,4808,0.525,1556,2095,0.743,832,2766,3598,1832,627,1154,1638,8937
9757,2018-4-14,Charlotte Hornets,82,19780,3197,7106,0.45,824,2233,0.369,2373,4873,0.487,1656,2216,0.747,826,2901,3727,1770,559,1011,1410,8874
9758,2018-4-14,Los Angeles Lakers,82,19905,3338,7248,0.461,822,2384,0.345,2516,4864,0.517,1364,1910,0.714,876,2926,3802,1949,633,1256,1738,8862
9759,2018-4-14,Oklahoma City Thunder,82,19830,3271,7220,0.453,881,2490,0.354,2390,4730,0.505,1421,1987,0.715,1024,2671,3695,1750,743,1102,1654,8844
9760,2018-4-14,Washington Wizards,82,19855,3275,7018,0.467,814,2173,0.375,2461,4845,0.508,1378,1785,0.772,823,2713,3536,2065,645,1152,1746,8742
9761,2018-4-14,Brooklyn Nets,82,19855,3136,7114,0.441,1041,2924,0.356,2095,4190,0.5,1428,1850,0.772,792,2851,3643,1942,512,1167,1688,8741
9762,2018-4-14,Milwaukee Bucks,82,19830,3257,6807,0.478,718,2024,0.355,2539,4783,0.531,1499,1916,0.782,688,2579,3267,1905,722,1078,1752,8731
9763,2018-4-14,Portland Trail Blazers,82,19755,3222,7132,0.452,845,2308,0.366,2377,4824,0.493,1372,1715,0.8,835,2893,3728,1599,573,1067,1599,8661
9764,2018-4-14,Indiana Pacers,82,19755,3345,7083,0.472,741,2010,0.369,2604,5073,0.513,1225,1573,0.779,788,2684,3472,1819,721,1048,1543,8656
9765,2018-4-14,New York Knicks,82,19830,3334,7194,0.463,673,1914,0.352,2661,5280,0.504,1225,1557,0.787,859,2752,3611,1912,552,1164,1682,8566
9766,2018-4-14,Utah Jazz,82,19755,3139,6797,0.462,887,2425,0.366,2252,4372,0.515,1375,1766,0.779,740,2807,3547,1839,708,1155,1608,8540
9767,2018-4-14,Boston Celtics,82,19805,3141,6975,0.45,939,2492,0.377,2202,4483,0.491,1308,1697,0.771,767,2878,3645,1842,604,1092,1618,8529
9768,2018-4-14,Phoenix Suns,82,19705,3153,7141,0.442,763,2286,0.334,2390,4855,0.492,1453,1963,0.74,842,2776,3618,1743,569,1235,1807,8522
9769,2018-4-14,Detroit Pistons,82,19805,3208,7129,0.45,886,2373,0.373,2322,4756,0.488,1207,1621,0.745,830,2756,3586,1868,628,1046,1508,8509
9770,2018-4-14,Atlanta Hawks,82,19705,3130,7014,0.446,917,2544,0.36,2213,4470,0.495,1298,1654,0.785,742,2693,3435,1946,638,1230,1606,8475
9771,2018-4-14,Orlando Magic,82,19730,3182,7042,0.452,844,2405,0.351,2338,4637,0.504,1271,1678,0.757,722,2692,3414,1921,622,1143,1580,8479
9772,2018-4-14,Miami Heat,82,19930,3184,6997,0.455,903,2506,0.36,2281,4491,0.508,1209,1601,0.755,763,2801,3564,1862,620,1119,1648,8480
9773,2018-4-14,Chicago Bulls,82,19855,3170,7286,0.435,906,2550,0.355,2264,4736,0.478,1194,1576,0.758,790,2873,3663,1923,626,1090,1572,8440
9774,2018-4-14,San Antonio Spurs,82,19730,3202,6999,0.457,696,1977,0.352,2506,5022,0.499,1324,1715,0.772,849,2777,3626,1868,628,1040,1409,8424
9775,2018-4-14,Dallas Mavericks,82,19805,3128,7041,0.444,967,2688,0.36,2161,4353,0.496,1167,1530,0.763,666,2717,3383,1858,578,965,1578,8390
9776,2018-4-14,Memphis Grizzlies,82,19705,3013,6788,0.444,758,2152,0.352,2255,4636,0.486,1361,1732,0.786,779,2544,3323,1767,613,1182,1900,8145
9777,2018-4-14,Sacramento Kings,82,19755,3179,7063,0.45,738,1967,0.375,2441,5096,0.479,1008,1371,0.735,777,2578,3355,1769,643,1083,1639,8104
9778,2018-4-15,Golden State Warriors,82,19730,3509,6980,0.503,926,2369,0.391,2583,4611,0.56,1360,1668,0.815,691,2877,3568,2402,656,1230,1606,9304
9779,2018-4-15,Houston Rockets,82,19755,3174,6906,0.46,1256,3470,0.362,1918,3436,0.558,1609,2061,0.781,739,2825,3564,1767,699,1081,1597,9213
9780,2018-4-15,New Orleans Pelicans,82,19955,3500,7241,0.483,837,2312,0.362,2663,4929,0.54,1324,1716,0.772,712,2924,3636,2195,657,1182,1570,9161
9781,2018-4-15,Toronto Raptors,82,19830,3383,7169,0.472,968,2703,0.358,2415,4466,0.541,1422,1790,0.794,800,2807,3607,1995,626,1045,1784,9156
9782,2018-4-15,Cleveland Cavaliers,82,19730,3311,6950,0.476,981,2636,0.372,2330,4314,0.54,1488,1909,0.779,694,2761,3455,1916,582,1091,1523,9091
9783,2018-4-15,Denver Nuggets,82,19880,3338,7102,0.47,940,2536,0.371,2398,4566,0.525,1404,1833,0.766,902,2748,3650,2058,627,1175,1533,9020
9784,2018-4-15,Philadelphia 76ers,82,19780,3349,7098,0.472,901,2445,0.369,2448,4653,0.526,1405,1868,0.752,893,2996,3889,2221,682,1301,1813,9004
9785,2018-4-15,Minnesota Timberwolves,82,19805,3365,7063,0.476,658,1845,0.357,2707,5218,0.519,1592,1980,0.804,848,2593,3441,1861,689,963,1495,8980
9786,2018-4-15,Los Angeles Clippers,82,19705,3302,7004,0.471,777,2196,0.354,2525,4808,0.525,1556,2095,0.743,832,2766,3598,1832,627,1154,1638,8937
9787,2018-4-15,Charlotte Hornets,82,19780,3197,7106,0.45,824,2233,0.369,2373,4873,0.487,1656,2216,0.747,826,2901,3727,1770,559,1011,1410,8874
9788,2018-4-15,Los Angeles Lakers,82,19905,3338,7248,0.461,822,2384,0.345,2516,4864,0.517,1364,1910,0.714,876,2926,3802,1949,633,1256,1738,8862
9789,2018-4-15,Oklahoma City Thunder,82,19830,3271,7220,0.453,881,2490,0.354,2390,4730,0.505,1421,1987,0.715,1024,2671,3695,1750,743,1102,1654,8844
9790,2018-4-15,Washington Wizards,82,19855,3275,7018,0.467,814,2173,0.375,2461,4845,0.508,1378,1785,0.772,823,2713,3536,2065,645,1152,1746,8742
9791,2018-4-15,Brooklyn Nets,82,19855,3136,7114,0.441,1041,2924,0.356,2095,4190,0.5,1428,1850,0.772,792,2851,3643,1942,512,1167,1688,8741
9792,2018-4-15,Milwaukee Bucks,82,19830,3257,6807,0.478,718,2024,0.355,2539,4783,0.531,1499,1916,0.782,688,2579,3267,1905,722,1078,1752,8731
9793,2018-4-15,Portland Trail Blazers,82,19755,3222,7132,0.452,845,2308,0.366,2377,4824,0.493,1372,1715,0.8,835,2893,3728,1599,573,1067,1599,8661
9794,2018-4-15,Indiana Pacers,82,19755,3345,7083,0.472,741,2010,0.369,2604,5073,0.513,1225,1573,0.779,788,2684,3472,1819,721,1048,1543,8656
9795,2018-4-15,New York Knicks,82,19830,3334,7194,0.463,673,1914,0.352,2661,5280,0.504,1225,1557,0.787,859,2752,3611,1912,552,1164,1682,8566
9796,2018-4-15,Utah Jazz,82,19755,3139,6797,0.462,887,2425,0.366,2252,4372,0.515,1375,1766,0.779,740,2807,3547,1839,708,1155,1608,8540
9797,2018-4-15,Boston Celtics,82,19805,3141,6975,0.45,939,2492,0.377,2202,4483,0.491,1308,1697,0.771,767,2878,3645,1842,604,1092,1618,8529
9798,2018-4-15,Phoenix Suns,82,19705,3153,7141,0.442,763,2286,0.334,2390,4855,0.492,1453,1963,0.74,842,2776,3618,1743,569,1235,1807,8522
9799,2018-4-15,Detroit Pistons,82,19805,3208,7129,0.45,886,2373,0.373,2322,4756,0.488,1207,1621,0.745,830,2756,3586,1868,628,1046,1508,8509
9800,2018-4-15,Atlanta Hawks,82,19705,3130,7014,0.446,917,2544,0.36,2213,4470,0.495,1298,1654,0.785,742,2693,3435,1946,638,1230,1606,8475
9801,2018-4-15,Orlando Magic,82,19730,3182,7042,0.452,844,2405,0.351,2338,4637,0.504,1271,1678,0.757,722,2692,3414,1921,622,1143,1580,8479
9802,2018-4-15,Miami Heat,82,19930,3184,6997,0.455,903,2506,0.36,2281,4491,0.508,1209,1601,0.755,763,2801,3564,1862,620,1119,1648,8480
9803,2018-4-15,Chicago Bulls,82,19855,3170,7286,0.435,906,2550,0.355,2264,4736,0.478,1194,1576,0.758,790,2873,3663,1923,626,1090,1572,8440
9804,2018-4-15,San Antonio Spurs,82,19730,3202,6999,0.457,696,1977,0.352,2506,5022,0.499,1324,1715,0.772,849,2777,3626,1868,628,1040,1409,8424
9805,2018-4-15,Dallas Mavericks,82,19805,3128,7041,0.444,967,2688,0.36,2161,4353,0.496,1167,1530,0.763,666,2717,3383,1858,578,965,1578,8390
9806,2018-4-15,Memphis Grizzlies,82,19705,3013,6788,0.444,758,2152,0.352,2255,4636,0.486,1361,1732,0.786,779,2544,3323,1767,613,1182,1900,8145
9807,2018-4-15,Sacramento Kings,82,19755,3179,7063,0.45,738,1967,0.375,2441,5096,0.479,1008,1371,0.735,777,2578,3355,1769,643,1083,1639,8104
9808,2018-4-16,Golden State Warriors,82,19730,3509,6980,0.503,926,2369,0.391,2583,4611,0.56,1360,1668,0.815,691,2877,3568,2402,656,1230,1606,9304
9809,2018-4-16,Houston Rockets,82,19755,3174,6906,0.46,1256,3470,0.362,1918,3436,0.558,1609,2061,0.781,739,2825,3564,1767,699,1081,1597,9213
9810,2018-4-16,New Orleans Pelicans,82,19955,3500,7241,0.483,837,2312,0.362,2663,4929,0.54,1324,1716,0.772,712,2924,3636,2195,657,1182,1570,9161
9811,2018-4-16,Toronto Raptors,82,19830,3383,7169,0.472,968,2703,0.358,2415,4466,0.541,1422,1790,0.794,800,2807,3607,1995,626,1045,1784,9156
9812,2018-4-16,Cleveland Cavaliers,82,19730,3311,6950,0.476,981,2636,0.372,2330,4314,0.54,1488,1909,0.779,694,2761,3455,1916,582,1091,1523,9091
9813,2018-4-16,Denver Nuggets,82,19880,3338,7102,0.47,940,2536,0.371,2398,4566,0.525,1404,1833,0.766,902,2748,3650,2058,627,1175,1533,9020
9814,2018-4-16,Philadelphia 76ers,82,19780,3349,7098,0.472,901,2445,0.369,2448,4653,0.526,1405,1868,0.752,893,2996,3889,2221,682,1301,1813,9004
9815,2018-4-16,Minnesota Timberwolves,82,19805,3365,7063,0.476,658,1845,0.357,2707,5218,0.519,1592,1980,0.804,848,2593,3441,1861,689,963,1495,8980
9816,2018-4-16,Los Angeles Clippers,82,19705,3302,7004,0.471,777,2196,0.354,2525,4808,0.525,1556,2095,0.743,832,2766,3598,1832,627,1154,1638,8937
9817,2018-4-16,Charlotte Hornets,82,19780,3197,7106,0.45,824,2233,0.369,2373,4873,0.487,1656,2216,0.747,826,2901,3727,1770,559,1011,1410,8874
9818,2018-4-16,Los Angeles Lakers,82,19905,3338,7248,0.461,822,2384,0.345,2516,4864,0.517,1364,1910,0.714,876,2926,3802,1949,633,1256,1738,8862
9819,2018-4-16,Oklahoma City Thunder,82,19830,3271,7220,0.453,881,2490,0.354,2390,4730,0.505,1421,1987,0.715,1024,2671,3695,1750,743,1102,1654,8844
9820,2018-4-16,Washington Wizards,82,19855,3275,7018,0.467,814,2173,0.375,2461,4845,0.508,1378,1785,0.772,823,2713,3536,2065,645,1152,1746,8742
9821,2018-4-16,Brooklyn Nets,82,19855,3136,7114,0.441,1041,2924,0.356,2095,4190,0.5,1428,1850,0.772,792,2851,3643,1942,512,1167,1688,8741
9822,2018-4-16,Milwaukee Bucks,82,19830,3257,6807,0.478,718,2024,0.355,2539,4783,0.531,1499,1916,0.782,688,2579,3267,1905,722,1078,1752,8731
9823,2018-4-16,Portland Trail Blazers,82,19755,3222,7132,0.452,845,2308,0.366,2377,4824,0.493,1372,1715,0.8,835,2893,3728,1599,573,1067,1599,8661
9824,2018-4-16,Indiana Pacers,82,19755,3345,7083,0.472,741,2010,0.369,2604,5073,0.513,1225,1573,0.779,788,2684,3472,1819,721,1048,1543,8656
9825,2018-4-16,New York Knicks,82,19830,3334,7194,0.463,673,1914,0.352,2661,5280,0.504,1225,1557,0.787,859,2752,3611,1912,552,1164,1682,8566
9826,2018-4-16,Utah Jazz,82,19755,3139,6797,0.462,887,2425,0.366,2252,4372,0.515,1375,1766,0.779,740,2807,3547,1839,708,1155,1608,8540
9827,2018-4-16,Boston Celtics,82,19805,3141,6975,0.45,939,2492,0.377,2202,4483,0.491,1308,1697,0.771,767,2878,3645,1842,604,1092,1618,8529
9828,2018-4-16,Phoenix Suns,82,19705,3153,7141,0.442,763,2286,0.334,2390,4855,0.492,1453,1963,0.74,842,2776,3618,1743,569,1235,1807,8522
9829,2018-4-16,Detroit Pistons,82,19805,3208,7129,0.45,886,2373,0.373,2322,4756,0.488,1207,1621,0.745,830,2756,3586,1868,628,1046,1508,8509
9830,2018-4-16,Atlanta Hawks,82,19705,3130,7014,0.446,917,2544,0.36,2213,4470,0.495,1298,1654,0.785,742,2693,3435,1946,638,1230,1606,8475
9831,2018-4-16,Orlando Magic,82,19730,3182,7042,0.452,844,2405,0.351,2338,4637,0.504,1271,1678,0.757,722,2692,3414,1921,622,1143,1580,8479
9832,2018-4-16,Miami Heat,82,19930,3184,6997,0.455,903,2506,0.36,2281,4491,0.508,1209,1601,0.755,763,2801,3564,1862,620,1119,1648,8480
9833,2018-4-16,Chicago Bulls,82,19855,3170,7286,0.435,906,2550,0.355,2264,4736,0.478,1194,1576,0.758,790,2873,3663,1923,626,1090,1572,8440
9834,2018-4-16,San Antonio Spurs,82,19730,3202,6999,0.457,696,1977,0.352,2506,5022,0.499,1324,1715,0.772,849,2777,3626,1868,628,1040,1409,8424
9835,2018-4-16,Dallas Mavericks,82,19805,3128,7041,0.444,967,2688,0.36,2161,4353,0.496,1167,1530,0.763,666,2717,3383,1858,578,965,1578,8390
9836,2018-4-16,Memphis Grizzlies,82,19705,3013,6788,0.444,758,2152,0.352,2255,4636,0.486,1361,1732,0.786,779,2544,3323,1767,613,1182,1900,8145
9837,2018-4-16,Sacramento Kings,82,19755,3179,7063,0.45,738,1967,0.375,2441,5096,0.479,1008,1371,0.735,777,2578,3355,1769,643,1083,1639,8104
9838,2018-4-17,Golden State Warriors,82,19730,3509,6980,0.503,926,2369,0.391,2583,4611,0.56,1360,1668,0.815,691,2877,3568,2402,656,1230,1606,9304
9839,2018-4-17,Houston Rockets,82,19755,3174,6906,0.46,1256,3470,0.362,1918,3436,0.558,1609,2061,0.781,739,2825,3564,1767,699,1081,1597,9213
9840,2018-4-17,New Orleans Pelicans,82,19955,3500,7241,0.483,837,2312,0.362,2663,4929,0.54,1324,1716,0.772,712,2924,3636,2195,657,1182,1570,9161
9841,2018-4-17,Toronto Raptors,82,19830,3383,7169,0.472,968,2703,0.358,2415,4466,0.541,1422,1790,0.794,800,2807,3607,1995,626,1045,1784,9156
9842,2018-4-17,Cleveland Cavaliers,82,19730,3311,6950,0.476,981,2636,0.372,2330,4314,0.54,1488,1909,0.779,694,2761,3455,1916,582,1091,1523,9091
9843,2018-4-17,Denver Nuggets,82,19880,3338,7102,0.47,940,2536,0.371,2398,4566,0.525,1404,1833,0.766,902,2748,3650,2058,627,1175,1533,9020
9844,2018-4-17,Philadelphia 76ers,82,19780,3349,7098,0.472,901,2445,0.369,2448,4653,0.526,1405,1868,0.752,893,2996,3889,2221,682,1301,1813,9004
9845,2018-4-17,Minnesota Timberwolves,82,19805,3365,7063,0.476,658,1845,0.357,2707,5218,0.519,1592,1980,0.804,848,2593,3441,1861,689,963,1495,8980
9846,2018-4-17,Los Angeles Clippers,82,19705,3302,7004,0.471,777,2196,0.354,2525,4808,0.525,1556,2095,0.743,832,2766,3598,1832,627,1154,1638,8937
9847,2018-4-17,Charlotte Hornets,82,19780,3197,7106,0.45,824,2233,0.369,2373,4873,0.487,1656,2216,0.747,826,2901,3727,1770,559,1011,1410,8874
9848,2018-4-17,Los Angeles Lakers,82,19905,3338,7248,0.461,822,2384,0.345,2516,4864,0.517,1364,1910,0.714,876,2926,3802,1949,633,1256,1738,8862
9849,2018-4-17,Oklahoma City Thunder,82,19830,3271,7220,0.453,881,2490,0.354,2390,4730,0.505,1421,1987,0.715,1024,2671,3695,1750,743,1102,1654,8844
9850,2018-4-17,Washington Wizards,82,19855,3275,7018,0.467,814,2173,0.375,2461,4845,0.508,1378,1785,0.772,823,2713,3536,2065,645,1152,1746,8742
9851,2018-4-17,Brooklyn Nets,82,19855,3136,7114,0.441,1041,2924,0.356,2095,4190,0.5,1428,1850,0.772,792,2851,3643,1942,512,1167,1688,8741
9852,2018-4-17,Milwaukee Bucks,82,19830,3257,6807,0.478,718,2024,0.355,2539,4783,0.531,1499,1916,0.782,688,2579,3267,1905,722,1078,1752,8731
9853,2018-4-17,Portland Trail Blazers,82,19755,3222,7132,0.452,845,2308,0.366,2377,4824,0.493,1372,1715,0.8,835,2893,3728,1599,573,1067,1599,8661
9854,2018-4-17,Indiana Pacers,82,19755,3345,7083,0.472,741,2010,0.369,2604,5073,0.513,1225,1573,0.779,788,2684,3472,1819,721,1048,1543,8656
9855,2018-4-17,New York Knicks,82,19830,3334,7194,0.463,673,1914,0.352,2661,5280,0.504,1225,1557,0.787,859,2752,3611,1912,552,1164,1682,8566
9856,2018-4-17,Utah Jazz,82,19755,3139,6797,0.462,887,2425,0.366,2252,4372,0.515,1375,1766,0.779,740,2807,3547,1839,708,1155,1608,8540
9857,2018-4-17,Boston Celtics,82,19805,3141,6975,0.45,939,2492,0.377,2202,4483,0.491,1308,1697,0.771,767,2878,3645,1842,604,1092,1618,8529
9858,2018-4-17,Phoenix Suns,82,19705,3153,7141,0.442,763,2286,0.334,2390,4855,0.492,1453,1963,0.74,842,2776,3618,1743,569,1235,1807,8522
9859,2018-4-17,Detroit Pistons,82,19805,3208,7129,0.45,886,2373,0.373,2322,4756,0.488,1207,1621,0.745,830,2756,3586,1868,628,1046,1508,8509
9860,2018-4-17,Atlanta Hawks,82,19705,3130,7014,0.446,917,2544,0.36,2213,4470,0.495,1298,1654,0.785,742,2693,3435,1946,638,1230,1606,8475
9861,2018-4-17,Orlando Magic,82,19730,3182,7042,0.452,844,2405,0.351,2338,4637,0.504,1271,1678,0.757,722,2692,3414,1921,622,1143,1580,8479
9862,2018-4-17,Miami Heat,82,19930,3184,6997,0.455,903,2506,0.36,2281,4491,0.508,1209,1601,0.755,763,2801,3564,1862,620,1119,1648,8480
9863,2018-4-17,Chicago Bulls,82,19855,3170,7286,0.435,906,2550,0.355,2264,4736,0.478,1194,1576,0.758,790,2873,3663,1923,626,1090,1572,8440
9864,2018-4-17,San Antonio Spurs,82,19730,3202,6999,0.457,696,1977,0.352,2506,5022,0.499,1324,1715,0.772,849,2777,3626,1868,628,1040,1409,8424
9865,2018-4-17,Dallas Mavericks,82,19805,3128,7041,0.444,967,2688,0.36,2161,4353,0.496,1167,1530,0.763,666,2717,3383,1858,578,965,1578,8390
9866,2018-4-17,Memphis Grizzlies,82,19705,3013,6788,0.444,758,2152,0.352,2255,4636,0.486,1361,1732,0.786,779,2544,3323,1767,613,1182,1900,8145
9867,2018-4-17,Sacramento Kings,82,19755,3179,7063,0.45,738,1967,0.375,2441,5096,0.479,1008,1371,0.735,777,2578,3355,1769,643,1083,1639,8104
9868,2018-4-18,Golden State Warriors,82,19730,3509,6980,0.503,926,2369,0.391,2583,4611,0.56,1360,1668,0.815,691,2877,3568,2402,656,1230,1606,9304
9869,2018-4-18,Houston Rockets,82,19755,3174,6906,0.46,1256,3470,0.362,1918,3436,0.558,1609,2061,0.781,739,2825,3564,1767,699,1081,1597,9213
9870,2018-4-18,New Orleans Pelicans,82,19955,3500,7241,0.483,837,2312,0.362,2663,4929,0.54,1324,1716,0.772,712,2924,3636,2195,657,1182,1570,9161
9871,2018-4-18,Toronto Raptors,82,19830,3383,7169,0.472,968,2703,0.358,2415,4466,0.541,1422,1790,0.794,800,2807,3607,1995,626,1045,1784,9156
9872,2018-4-18,Cleveland Cavaliers,82,19730,3311,6950,0.476,981,2636,0.372,2330,4314,0.54,1488,1909,0.779,694,2761,3455,1916,582,1091,1523,9091
9873,2018-4-18,Denver Nuggets,82,19880,3338,7102,0.47,940,2536,0.371,2398,4566,0.525,1404,1833,0.766,902,2748,3650,2058,627,1175,1533,9020
9874,2018-4-18,Philadelphia 76ers,82,19780,3349,7098,0.472,901,2445,0.369,2448,4653,0.526,1405,1868,0.752,893,2996,3889,2221,682,1301,1813,9004
9875,2018-4-18,Minnesota Timberwolves,82,19805,3365,7063,0.476,658,1845,0.357,2707,5218,0.519,1592,1980,0.804,848,2593,3441,1861,689,963,1495,8980
9876,2018-4-18,Los Angeles Clippers,82,19705,3302,7004,0.471,777,2196,0.354,2525,4808,0.525,1556,2095,0.743,832,2766,3598,1832,627,1154,1638,8937
9877,2018-4-18,Charlotte Hornets,82,19780,3197,7106,0.45,824,2233,0.369,2373,4873,0.487,1656,2216,0.747,826,2901,3727,1770,559,1011,1410,8874
9878,2018-4-18,Los Angeles Lakers,82,19905,3338,7248,0.461,822,2384,0.345,2516,4864,0.517,1364,1910,0.714,876,2926,3802,1949,633,1256,1738,8862
9879,2018-4-18,Oklahoma City Thunder,82,19830,3271,7220,0.453,881,2490,0.354,2390,4730,0.505,1421,1987,0.715,1024,2671,3695,1750,743,1102,1654,8844
9880,2018-4-18,Washington Wizards,82,19855,3275,7018,0.467,814,2173,0.375,2461,4845,0.508,1378,1785,0.772,823,2713,3536,2065,645,1152,1746,8742
9881,2018-4-18,Brooklyn Nets,82,19855,3136,7114,0.441,1041,2924,0.356,2095,4190,0.5,1428,1850,0.772,792,2851,3643,1942,512,1167,1688,8741
9882,2018-4-18,Milwaukee Bucks,82,19830,3257,6807,0.478,718,2024,0.355,2539,4783,0.531,1499,1916,0.782,688,2579,3267,1905,722,1078,1752,8731
9883,2018-4-18,Portland Trail Blazers,82,19755,3222,7132,0.452,845,2308,0.366,2377,4824,0.493,1372,1715,0.8,835,2893,3728,1599,573,1067,1599,8661
9884,2018-4-18,Indiana Pacers,82,19755,3345,7083,0.472,741,2010,0.369,2604,5073,0.513,1225,1573,0.779,788,2684,3472,1819,721,1048,1543,8656
9885,2018-4-18,New York Knicks,82,19830,3334,7194,0.463,673,1914,0.352,2661,5280,0.504,1225,1557,0.787,859,2752,3611,1912,552,1164,1682,8566
9886,2018-4-18,Utah Jazz,82,19755,3139,6797,0.462,887,2425,0.366,2252,4372,0.515,1375,1766,0.779,740,2807,3547,1839,708,1155,1608,8540
9887,2018-4-18,Boston Celtics,82,19805,3141,6975,0.45,939,2492,0.377,2202,4483,0.491,1308,1697,0.771,767,2878,3645,1842,604,1092,1618,8529
9888,2018-4-18,Phoenix Suns,82,19705,3153,7141,0.442,763,2286,0.334,2390,4855,0.492,1453,1963,0.74,842,2776,3618,1743,569,1235,1807,8522
9889,2018-4-18,Detroit Pistons,82,19805,3208,7129,0.45,886,2373,0.373,2322,4756,0.488,1207,1621,0.745,830,2756,3586,1868,628,1046,1508,8509
9890,2018-4-18,Atlanta Hawks,82,19705,3130,7014,0.446,917,2544,0.36,2213,4470,0.495,1298,1654,0.785,742,2693,3435,1946,638,1230,1606,8475
9891,2018-4-18,Orlando Magic,82,19730,3182,7042,0.452,844,2405,0.351,2338,4637,0.504,1271,1678,0.757,722,2692,3414,1921,622,1143,1580,8479
9892,2018-4-18,Miami Heat,82,19930,3184,6997,0.455,903,2506,0.36,2281,4491,0.508,1209,1601,0.755,763,2801,3564,1862,620,1119,1648,8480
9893,2018-4-18,Chicago Bulls,82,19855,3170,7286,0.435,906,2550,0.355,2264,4736,0.478,1194,1576,0.758,790,2873,3663,1923,626,1090,1572,8440
9894,2018-4-18,San Antonio Spurs,82,19730,3202,6999,0.457,696,1977,0.352,2506,5022,0.499,1324,1715,0.772,849,2777,3626,1868,628,1040,1409,8424
9895,2018-4-18,Dallas Mavericks,82,19805,3128,7041,0.444,967,2688,0.36,2161,4353,0.496,1167,1530,0.763,666,2717,3383,1858,578,965,1578,8390
9896,2018-4-18,Memphis Grizzlies,82,19705,3013,6788,0.444,758,2152,0.352,2255,4636,0.486,1361,1732,0.786,779,2544,3323,1767,613,1182,1900,8145
9897,2018-4-18,Sacramento Kings,82,19755,3179,7063,0.45,738,1967,0.375,2441,5096,0.479,1008,1371,0.735,777,2578,3355,1769,643,1083,1639,8104
9898,2018-4-19,Golden State Warriors,82,19730,3509,6980,0.503,926,2369,0.391,2583,4611,0.56,1360,1668,0.815,691,2877,3568,2402,656,1230,1606,9304
9899,2018-4-19,Houston Rockets,82,19755,3174,6906,0.46,1256,3470,0.362,1918,3436,0.558,1609,2061,0.781,739,2825,3564,1767,699,1081,1597,9213
9900,2018-4-19,New Orleans Pelicans,82,19955,3500,7241,0.483,837,2312,0.362,2663,4929,0.54,1324,1716,0.772,712,2924,3636,2195,657,1182,1570,9161
9901,2018-4-19,Toronto Raptors,82,19830,3383,7169,0.472,968,2703,0.358,2415,4466,0.541,1422,1790,0.794,800,2807,3607,1995,626,1045,1784,9156
9902,2018-4-19,Cleveland Cavaliers,82,19730,3311,6950,0.476,981,2636,0.372,2330,4314,0.54,1488,1909,0.779,694,2761,3455,1916,582,1091,1523,9091
9903,2018-4-19,Denver Nuggets,82,19880,3338,7102,0.47,940,2536,0.371,2398,4566,0.525,1404,1833,0.766,902,2748,3650,2058,627,1175,1533,9020
9904,2018-4-19,Philadelphia 76ers,82,19780,3349,7098,0.472,901,2445,0.369,2448,4653,0.526,1405,1868,0.752,893,2996,3889,2221,682,1301,1813,9004
9905,2018-4-19,Minnesota Timberwolves,82,19805,3365,7063,0.476,658,1845,0.357,2707,5218,0.519,1592,1980,0.804,848,2593,3441,1861,689,963,1495,8980
9906,2018-4-19,Los Angeles Clippers,82,19705,3302,7004,0.471,777,2196,0.354,2525,4808,0.525,1556,2095,0.743,832,2766,3598,1832,627,1154,1638,8937
9907,2018-4-19,Charlotte Hornets,82,19780,3197,7106,0.45,824,2233,0.369,2373,4873,0.487,1656,2216,0.747,826,2901,3727,1770,559,1011,1410,8874
9908,2018-4-19,Los Angeles Lakers,82,19905,3338,7248,0.461,822,2384,0.345,2516,4864,0.517,1364,1910,0.714,876,2926,3802,1949,633,1256,1738,8862
9909,2018-4-19,Oklahoma City Thunder,82,19830,3271,7220,0.453,881,2490,0.354,2390,4730,0.505,1421,1987,0.715,1024,2671,3695,1750,743,1102,1654,8844
9910,2018-4-19,Washington Wizards,82,19855,3275,7018,0.467,814,2173,0.375,2461,4845,0.508,1378,1785,0.772,823,2713,3536,2065,645,1152,1746,8742
9911,2018-4-19,Brooklyn Nets,82,19855,3136,7114,0.441,1041,2924,0.356,2095,4190,0.5,1428,1850,0.772,792,2851,3643,1942,512,1167,1688,8741
9912,2018-4-19,Milwaukee Bucks,82,19830,3257,6807,0.478,718,2024,0.355,2539,4783,0.531,1499,1916,0.782,688,2579,3267,1905,722,1078,1752,8731
9913,2018-4-19,Portland Trail Blazers,82,19755,3222,7132,0.452,845,2308,0.366,2377,4824,0.493,1372,1715,0.8,835,2893,3728,1599,573,1067,1599,8661
9914,2018-4-19,Indiana Pacers,82,19755,3345,7083,0.472,741,2010,0.369,2604,5073,0.513,1225,1573,0.779,788,2684,3472,1819,721,1048,1543,8656
9915,2018-4-19,New York Knicks,82,19830,3334,7194,0.463,673,1914,0.352,2661,5280,0.504,1225,1557,0.787,859,2752,3611,1912,552,1164,1682,8566
9916,2018-4-19,Utah Jazz,82,19755,3139,6797,0.462,887,2425,0.366,2252,4372,0.515,1375,1766,0.779,740,2807,3547,1839,708,1155,1608,8540
9917,2018-4-19,Boston Celtics,82,19805,3141,6975,0.45,939,2492,0.377,2202,4483,0.491,1308,1697,0.771,767,2878,3645,1842,604,1092,1618,8529
9918,2018-4-19,Phoenix Suns,82,19705,3153,7141,0.442,763,2286,0.334,2390,4855,0.492,1453,1963,0.74,842,2776,3618,1743,569,1235,1807,8522
9919,2018-4-19,Detroit Pistons,82,19805,3208,7129,0.45,886,2373,0.373,2322,4756,0.488,1207,1621,0.745,830,2756,3586,1868,628,1046,1508,8509
9920,2018-4-19,Atlanta Hawks,82,19705,3130,7014,0.446,917,2544,0.36,2213,4470,0.495,1298,1654,0.785,742,2693,3435,1946,638,1230,1606,8475
9921,2018-4-19,Orlando Magic,82,19730,3182,7042,0.452,844,2405,0.351,2338,4637,0.504,1271,1678,0.757,722,2692,3414,1921,622,1143,1580,8479
9922,2018-4-19,Miami Heat,82,19930,3184,6997,0.455,903,2506,0.36,2281,4491,0.508,1209,1601,0.755,763,2801,3564,1862,620,1119,1648,8480
9923,2018-4-19,Chicago Bulls,82,19855,3170,7286,0.435,906,2550,0.355,2264,4736,0.478,1194,1576,0.758,790,2873,3663,1923,626,1090,1572,8440
9924,2018-4-19,San Antonio Spurs,82,19730,3202,6999,0.457,696,1977,0.352,2506,5022,0.499,1324,1715,0.772,849,2777,3626,1868,628,1040,1409,8424
9925,2018-4-19,Dallas Mavericks,82,19805,3128,7041,0.444,967,2688,0.36,2161,4353,0.496,1167,1530,0.763,666,2717,3383,1858,578,965,1578,8390
9926,2018-4-19,Memphis Grizzlies,82,19705,3013,6788,0.444,758,2152,0.352,2255,4636,0.486,1361,1732,0.786,779,2544,3323,1767,613,1182,1900,8145
9927,2018-4-19,Sacramento Kings,82,19755,3179,7063,0.45,738,1967,0.375,2441,5096,0.479,1008,1371,0.735,777,2578,3355,1769,643,1083,1639,8104
9928,2018-4-20,Golden State Warriors,82,19730,3509,6980,0.503,926,2369,0.391,2583,4611,0.56,1360,1668,0.815,691,2877,3568,2402,656,1230,1606,9304
9929,2018-4-20,Houston Rockets,82,19755,3174,6906,0.46,1256,3470,0.362,1918,3436,0.558,1609,2061,0.781,739,2825,3564,1767,699,1081,1597,9213
9930,2018-4-20,New Orleans Pelicans,82,19955,3500,7241,0.483,837,2312,0.362,2663,4929,0.54,1324,1716,0.772,712,2924,3636,2195,657,1182,1570,9161
9931,2018-4-20,Toronto Raptors,82,19830,3383,7169,0.472,968,2703,0.358,2415,4466,0.541,1422,1790,0.794,800,2807,3607,1995,626,1045,1784,9156
9932,2018-4-20,Cleveland Cavaliers,82,19730,3311,6950,0.476,981,2636,0.372,2330,4314,0.54,1488,1909,0.779,694,2761,3455,1916,582,1091,1523,9091
9933,2018-4-20,Denver Nuggets,82,19880,3338,7102,0.47,940,2536,0.371,2398,4566,0.525,1404,1833,0.766,902,2748,3650,2058,627,1175,1533,9020
9934,2018-4-20,Philadelphia 76ers,82,19780,3349,7098,0.472,901,2445,0.369,2448,4653,0.526,1405,1868,0.752,893,2996,3889,2221,682,1301,1813,9004
9935,2018-4-20,Minnesota Timberwolves,82,19805,3365,7063,0.476,658,1845,0.357,2707,5218,0.519,1592,1980,0.804,848,2593,3441,1861,689,963,1495,8980
9936,2018-4-20,Los Angeles Clippers,82,19705,3302,7004,0.471,777,2196,0.354,2525,4808,0.525,1556,2095,0.743,832,2766,3598,1832,627,1154,1638,8937
9937,2018-4-20,Charlotte Hornets,82,19780,3197,7106,0.45,824,2233,0.369,2373,4873,0.487,1656,2216,0.747,826,2901,3727,1770,559,1011,1410,8874
9938,2018-4-20,Los Angeles Lakers,82,19905,3338,7248,0.461,822,2384,0.345,2516,4864,0.517,1364,1910,0.714,876,2926,3802,1949,633,1256,1738,8862
9939,2018-4-20,Oklahoma City Thunder,82,19830,3271,7220,0.453,881,2490,0.354,2390,4730,0.505,1421,1987,0.715,1024,2671,3695,1750,743,1102,1654,8844
9940,2018-4-20,Washington Wizards,82,19855,3275,7018,0.467,814,2173,0.375,2461,4845,0.508,1378,1785,0.772,823,2713,3536,2065,645,1152,1746,8742
9941,2018-4-20,Brooklyn Nets,82,19855,3136,7114,0.441,1041,2924,0.356,2095,4190,0.5,1428,1850,0.772,792,2851,3643,1942,512,1167,1688,8741
9942,2018-4-20,Milwaukee Bucks,82,19830,3257,6807,0.478,718,2024,0.355,2539,4783,0.531,1499,1916,0.782,688,2579,3267,1905,722,1078,1752,8731
9943,2018-4-20,Portland Trail Blazers,82,19755,3222,7132,0.452,845,2308,0.366,2377,4824,0.493,1372,1715,0.8,835,2893,3728,1599,573,1067,1599,8661
9944,2018-4-20,Indiana Pacers,82,19755,3345,7083,0.472,741,2010,0.369,2604,5073,0.513,1225,1573,0.779,788,2684,3472,1819,721,1048,1543,8656
9945,2018-4-20,New York Knicks,82,19830,3334,7194,0.463,673,1914,0.352,2661,5280,0.504,1225,1557,0.787,859,2752,3611,1912,552,1164,1682,8566
9946,2018-4-20,Utah Jazz,82,19755,3139,6797,0.462,887,2425,0.366,2252,4372,0.515,1375,1766,0.779,740,2807,3547,1839,708,1155,1608,8540
9947,2018-4-20,Boston Celtics,82,19805,3141,6975,0.45,939,2492,0.377,2202,4483,0.491,1308,1697,0.771,767,2878,3645,1842,604,1092,1618,8529
9948,2018-4-20,Phoenix Suns,82,19705,3153,7141,0.442,763,2286,0.334,2390,4855,0.492,1453,1963,0.74,842,2776,3618,1743,569,1235,1807,8522
9949,2018-4-20,Detroit Pistons,82,19805,3208,7129,0.45,886,2373,0.373,2322,4756,0.488,1207,1621,0.745,830,2756,3586,1868,628,1046,1508,8509
9950,2018-4-20,Atlanta Hawks,82,19705,3130,7014,0.446,917,2544,0.36,2213,4470,0.495,1298,1654,0.785,742,2693,3435,1946,638,1230,1606,8475
9951,2018-4-20,Orlando Magic,82,19730,3182,7042,0.452,844,2405,0.351,2338,4637,0.504,1271,1678,0.757,722,2692,3414,1921,622,1143,1580,8479
9952,2018-4-20,Miami Heat,82,19930,3184,6997,0.455,903,2506,0.36,2281,4491,0.508,1209,1601,0.755,763,2801,3564,1862,620,1119,1648,8480
9953,2018-4-20,Chicago Bulls,82,19855,3170,7286,0.435,906,2550,0.355,2264,4736,0.478,1194,1576,0.758,790,2873,3663,1923,626,1090,1572,8440
9954,2018-4-20,San Antonio Spurs,82,19730,3202,6999,0.457,696,1977,0.352,2506,5022,0.499,1324,1715,0.772,849,2777,3626,1868,628,1040,1409,8424
9955,2018-4-20,Dallas Mavericks,82,19805,3128,7041,0.444,967,2688,0.36,2161,4353,0.496,1167,1530,0.763,666,2717,3383,1858,578,965,1578,8390
9956,2018-4-20,Memphis Grizzlies,82,19705,3013,6788,0.444,758,2152,0.352,2255,4636,0.486,1361,1732,0.786,779,2544,3323,1767,613,1182,1900,8145
9957,2018-4-20,Sacramento Kings,82,19755,3179,7063,0.45,738,1967,0.375,2441,5096,0.479,1008,1371,0.735,777,2578,3355,1769,643,1083,1639,8104
9958,2018-4-21,Golden State Warriors,82,19730,3509,6980,0.503,926,2369,0.391,2583,4611,0.56,1360,1668,0.815,691,2877,3568,2402,656,1230,1606,9304
9959,2018-4-21,Houston Rockets,82,19755,3174,6906,0.46,1256,3470,0.362,1918,3436,0.558,1609,2061,0.781,739,2825,3564,1767,699,1081,1597,9213
9960,2018-4-21,New Orleans Pelicans,82,19955,3500,7241,0.483,837,2312,0.362,2663,4929,0.54,1324,1716,0.772,712,2924,3636,2195,657,1182,1570,9161
9961,2018-4-21,Toronto Raptors,82,19830,3383,7169,0.472,968,2703,0.358,2415,4466,0.541,1422,1790,0.794,800,2807,3607,1995,626,1045,1784,9156
9962,2018-4-21,Cleveland Cavaliers,82,19730,3311,6950,0.476,981,2636,0.372,2330,4314,0.54,1488,1909,0.779,694,2761,3455,1916,582,1091,1523,9091
9963,2018-4-21,Denver Nuggets,82,19880,3338,7102,0.47,940,2536,0.371,2398,4566,0.525,1404,1833,0.766,902,2748,3650,2058,627,1175,1533,9020
9964,2018-4-21,Philadelphia 76ers,82,19780,3349,7098,0.472,901,2445,0.369,2448,4653,0.526,1405,1868,0.752,893,2996,3889,2221,682,1301,1813,9004
9965,2018-4-21,Minnesota Timberwolves,82,19805,3365,7063,0.476,658,1845,0.357,2707,5218,0.519,1592,1980,0.804,848,2593,3441,1861,689,963,1495,8980
9966,2018-4-21,Los Angeles Clippers,82,19705,3302,7004,0.471,777,2196,0.354,2525,4808,0.525,1556,2095,0.743,832,2766,3598,1832,627,1154,1638,8937
9967,2018-4-21,Charlotte Hornets,82,19780,3197,7106,0.45,824,2233,0.369,2373,4873,0.487,1656,2216,0.747,826,2901,3727,1770,559,1011,1410,8874
9968,2018-4-21,Los Angeles Lakers,82,19905,3338,7248,0.461,822,2384,0.345,2516,4864,0.517,1364,1910,0.714,876,2926,3802,1949,633,1256,1738,8862
9969,2018-4-21,Oklahoma City Thunder,82,19830,3271,7220,0.453,881,2490,0.354,2390,4730,0.505,1421,1987,0.715,1024,2671,3695,1750,743,1102,1654,8844
9970,2018-4-21,Washington Wizards,82,19855,3275,7018,0.467,814,2173,0.375,2461,4845,0.508,1378,1785,0.772,823,2713,3536,2065,645,1152,1746,8742
9971,2018-4-21,Brooklyn Nets,82,19855,3136,7114,0.441,1041,2924,0.356,2095,4190,0.5,1428,1850,0.772,792,2851,3643,1942,512,1167,1688,8741
9972,2018-4-21,Milwaukee Bucks,82,19830,3257,6807,0.478,718,2024,0.355,2539,4783,0.531,1499,1916,0.782,688,2579,3267,1905,722,1078,1752,8731
9973,2018-4-21,Portland Trail Blazers,82,19755,3222,7132,0.452,845,2308,0.366,2377,4824,0.493,1372,1715,0.8,835,2893,3728,1599,573,1067,1599,8661
9974,2018-4-21,Indiana Pacers,82,19755,3345,7083,0.472,741,2010,0.369,2604,5073,0.513,1225,1573,0.779,788,2684,3472,1819,721,1048,1543,8656
9975,2018-4-21,New York Knicks,82,19830,3334,7194,0.463,673,1914,0.352,2661,5280,0.504,1225,1557,0.787,859,2752,3611,1912,552,1164,1682,8566
9976,2018-4-21,Utah Jazz,82,19755,3139,6797,0.462,887,2425,0.366,2252,4372,0.515,1375,1766,0.779,740,2807,3547,1839,708,1155,1608,8540
9977,2018-4-21,Boston Celtics,82,19805,3141,6975,0.45,939,2492,0.377,2202,4483,0.491,1308,1697,0.771,767,2878,3645,1842,604,1092,1618,8529
9978,2018-4-21,Phoenix Suns,82,19705,3153,7141,0.442,763,2286,0.334,2390,4855,0.492,1453,1963,0.74,842,2776,3618,1743,569,1235,1807,8522
9979,2018-4-21,Detroit Pistons,82,19805,3208,7129,0.45,886,2373,0.373,2322,4756,0.488,1207,1621,0.745,830,2756,3586,1868,628,1046,1508,8509
9980,2018-4-21,Atlanta Hawks,82,19705,3130,7014,0.446,917,2544,0.36,2213,4470,0.495,1298,1654,0.785,742,2693,3435,1946,638,1230,1606,8475
9981,2018-4-21,Orlando Magic,82,19730,3182,7042,0.452,844,2405,0.351,2338,4637,0.504,1271,1678,0.757,722,2692,3414,1921,622,1143,1580,8479
9982,2018-4-21,Miami Heat,82,19930,3184,6997,0.455,903,2506,0.36,2281,4491,0.508,1209,1601,0.755,763,2801,3564,1862,620,1119,1648,8480
9983,2018-4-21,Chicago Bulls,82,19855,3170,7286,0.435,906,2550,0.355,2264,4736,0.478,1194,1576,0.758,790,2873,3663,1923,626,1090,1572,8440
9984,2018-4-21,San Antonio Spurs,82,19730,3202,6999,0.457,696,1977,0.352,2506,5022,0.499,1324,1715,0.772,849,2777,3626,1868,628,1040,1409,8424
9985,2018-4-21,Dallas Mavericks,82,19805,3128,7041,0.444,967,2688,0.36,2161,4353,0.496,1167,1530,0.763,666,2717,3383,1858,578,965,1578,8390
9986,2018-4-21,Memphis Grizzlies,82,19705,3013,6788,0.444,758,2152,0.352,2255,4636,0.486,1361,1732,0.786,779,2544,3323,1767,613,1182,1900,8145
9987,2018-4-21,Sacramento Kings,82,19755,3179,7063,0.45,738,1967,0.375,2441,5096,0.479,1008,1371,0.735,777,2578,3355,1769,643,1083,1639,8104
9988,2018-4-22,Golden State Warriors,82,19730,3509,6980,0.503,926,2369,0.391,2583,4611,0.56,1360,1668,0.815,691,2877,3568,2402,656,1230,1606,9304
9989,2018-4-22,Houston Rockets,82,19755,3174,6906,0.46,1256,3470,0.362,1918,3436,0.558,1609,2061,0.781,739,2825,3564,1767,699,1081,1597,9213
9990,2018-4-22,New Orleans Pelicans,82,19955,3500,7241,0.483,837,2312,0.362,2663,4929,0.54,1324,1716,0.772,712,2924,3636,2195,657,1182,1570,9161
9991,2018-4-22,Toronto Raptors,82,19830,3383,7169,0.472,968,2703,0.358,2415,4466,0.541,1422,1790,0.794,800,2807,3607,1995,626,1045,1784,9156
9992,2018-4-22,Cleveland Cavaliers,82,19730,3311,6950,0.476,981,2636,0.372,2330,4314,0.54,1488,1909,0.779,694,2761,3455,1916,582,1091,1523,9091
9993,2018-4-22,Denver Nuggets,82,19880,3338,7102,0.47,940,2536,0.371,2398,4566,0.525,1404,1833,0.766,902,2748,3650,2058,627,1175,1533,9020
9994,2018-4-22,Philadelphia 76ers,82,19780,3349,7098,0.472,901,2445,0.369,2448,4653,0.526,1405,1868,0.752,893,2996,3889,2221,682,1301,1813,9004
9995,2018-4-22,Minnesota Timberwolves,82,19805,3365,7063,0.476,658,1845,0.357,2707,5218,0.519,1592,1980,0.804,848,2593,3441,1861,689,963,1495,8980
9996,2018-4-22,Los Angeles Clippers,82,19705,3302,7004,0.471,777,2196,0.354,2525,4808,0.525,1556,2095,0.743,832,2766,3598,1832,627,1154,1638,8937
9997,2018-4-22,Charlotte Hornets,82,19780,3197,7106,0.45,824,2233,0.369,2373,4873,0.487,1656,2216,0.747,826,2901,3727,1770,559,1011,1410,8874
9998,2018-4-22,Los Angeles Lakers,82,19905,3338,7248,0.461,822,2384,0.345,2516,4864,0.517,1364,1910,0.714,876,2926,3802,1949,633,1256,1738,8862
9999,2018-4-22,Oklahoma City Thunder,82,19830,3271,7220,0.453,881,2490,0.354,2390,4730,0.505,1421,1987,0.715,1024,2671,3695,1750,743,1102,1654,8844
10000,2018-4-22,Washington Wizards,82,19855,3275,7018,0.467,814,2173,0.375,2461,4845,0.508,1378,1785,0.772,823,2713,3536,2065,645,1152,1746,8742
10001,2018-4-22,Brooklyn Nets,82,19855,3136,7114,0.441,1041,2924,0.356,2095,4190,0.5,1428,1850,0.772,792,2851,3643,1942,512,1167,1688,8741
10002,2018-4-22,Milwaukee Bucks,82,19830,3257,6807,0.478,718,2024,0.355,2539,4783,0.531,1499,1916,0.782,688,2579,3267,1905,722,1078,1752,8731
10003,2018-4-22,Portland Trail Blazers,82,19755,3222,7132,0.452,845,2308,0.366,2377,4824,0.493,1372,1715,0.8,835,2893,3728,1599,573,1067,1599,8661
10004,2018-4-22,Indiana Pacers,82,19755,3345,7083,0.472,741,2010,0.369,2604,5073,0.513,1225,1573,0.779,788,2684,3472,1819,721,1048,1543,8656
10005,2018-4-22,New York Knicks,82,19830,3334,7194,0.463,673,1914,0.352,2661,5280,0.504,1225,1557,0.787,859,2752,3611,1912,552,1164,1682,8566
10006,2018-4-22,Utah Jazz,82,19755,3139,6797,0.462,887,2425,0.366,2252,4372,0.515,1375,1766,0.779,740,2807,3547,1839,708,1155,1608,8540
10007,2018-4-22,Boston Celtics,82,19805,3141,6975,0.45,939,2492,0.377,2202,4483,0.491,1308,1697,0.771,767,2878,3645,1842,604,1092,1618,8529
10008,2018-4-22,Phoenix Suns,82,19705,3153,7141,0.442,763,2286,0.334,2390,4855,0.492,1453,1963,0.74,842,2776,3618,1743,569,1235,1807,8522
10009,2018-4-22,Detroit Pistons,82,19805,3208,7129,0.45,886,2373,0.373,2322,4756,0.488,1207,1621,0.745,830,2756,3586,1868,628,1046,1508,8509
10010,2018-4-22,Atlanta Hawks,82,19705,3130,7014,0.446,917,2544,0.36,2213,4470,0.495,1298,1654,0.785,742,2693,3435,1946,638,1230,1606,8475
10011,2018-4-22,Orlando Magic,82,19730,3182,7042,0.452,844,2405,0.351,2338,4637,0.504,1271,1678,0.757,722,2692,3414,1921,622,1143,1580,8479
10012,2018-4-22,Miami Heat,82,19930,3184,6997,0.455,903,2506,0.36,2281,4491,0.508,1209,1601,0.755,763,2801,3564,1862,620,1119,1648,8480
10013,2018-4-22,Chicago Bulls,82,19855,3170,7286,0.435,906,2550,0.355,2264,4736,0.478,1194,1576,0.758,790,2873,3663,1923,626,1090,1572,8440
10014,2018-4-22,San Antonio Spurs,82,19730,3202,6999,0.457,696,1977,0.352,2506,5022,0.499,1324,1715,0.772,849,2777,3626,1868,628,1040,1409,8424
10015,2018-4-22,Dallas Mavericks,82,19805,3128,7041,0.444,967,2688,0.36,2161,4353,0.496,1167,1530,0.763,666,2717,3383,1858,578,965,1578,8390
10016,2018-4-22,Memphis Grizzlies,82,19705,3013,6788,0.444,758,2152,0.352,2255,4636,0.486,1361,1732,0.786,779,2544,3323,1767,613,1182,1900,8145
10017,2018-4-22,Sacramento Kings,82,19755,3179,7063,0.45,738,1967,0.375,2441,5096,0.479,1008,1371,0.735,777,2578,3355,1769,643,1083,1639,8104
10018,2018-4-23,Golden State Warriors,82,19730,3509,6980,0.503,926,2369,0.391,2583,4611,0.56,1360,1668,0.815,691,2877,3568,2402,656,1230,1606,9304
10019,2018-4-23,Houston Rockets,82,19755,3174,6906,0.46,1256,3470,0.362,1918,3436,0.558,1609,2061,0.781,739,2825,3564,1767,699,1081,1597,9213
10020,2018-4-23,New Orleans Pelicans,82,19955,3500,7241,0.483,837,2312,0.362,2663,4929,0.54,1324,1716,0.772,712,2924,3636,2195,657,1182,1570,9161
10021,2018-4-23,Toronto Raptors,82,19830,3383,7169,0.472,968,2703,0.358,2415,4466,0.541,1422,1790,0.794,800,2807,3607,1995,626,1045,1784,9156
10022,2018-4-23,Cleveland Cavaliers,82,19730,3311,6950,0.476,981,2636,0.372,2330,4314,0.54,1488,1909,0.779,694,2761,3455,1916,582,1091,1523,9091
10023,2018-4-23,Denver Nuggets,82,19880,3338,7102,0.47,940,2536,0.371,2398,4566,0.525,1404,1833,0.766,902,2748,3650,2058,627,1175,1533,9020
10024,2018-4-23,Philadelphia 76ers,82,19780,3349,7098,0.472,901,2445,0.369,2448,4653,0.526,1405,1868,0.752,893,2996,3889,2221,682,1301,1813,9004
10025,2018-4-23,Minnesota Timberwolves,82,19805,3365,7063,0.476,658,1845,0.357,2707,5218,0.519,1592,1980,0.804,848,2593,3441,1861,689,963,1495,8980
10026,2018-4-23,Los Angeles Clippers,82,19705,3302,7004,0.471,777,2196,0.354,2525,4808,0.525,1556,2095,0.743,832,2766,3598,1832,627,1154,1638,8937
10027,2018-4-23,Charlotte Hornets,82,19780,3197,7106,0.45,824,2233,0.369,2373,4873,0.487,1656,2216,0.747,826,2901,3727,1770,559,1011,1410,8874
10028,2018-4-23,Los Angeles Lakers,82,19905,3338,7248,0.461,822,2384,0.345,2516,4864,0.517,1364,1910,0.714,876,2926,3802,1949,633,1256,1738,8862
10029,2018-4-23,Oklahoma City Thunder,82,19830,3271,7220,0.453,881,2490,0.354,2390,4730,0.505,1421,1987,0.715,1024,2671,3695,1750,743,1102,1654,8844
10030,2018-4-23,Washington Wizards,82,19855,3275,7018,0.467,814,2173,0.375,2461,4845,0.508,1378,1785,0.772,823,2713,3536,2065,645,1152,1746,8742
10031,2018-4-23,Brooklyn Nets,82,19855,3136,7114,0.441,1041,2924,0.356,2095,4190,0.5,1428,1850,0.772,792,2851,3643,1942,512,1167,1688,8741
10032,2018-4-23,Milwaukee Bucks,82,19830,3257,6807,0.478,718,2024,0.355,2539,4783,0.531,1499,1916,0.782,688,2579,3267,1905,722,1078,1752,8731
10033,2018-4-23,Portland Trail Blazers,82,19755,3222,7132,0.452,845,2308,0.366,2377,4824,0.493,1372,1715,0.8,835,2893,3728,1599,573,1067,1599,8661
10034,2018-4-23,Indiana Pacers,82,19755,3345,7083,0.472,741,2010,0.369,2604,5073,0.513,1225,1573,0.779,788,2684,3472,1819,721,1048,1543,8656
10035,2018-4-23,New York Knicks,82,19830,3334,7194,0.463,673,1914,0.352,2661,5280,0.504,1225,1557,0.787,859,2752,3611,1912,552,1164,1682,8566
10036,2018-4-23,Utah Jazz,82,19755,3139,6797,0.462,887,2425,0.366,2252,4372,0.515,1375,1766,0.779,740,2807,3547,1839,708,1155,1608,8540
10037,2018-4-23,Boston Celtics,82,19805,3141,6975,0.45,939,2492,0.377,2202,4483,0.491,1308,1697,0.771,767,2878,3645,1842,604,1092,1618,8529
10038,2018-4-23,Phoenix Suns,82,19705,3153,7141,0.442,763,2286,0.334,2390,4855,0.492,1453,1963,0.74,842,2776,3618,1743,569,1235,1807,8522
10039,2018-4-23,Detroit Pistons,82,19805,3208,7129,0.45,886,2373,0.373,2322,4756,0.488,1207,1621,0.745,830,2756,3586,1868,628,1046,1508,8509
10040,2018-4-23,Atlanta Hawks,82,19705,3130,7014,0.446,917,2544,0.36,2213,4470,0.495,1298,1654,0.785,742,2693,3435,1946,638,1230,1606,8475
10041,2018-4-23,Orlando Magic,82,19730,3182,7042,0.452,844,2405,0.351,2338,4637,0.504,1271,1678,0.757,722,2692,3414,1921,622,1143,1580,8479
10042,2018-4-23,Miami Heat,82,19930,3184,6997,0.455,903,2506,0.36,2281,4491,0.508,1209,1601,0.755,763,2801,3564,1862,620,1119,1648,8480
10043,2018-4-23,Chicago Bulls,82,19855,3170,7286,0.435,906,2550,0.355,2264,4736,0.478,1194,1576,0.758,790,2873,3663,1923,626,1090,1572,8440
10044,2018-4-23,San Antonio Spurs,82,19730,3202,6999,0.457,696,1977,0.352,2506,5022,0.499,1324,1715,0.772,849,2777,3626,1868,628,1040,1409,8424
10045,2018-4-23,Dallas Mavericks,82,19805,3128,7041,0.444,967,2688,0.36,2161,4353,0.496,1167,1530,0.763,666,2717,3383,1858,578,965,1578,8390
10046,2018-4-23,Memphis Grizzlies,82,19705,3013,6788,0.444,758,2152,0.352,2255,4636,0.486,1361,1732,0.786,779,2544,3323,1767,613,1182,1900,8145
10047,2018-4-23,Sacramento Kings,82,19755,3179,7063,0.45,738,1967,0.375,2441,5096,0.479,1008,1371,0.735,777,2578,3355,1769,643,1083,1639,8104
10048,2018-4-24,Golden State Warriors,82,19730,3509,6980,0.503,926,2369,0.391,2583,4611,0.56,1360,1668,0.815,691,2877,3568,2402,656,1230,1606,9304
10049,2018-4-24,Houston Rockets,82,19755,3174,6906,0.46,1256,3470,0.362,1918,3436,0.558,1609,2061,0.781,739,2825,3564,1767,699,1081,1597,9213
10050,2018-4-24,New Orleans Pelicans,82,19955,3500,7241,0.483,837,2312,0.362,2663,4929,0.54,1324,1716,0.772,712,2924,3636,2195,657,1182,1570,9161
10051,2018-4-24,Toronto Raptors,82,19830,3383,7169,0.472,968,2703,0.358,2415,4466,0.541,1422,1790,0.794,800,2807,3607,1995,626,1045,1784,9156
10052,2018-4-24,Cleveland Cavaliers,82,19730,3311,6950,0.476,981,2636,0.372,2330,4314,0.54,1488,1909,0.779,694,2761,3455,1916,582,1091,1523,9091
10053,2018-4-24,Denver Nuggets,82,19880,3338,7102,0.47,940,2536,0.371,2398,4566,0.525,1404,1833,0.766,902,2748,3650,2058,627,1175,1533,9020
10054,2018-4-24,Philadelphia 76ers,82,19780,3349,7098,0.472,901,2445,0.369,2448,4653,0.526,1405,1868,0.752,893,2996,3889,2221,682,1301,1813,9004
10055,2018-4-24,Minnesota Timberwolves,82,19805,3365,7063,0.476,658,1845,0.357,2707,5218,0.519,1592,1980,0.804,848,2593,3441,1861,689,963,1495,8980
10056,2018-4-24,Los Angeles Clippers,82,19705,3302,7004,0.471,777,2196,0.354,2525,4808,0.525,1556,2095,0.743,832,2766,3598,1832,627,1154,1638,8937
10057,2018-4-24,Charlotte Hornets,82,19780,3197,7106,0.45,824,2233,0.369,2373,4873,0.487,1656,2216,0.747,826,2901,3727,1770,559,1011,1410,8874
10058,2018-4-24,Los Angeles Lakers,82,19905,3338,7248,0.461,822,2384,0.345,2516,4864,0.517,1364,1910,0.714,876,2926,3802,1949,633,1256,1738,8862
10059,2018-4-24,Oklahoma City Thunder,82,19830,3271,7220,0.453,881,2490,0.354,2390,4730,0.505,1421,1987,0.715,1024,2671,3695,1750,743,1102,1654,8844
10060,2018-4-24,Washington Wizards,82,19855,3275,7018,0.467,814,2173,0.375,2461,4845,0.508,1378,1785,0.772,823,2713,3536,2065,645,1152,1746,8742
10061,2018-4-24,Brooklyn Nets,82,19855,3136,7114,0.441,1041,2924,0.356,2095,4190,0.5,1428,1850,0.772,792,2851,3643,1942,512,1167,1688,8741
10062,2018-4-24,Milwaukee Bucks,82,19830,3257,6807,0.478,718,2024,0.355,2539,4783,0.531,1499,1916,0.782,688,2579,3267,1905,722,1078,1752,8731
10063,2018-4-24,Portland Trail Blazers,82,19755,3222,7132,0.452,845,2308,0.366,2377,4824,0.493,1372,1715,0.8,835,2893,3728,1599,573,1067,1599,8661
10064,2018-4-24,Indiana Pacers,82,19755,3345,7083,0.472,741,2010,0.369,2604,5073,0.513,1225,1573,0.779,788,2684,3472,1819,721,1048,1543,8656
10065,2018-4-24,New York Knicks,82,19830,3334,7194,0.463,673,1914,0.352,2661,5280,0.504,1225,1557,0.787,859,2752,3611,1912,552,1164,1682,8566
10066,2018-4-24,Utah Jazz,82,19755,3139,6797,0.462,887,2425,0.366,2252,4372,0.515,1375,1766,0.779,740,2807,3547,1839,708,1155,1608,8540
10067,2018-4-24,Boston Celtics,82,19805,3141,6975,0.45,939,2492,0.377,2202,4483,0.491,1308,1697,0.771,767,2878,3645,1842,604,1092,1618,8529
10068,2018-4-24,Phoenix Suns,82,19705,3153,7141,0.442,763,2286,0.334,2390,4855,0.492,1453,1963,0.74,842,2776,3618,1743,569,1235,1807,8522
10069,2018-4-24,Detroit Pistons,82,19805,3208,7129,0.45,886,2373,0.373,2322,4756,0.488,1207,1621,0.745,830,2756,3586,1868,628,1046,1508,8509
10070,2018-4-24,Atlanta Hawks,82,19705,3130,7014,0.446,917,2544,0.36,2213,4470,0.495,1298,1654,0.785,742,2693,3435,1946,638,1230,1606,8475
10071,2018-4-24,Orlando Magic,82,19730,3182,7042,0.452,844,2405,0.351,2338,4637,0.504,1271,1678,0.757,722,2692,3414,1921,622,1143,1580,8479
10072,2018-4-24,Miami Heat,82,19930,3184,6997,0.455,903,2506,0.36,2281,4491,0.508,1209,1601,0.755,763,2801,3564,1862,620,1119,1648,8480
10073,2018-4-24,Chicago Bulls,82,19855,3170,7286,0.435,906,2550,0.355,2264,4736,0.478,1194,1576,0.758,790,2873,3663,1923,626,1090,1572,8440
10074,2018-4-24,San Antonio Spurs,82,19730,3202,6999,0.457,696,1977,0.352,2506,5022,0.499,1324,1715,0.772,849,2777,3626,1868,628,1040,1409,8424
10075,2018-4-24,Dallas Mavericks,82,19805,3128,7041,0.444,967,2688,0.36,2161,4353,0.496,1167,1530,0.763,666,2717,3383,1858,578,965,1578,8390
10076,2018-4-24,Memphis Grizzlies,82,19705,3013,6788,0.444,758,2152,0.352,2255,4636,0.486,1361,1732,0.786,779,2544,3323,1767,613,1182,1900,8145
10077,2018-4-24,Sacramento Kings,82,19755,3179,7063,0.45,738,1967,0.375,2441,5096,0.479,1008,1371,0.735,777,2578,3355,1769,643,1083,1639,8104
10078,2018-4-25,Golden State Warriors,82,19730,3509,6980,0.503,926,2369,0.391,2583,4611,0.56,1360,1668,0.815,691,2877,3568,2402,656,1230,1606,9304
10079,2018-4-25,Houston Rockets,82,19755,3174,6906,0.46,1256,3470,0.362,1918,3436,0.558,1609,2061,0.781,739,2825,3564,1767,699,1081,1597,9213
10080,2018-4-25,New Orleans Pelicans,82,19955,3500,7241,0.483,837,2312,0.362,2663,4929,0.54,1324,1716,0.772,712,2924,3636,2195,657,1182,1570,9161
10081,2018-4-25,Toronto Raptors,82,19830,3383,7169,0.472,968,2703,0.358,2415,4466,0.541,1422,1790,0.794,800,2807,3607,1995,626,1045,1784,9156
10082,2018-4-25,Cleveland Cavaliers,82,19730,3311,6950,0.476,981,2636,0.372,2330,4314,0.54,1488,1909,0.779,694,2761,3455,1916,582,1091,1523,9091
10083,2018-4-25,Denver Nuggets,82,19880,3338,7102,0.47,940,2536,0.371,2398,4566,0.525,1404,1833,0.766,902,2748,3650,2058,627,1175,1533,9020
10084,2018-4-25,Philadelphia 76ers,82,19780,3349,7098,0.472,901,2445,0.369,2448,4653,0.526,1405,1868,0.752,893,2996,3889,2221,682,1301,1813,9004
10085,2018-4-25,Minnesota Timberwolves,82,19805,3365,7063,0.476,658,1845,0.357,2707,5218,0.519,1592,1980,0.804,848,2593,3441,1861,689,963,1495,8980
10086,2018-4-25,Los Angeles Clippers,82,19705,3302,7004,0.471,777,2196,0.354,2525,4808,0.525,1556,2095,0.743,832,2766,3598,1832,627,1154,1638,8937
10087,2018-4-25,Charlotte Hornets,82,19780,3197,7106,0.45,824,2233,0.369,2373,4873,0.487,1656,2216,0.747,826,2901,3727,1770,559,1011,1410,8874
10088,2018-4-25,Los Angeles Lakers,82,19905,3338,7248,0.461,822,2384,0.345,2516,4864,0.517,1364,1910,0.714,876,2926,3802,1949,633,1256,1738,8862
10089,2018-4-25,Oklahoma City Thunder,82,19830,3271,7220,0.453,881,2490,0.354,2390,4730,0.505,1421,1987,0.715,1024,2671,3695,1750,743,1102,1654,8844
10090,2018-4-25,Washington Wizards,82,19855,3275,7018,0.467,814,2173,0.375,2461,4845,0.508,1378,1785,0.772,823,2713,3536,2065,645,1152,1746,8742
10091,2018-4-25,Brooklyn Nets,82,19855,3136,7114,0.441,1041,2924,0.356,2095,4190,0.5,1428,1850,0.772,792,2851,3643,1942,512,1167,1688,8741
10092,2018-4-25,Milwaukee Bucks,82,19830,3257,6807,0.478,718,2024,0.355,2539,4783,0.531,1499,1916,0.782,688,2579,3267,1905,722,1078,1752,8731
10093,2018-4-25,Portland Trail Blazers,82,19755,3222,7132,0.452,845,2308,0.366,2377,4824,0.493,1372,1715,0.8,835,2893,3728,1599,573,1067,1599,8661
10094,2018-4-25,Indiana Pacers,82,19755,3345,7083,0.472,741,2010,0.369,2604,5073,0.513,1225,1573,0.779,788,2684,3472,1819,721,1048,1543,8656
10095,2018-4-25,New York Knicks,82,19830,3334,7194,0.463,673,1914,0.352,2661,5280,0.504,1225,1557,0.787,859,2752,3611,1912,552,1164,1682,8566
10096,2018-4-25,Utah Jazz,82,19755,3139,6797,0.462,887,2425,0.366,2252,4372,0.515,1375,1766,0.779,740,2807,3547,1839,708,1155,1608,8540
10097,2018-4-25,Boston Celtics,82,19805,3141,6975,0.45,939,2492,0.377,2202,4483,0.491,1308,1697,0.771,767,2878,3645,1842,604,1092,1618,8529
10098,2018-4-25,Phoenix Suns,82,19705,3153,7141,0.442,763,2286,0.334,2390,4855,0.492,1453,1963,0.74,842,2776,3618,1743,569,1235,1807,8522
10099,2018-4-25,Detroit Pistons,82,19805,3208,7129,0.45,886,2373,0.373,2322,4756,0.488,1207,1621,0.745,830,2756,3586,1868,628,1046,1508,8509
10100,2018-4-25,Atlanta Hawks,82,19705,3130,7014,0.446,917,2544,0.36,2213,4470,0.495,1298,1654,0.785,742,2693,3435,1946,638,1230,1606,8475
10101,2018-4-25,Orlando Magic,82,19730,3182,7042,0.452,844,2405,0.351,2338,4637,0.504,1271,1678,0.757,722,2692,3414,1921,622,1143,1580,8479
10102,2018-4-25,Miami Heat,82,19930,3184,6997,0.455,903,2506,0.36,2281,4491,0.508,1209,1601,0.755,763,2801,3564,1862,620,1119,1648,8480
10103,2018-4-25,Chicago Bulls,82,19855,3170,7286,0.435,906,2550,0.355,2264,4736,0.478,1194,1576,0.758,790,2873,3663,1923,626,1090,1572,8440
10104,2018-4-25,San Antonio Spurs,82,19730,3202,6999,0.457,696,1977,0.352,2506,5022,0.499,1324,1715,0.772,849,2777,3626,1868,628,1040,1409,8424
10105,2018-4-25,Dallas Mavericks,82,19805,3128,7041,0.444,967,2688,0.36,2161,4353,0.496,1167,1530,0.763,666,2717,3383,1858,578,965,1578,8390
10106,2018-4-25,Memphis Grizzlies,82,19705,3013,6788,0.444,758,2152,0.352,2255,4636,0.486,1361,1732,0.786,779,2544,3323,1767,613,1182,1900,8145
10107,2018-4-25,Sacramento Kings,82,19755,3179,7063,0.45,738,1967,0.375,2441,5096,0.479,1008,1371,0.735,777,2578,3355,1769,643,1083,1639,8104
10108,2018-4-26,Golden State Warriors,82,19730,3509,6980,0.503,926,2369,0.391,2583,4611,0.56,1360,1668,0.815,691,2877,3568,2402,656,1230,1606,9304
10109,2018-4-26,Houston Rockets,82,19755,3174,6906,0.46,1256,3470,0.362,1918,3436,0.558,1609,2061,0.781,739,2825,3564,1767,699,1081,1597,9213
10110,2018-4-26,New Orleans Pelicans,82,19955,3500,7241,0.483,837,2312,0.362,2663,4929,0.54,1324,1716,0.772,712,2924,3636,2195,657,1182,1570,9161
10111,2018-4-26,Toronto Raptors,82,19830,3383,7169,0.472,968,2703,0.358,2415,4466,0.541,1422,1790,0.794,800,2807,3607,1995,626,1045,1784,9156
10112,2018-4-26,Cleveland Cavaliers,82,19730,3311,6950,0.476,981,2636,0.372,2330,4314,0.54,1488,1909,0.779,694,2761,3455,1916,582,1091,1523,9091
10113,2018-4-26,Denver Nuggets,82,19880,3338,7102,0.47,940,2536,0.371,2398,4566,0.525,1404,1833,0.766,902,2748,3650,2058,627,1175,1533,9020
10114,2018-4-26,Philadelphia 76ers,82,19780,3349,7098,0.472,901,2445,0.369,2448,4653,0.526,1405,1868,0.752,893,2996,3889,2221,682,1301,1813,9004
10115,2018-4-26,Minnesota Timberwolves,82,19805,3365,7063,0.476,658,1845,0.357,2707,5218,0.519,1592,1980,0.804,848,2593,3441,1861,689,963,1495,8980
10116,2018-4-26,Los Angeles Clippers,82,19705,3302,7004,0.471,777,2196,0.354,2525,4808,0.525,1556,2095,0.743,832,2766,3598,1832,627,1154,1638,8937
10117,2018-4-26,Charlotte Hornets,82,19780,3197,7106,0.45,824,2233,0.369,2373,4873,0.487,1656,2216,0.747,826,2901,3727,1770,559,1011,1410,8874
10118,2018-4-26,Los Angeles Lakers,82,19905,3338,7248,0.461,822,2384,0.345,2516,4864,0.517,1364,1910,0.714,876,2926,3802,1949,633,1256,1738,8862
10119,2018-4-26,Oklahoma City Thunder,82,19830,3271,7220,0.453,881,2490,0.354,2390,4730,0.505,1421,1987,0.715,1024,2671,3695,1750,743,1102,1654,8844
10120,2018-4-26,Washington Wizards,82,19855,3275,7018,0.467,814,2173,0.375,2461,4845,0.508,1378,1785,0.772,823,2713,3536,2065,645,1152,1746,8742
10121,2018-4-26,Brooklyn Nets,82,19855,3136,7114,0.441,1041,2924,0.356,2095,4190,0.5,1428,1850,0.772,792,2851,3643,1942,512,1167,1688,8741
10122,2018-4-26,Milwaukee Bucks,82,19830,3257,6807,0.478,718,2024,0.355,2539,4783,0.531,1499,1916,0.782,688,2579,3267,1905,722,1078,1752,8731
10123,2018-4-26,Portland Trail Blazers,82,19755,3222,7132,0.452,845,2308,0.366,2377,4824,0.493,1372,1715,0.8,835,2893,3728,1599,573,1067,1599,8661
10124,2018-4-26,Indiana Pacers,82,19755,3345,7083,0.472,741,2010,0.369,2604,5073,0.513,1225,1573,0.779,788,2684,3472,1819,721,1048,1543,8656
10125,2018-4-26,New York Knicks,82,19830,3334,7194,0.463,673,1914,0.352,2661,5280,0.504,1225,1557,0.787,859,2752,3611,1912,552,1164,1682,8566
10126,2018-4-26,Utah Jazz,82,19755,3139,6797,0.462,887,2425,0.366,2252,4372,0.515,1375,1766,0.779,740,2807,3547,1839,708,1155,1608,8540
10127,2018-4-26,Boston Celtics,82,19805,3141,6975,0.45,939,2492,0.377,2202,4483,0.491,1308,1697,0.771,767,2878,3645,1842,604,1092,1618,8529
10128,2018-4-26,Phoenix Suns,82,19705,3153,7141,0.442,763,2286,0.334,2390,4855,0.492,1453,1963,0.74,842,2776,3618,1743,569,1235,1807,8522
10129,2018-4-26,Detroit Pistons,82,19805,3208,7129,0.45,886,2373,0.373,2322,4756,0.488,1207,1621,0.745,830,2756,3586,1868,628,1046,1508,8509
10130,2018-4-26,Atlanta Hawks,82,19705,3130,7014,0.446,917,2544,0.36,2213,4470,0.495,1298,1654,0.785,742,2693,3435,1946,638,1230,1606,8475
10131,2018-4-26,Orlando Magic,82,19730,3182,7042,0.452,844,2405,0.351,2338,4637,0.504,1271,1678,0.757,722,2692,3414,1921,622,1143,1580,8479
10132,2018-4-26,Miami Heat,82,19930,3184,6997,0.455,903,2506,0.36,2281,4491,0.508,1209,1601,0.755,763,2801,3564,1862,620,1119,1648,8480
10133,2018-4-26,Chicago Bulls,82,19855,3170,7286,0.435,906,2550,0.355,2264,4736,0.478,1194,1576,0.758,790,2873,3663,1923,626,1090,1572,8440
10134,2018-4-26,San Antonio Spurs,82,19730,3202,6999,0.457,696,1977,0.352,2506,5022,0.499,1324,1715,0.772,849,2777,3626,1868,628,1040,1409,8424
10135,2018-4-26,Dallas Mavericks,82,19805,3128,7041,0.444,967,2688,0.36,2161,4353,0.496,1167,1530,0.763,666,2717,3383,1858,578,965,1578,8390
10136,2018-4-26,Memphis Grizzlies,82,19705,3013,6788,0.444,758,2152,0.352,2255,4636,0.486,1361,1732,0.786,779,2544,3323,1767,613,1182,1900,8145
10137,2018-4-26,Sacramento Kings,82,19755,3179,7063,0.45,738,1967,0.375,2441,5096,0.479,1008,1371,0.735,777,2578,3355,1769,643,1083,1639,8104
10138,2018-4-27,Golden State Warriors,82,19730,3509,6980,0.503,926,2369,0.391,2583,4611,0.56,1360,1668,0.815,691,2877,3568,2402,656,1230,1606,9304
10139,2018-4-27,Houston Rockets,82,19755,3174,6906,0.46,1256,3470,0.362,1918,3436,0.558,1609,2061,0.781,739,2825,3564,1767,699,1081,1597,9213
10140,2018-4-27,New Orleans Pelicans,82,19955,3500,7241,0.483,837,2312,0.362,2663,4929,0.54,1324,1716,0.772,712,2924,3636,2195,657,1182,1570,9161
10141,2018-4-27,Toronto Raptors,82,19830,3383,7169,0.472,968,2703,0.358,2415,4466,0.541,1422,1790,0.794,800,2807,3607,1995,626,1045,1784,9156
10142,2018-4-27,Cleveland Cavaliers,82,19730,3311,6950,0.476,981,2636,0.372,2330,4314,0.54,1488,1909,0.779,694,2761,3455,1916,582,1091,1523,9091
10143,2018-4-27,Denver Nuggets,82,19880,3338,7102,0.47,940,2536,0.371,2398,4566,0.525,1404,1833,0.766,902,2748,3650,2058,627,1175,1533,9020
10144,2018-4-27,Philadelphia 76ers,82,19780,3349,7098,0.472,901,2445,0.369,2448,4653,0.526,1405,1868,0.752,893,2996,3889,2221,682,1301,1813,9004
10145,2018-4-27,Minnesota Timberwolves,82,19805,3365,7063,0.476,658,1845,0.357,2707,5218,0.519,1592,1980,0.804,848,2593,3441,1861,689,963,1495,8980
10146,2018-4-27,Los Angeles Clippers,82,19705,3302,7004,0.471,777,2196,0.354,2525,4808,0.525,1556,2095,0.743,832,2766,3598,1832,627,1154,1638,8937
10147,2018-4-27,Charlotte Hornets,82,19780,3197,7106,0.45,824,2233,0.369,2373,4873,0.487,1656,2216,0.747,826,2901,3727,1770,559,1011,1410,8874
10148,2018-4-27,Los Angeles Lakers,82,19905,3338,7248,0.461,822,2384,0.345,2516,4864,0.517,1364,1910,0.714,876,2926,3802,1949,633,1256,1738,8862
10149,2018-4-27,Oklahoma City Thunder,82,19830,3271,7220,0.453,881,2490,0.354,2390,4730,0.505,1421,1987,0.715,1024,2671,3695,1750,743,1102,1654,8844
10150,2018-4-27,Washington Wizards,82,19855,3275,7018,0.467,814,2173,0.375,2461,4845,0.508,1378,1785,0.772,823,2713,3536,2065,645,1152,1746,8742
10151,2018-4-27,Brooklyn Nets,82,19855,3136,7114,0.441,1041,2924,0.356,2095,4190,0.5,1428,1850,0.772,792,2851,3643,1942,512,1167,1688,8741
10152,2018-4-27,Milwaukee Bucks,82,19830,3257,6807,0.478,718,2024,0.355,2539,4783,0.531,1499,1916,0.782,688,2579,3267,1905,722,1078,1752,8731
10153,2018-4-27,Portland Trail Blazers,82,19755,3222,7132,0.452,845,2308,0.366,2377,4824,0.493,1372,1715,0.8,835,2893,3728,1599,573,1067,1599,8661
10154,2018-4-27,Indiana Pacers,82,19755,3345,7083,0.472,741,2010,0.369,2604,5073,0.513,1225,1573,0.779,788,2684,3472,1819,721,1048,1543,8656
10155,2018-4-27,New York Knicks,82,19830,3334,7194,0.463,673,1914,0.352,2661,5280,0.504,1225,1557,0.787,859,2752,3611,1912,552,1164,1682,8566
10156,2018-4-27,Utah Jazz,82,19755,3139,6797,0.462,887,2425,0.366,2252,4372,0.515,1375,1766,0.779,740,2807,3547,1839,708,1155,1608,8540
10157,2018-4-27,Boston Celtics,82,19805,3141,6975,0.45,939,2492,0.377,2202,4483,0.491,1308,1697,0.771,767,2878,3645,1842,604,1092,1618,8529
10158,2018-4-27,Phoenix Suns,82,19705,3153,7141,0.442,763,2286,0.334,2390,4855,0.492,1453,1963,0.74,842,2776,3618,1743,569,1235,1807,8522
10159,2018-4-27,Detroit Pistons,82,19805,3208,7129,0.45,886,2373,0.373,2322,4756,0.488,1207,1621,0.745,830,2756,3586,1868,628,1046,1508,8509
10160,2018-4-27,Atlanta Hawks,82,19705,3130,7014,0.446,917,2544,0.36,2213,4470,0.495,1298,1654,0.785,742,2693,3435,1946,638,1230,1606,8475
10161,2018-4-27,Orlando Magic,82,19730,3182,7042,0.452,844,2405,0.351,2338,4637,0.504,1271,1678,0.757,722,2692,3414,1921,622,1143,1580,8479
10162,2018-4-27,Miami Heat,82,19930,3184,6997,0.455,903,2506,0.36,2281,4491,0.508,1209,1601,0.755,763,2801,3564,1862,620,1119,1648,8480
10163,2018-4-27,Chicago Bulls,82,19855,3170,7286,0.435,906,2550,0.355,2264,4736,0.478,1194,1576,0.758,790,2873,3663,1923,626,1090,1572,8440
10164,2018-4-27,San Antonio Spurs,82,19730,3202,6999,0.457,696,1977,0.352,2506,5022,0.499,1324,1715,0.772,849,2777,3626,1868,628,1040,1409,8424
10165,2018-4-27,Dallas Mavericks,82,19805,3128,7041,0.444,967,2688,0.36,2161,4353,0.496,1167,1530,0.763,666,2717,3383,1858,578,965,1578,8390
10166,2018-4-27,Memphis Grizzlies,82,19705,3013,6788,0.444,758,2152,0.352,2255,4636,0.486,1361,1732,0.786,779,2544,3323,1767,613,1182,1900,8145
10167,2018-4-27,Sacramento Kings,82,19755,3179,7063,0.45,738,1967,0.375,2441,5096,0.479,1008,1371,0.735,777,2578,3355,1769,643,1083,1639,8104
10168,2018-4-28,Golden State Warriors,82,19730,3509,6980,0.503,926,2369,0.391,2583,4611,0.56,1360,1668,0.815,691,2877,3568,2402,656,1230,1606,9304
10169,2018-4-28,Houston Rockets,82,19755,3174,6906,0.46,1256,3470,0.362,1918,3436,0.558,1609,2061,0.781,739,2825,3564,1767,699,1081,1597,9213
10170,2018-4-28,New Orleans Pelicans,82,19955,3500,7241,0.483,837,2312,0.362,2663,4929,0.54,1324,1716,0.772,712,2924,3636,2195,657,1182,1570,9161
10171,2018-4-28,Toronto Raptors,82,19830,3383,7169,0.472,968,2703,0.358,2415,4466,0.541,1422,1790,0.794,800,2807,3607,1995,626,1045,1784,9156
10172,2018-4-28,Cleveland Cavaliers,82,19730,3311,6950,0.476,981,2636,0.372,2330,4314,0.54,1488,1909,0.779,694,2761,3455,1916,582,1091,1523,9091
10173,2018-4-28,Denver Nuggets,82,19880,3338,7102,0.47,940,2536,0.371,2398,4566,0.525,1404,1833,0.766,902,2748,3650,2058,627,1175,1533,9020
10174,2018-4-28,Philadelphia 76ers,82,19780,3349,7098,0.472,901,2445,0.369,2448,4653,0.526,1405,1868,0.752,893,2996,3889,2221,682,1301,1813,9004
10175,2018-4-28,Minnesota Timberwolves,82,19805,3365,7063,0.476,658,1845,0.357,2707,5218,0.519,1592,1980,0.804,848,2593,3441,1861,689,963,1495,8980
10176,2018-4-28,Los Angeles Clippers,82,19705,3302,7004,0.471,777,2196,0.354,2525,4808,0.525,1556,2095,0.743,832,2766,3598,1832,627,1154,1638,8937
10177,2018-4-28,Charlotte Hornets,82,19780,3197,7106,0.45,824,2233,0.369,2373,4873,0.487,1656,2216,0.747,826,2901,3727,1770,559,1011,1410,8874
10178,2018-4-28,Los Angeles Lakers,82,19905,3338,7248,0.461,822,2384,0.345,2516,4864,0.517,1364,1910,0.714,876,2926,3802,1949,633,1256,1738,8862
10179,2018-4-28,Oklahoma City Thunder,82,19830,3271,7220,0.453,881,2490,0.354,2390,4730,0.505,1421,1987,0.715,1024,2671,3695,1750,743,1102,1654,8844
10180,2018-4-28,Washington Wizards,82,19855,3275,7018,0.467,814,2173,0.375,2461,4845,0.508,1378,1785,0.772,823,2713,3536,2065,645,1152,1746,8742
10181,2018-4-28,Brooklyn Nets,82,19855,3136,7114,0.441,1041,2924,0.356,2095,4190,0.5,1428,1850,0.772,792,2851,3643,1942,512,1167,1688,8741
10182,2018-4-28,Milwaukee Bucks,82,19830,3257,6807,0.478,718,2024,0.355,2539,4783,0.531,1499,1916,0.782,688,2579,3267,1905,722,1078,1752,8731
10183,2018-4-28,Portland Trail Blazers,82,19755,3222,7132,0.452,845,2308,0.366,2377,4824,0.493,1372,1715,0.8,835,2893,3728,1599,573,1067,1599,8661
10184,2018-4-28,Indiana Pacers,82,19755,3345,7083,0.472,741,2010,0.369,2604,5073,0.513,1225,1573,0.779,788,2684,3472,1819,721,1048,1543,8656
10185,2018-4-28,New York Knicks,82,19830,3334,7194,0.463,673,1914,0.352,2661,5280,0.504,1225,1557,0.787,859,2752,3611,1912,552,1164,1682,8566
10186,2018-4-28,Utah Jazz,82,19755,3139,6797,0.462,887,2425,0.366,2252,4372,0.515,1375,1766,0.779,740,2807,3547,1839,708,1155,1608,8540
10187,2018-4-28,Boston Celtics,82,19805,3141,6975,0.45,939,2492,0.377,2202,4483,0.491,1308,1697,0.771,767,2878,3645,1842,604,1092,1618,8529
10188,2018-4-28,Phoenix Suns,82,19705,3153,7141,0.442,763,2286,0.334,2390,4855,0.492,1453,1963,0.74,842,2776,3618,1743,569,1235,1807,8522
10189,2018-4-28,Detroit Pistons,82,19805,3208,7129,0.45,886,2373,0.373,2322,4756,0.488,1207,1621,0.745,830,2756,3586,1868,628,1046,1508,8509
10190,2018-4-28,Atlanta Hawks,82,19705,3130,7014,0.446,917,2544,0.36,2213,4470,0.495,1298,1654,0.785,742,2693,3435,1946,638,1230,1606,8475
10191,2018-4-28,Orlando Magic,82,19730,3182,7042,0.452,844,2405,0.351,2338,4637,0.504,1271,1678,0.757,722,2692,3414,1921,622,1143,1580,8479
10192,2018-4-28,Miami Heat,82,19930,3184,6997,0.455,903,2506,0.36,2281,4491,0.508,1209,1601,0.755,763,2801,3564,1862,620,1119,1648,8480
10193,2018-4-28,Chicago Bulls,82,19855,3170,7286,0.435,906,2550,0.355,2264,4736,0.478,1194,1576,0.758,790,2873,3663,1923,626,1090,1572,8440
10194,2018-4-28,San Antonio Spurs,82,19730,3202,6999,0.457,696,1977,0.352,2506,5022,0.499,1324,1715,0.772,849,2777,3626,1868,628,1040,1409,8424
10195,2018-4-28,Dallas Mavericks,82,19805,3128,7041,0.444,967,2688,0.36,2161,4353,0.496,1167,1530,0.763,666,2717,3383,1858,578,965,1578,8390
10196,2018-4-28,Memphis Grizzlies,82,19705,3013,6788,0.444,758,2152,0.352,2255,4636,0.486,1361,1732,0.786,779,2544,3323,1767,613,1182,1900,8145
10197,2018-4-28,Sacramento Kings,82,19755,3179,7063,0.45,738,1967,0.375,2441,5096,0.479,1008,1371,0.735,777,2578,3355,1769,643,1083,1639,8104
10198,2018-4-29,Golden State Warriors,82,19730,3509,6980,0.503,926,2369,0.391,2583,4611,0.56,1360,1668,0.815,691,2877,3568,2402,656,1230,1606,9304
10199,2018-4-29,Houston Rockets,82,19755,3174,6906,0.46,1256,3470,0.362,1918,3436,0.558,1609,2061,0.781,739,2825,3564,1767,699,1081,1597,9213
10200,2018-4-29,New Orleans Pelicans,82,19955,3500,7241,0.483,837,2312,0.362,2663,4929,0.54,1324,1716,0.772,712,2924,3636,2195,657,1182,1570,9161
10201,2018-4-29,Toronto Raptors,82,19830,3383,7169,0.472,968,2703,0.358,2415,4466,0.541,1422,1790,0.794,800,2807,3607,1995,626,1045,1784,9156
10202,2018-4-29,Cleveland Cavaliers,82,19730,3311,6950,0.476,981,2636,0.372,2330,4314,0.54,1488,1909,0.779,694,2761,3455,1916,582,1091,1523,9091
10203,2018-4-29,Denver Nuggets,82,19880,3338,7102,0.47,940,2536,0.371,2398,4566,0.525,1404,1833,0.766,902,2748,3650,2058,627,1175,1533,9020
10204,2018-4-29,Philadelphia 76ers,82,19780,3349,7098,0.472,901,2445,0.369,2448,4653,0.526,1405,1868,0.752,893,2996,3889,2221,682,1301,1813,9004
10205,2018-4-29,Minnesota Timberwolves,82,19805,3365,7063,0.476,658,1845,0.357,2707,5218,0.519,1592,1980,0.804,848,2593,3441,1861,689,963,1495,8980
10206,2018-4-29,Los Angeles Clippers,82,19705,3302,7004,0.471,777,2196,0.354,2525,4808,0.525,1556,2095,0.743,832,2766,3598,1832,627,1154,1638,8937
10207,2018-4-29,Charlotte Hornets,82,19780,3197,7106,0.45,824,2233,0.369,2373,4873,0.487,1656,2216,0.747,826,2901,3727,1770,559,1011,1410,8874
10208,2018-4-29,Los Angeles Lakers,82,19905,3338,7248,0.461,822,2384,0.345,2516,4864,0.517,1364,1910,0.714,876,2926,3802,1949,633,1256,1738,8862
10209,2018-4-29,Oklahoma City Thunder,82,19830,3271,7220,0.453,881,2490,0.354,2390,4730,0.505,1421,1987,0.715,1024,2671,3695,1750,743,1102,1654,8844
10210,2018-4-29,Washington Wizards,82,19855,3275,7018,0.467,814,2173,0.375,2461,4845,0.508,1378,1785,0.772,823,2713,3536,2065,645,1152,1746,8742
10211,2018-4-29,Brooklyn Nets,82,19855,3136,7114,0.441,1041,2924,0.356,2095,4190,0.5,1428,1850,0.772,792,2851,3643,1942,512,1167,1688,8741
10212,2018-4-29,Milwaukee Bucks,82,19830,3257,6807,0.478,718,2024,0.355,2539,4783,0.531,1499,1916,0.782,688,2579,3267,1905,722,1078,1752,8731
10213,2018-4-29,Portland Trail Blazers,82,19755,3222,7132,0.452,845,2308,0.366,2377,4824,0.493,1372,1715,0.8,835,2893,3728,1599,573,1067,1599,8661
10214,2018-4-29,Indiana Pacers,82,19755,3345,7083,0.472,741,2010,0.369,2604,5073,0.513,1225,1573,0.779,788,2684,3472,1819,721,1048,1543,8656
10215,2018-4-29,New York Knicks,82,19830,3334,7194,0.463,673,1914,0.352,2661,5280,0.504,1225,1557,0.787,859,2752,3611,1912,552,1164,1682,8566
10216,2018-4-29,Utah Jazz,82,19755,3139,6797,0.462,887,2425,0.366,2252,4372,0.515,1375,1766,0.779,740,2807,3547,1839,708,1155,1608,8540
10217,2018-4-29,Boston Celtics,82,19805,3141,6975,0.45,939,2492,0.377,2202,4483,0.491,1308,1697,0.771,767,2878,3645,1842,604,1092,1618,8529
10218,2018-4-29,Phoenix Suns,82,19705,3153,7141,0.442,763,2286,0.334,2390,4855,0.492,1453,1963,0.74,842,2776,3618,1743,569,1235,1807,8522
10219,2018-4-29,Detroit Pistons,82,19805,3208,7129,0.45,886,2373,0.373,2322,4756,0.488,1207,1621,0.745,830,2756,3586,1868,628,1046,1508,8509
10220,2018-4-29,Atlanta Hawks,82,19705,3130,7014,0.446,917,2544,0.36,2213,4470,0.495,1298,1654,0.785,742,2693,3435,1946,638,1230,1606,8475
10221,2018-4-29,Orlando Magic,82,19730,3182,7042,0.452,844,2405,0.351,2338,4637,0.504,1271,1678,0.757,722,2692,3414,1921,622,1143,1580,8479
10222,2018-4-29,Miami Heat,82,19930,3184,6997,0.455,903,2506,0.36,2281,4491,0.508,1209,1601,0.755,763,2801,3564,1862,620,1119,1648,8480
10223,2018-4-29,Chicago Bulls,82,19855,3170,7286,0.435,906,2550,0.355,2264,4736,0.478,1194,1576,0.758,790,2873,3663,1923,626,1090,1572,8440
10224,2018-4-29,San Antonio Spurs,82,19730,3202,6999,0.457,696,1977,0.352,2506,5022,0.499,1324,1715,0.772,849,2777,3626,1868,628,1040,1409,8424
10225,2018-4-29,Dallas Mavericks,82,19805,3128,7041,0.444,967,2688,0.36,2161,4353,0.496,1167,1530,0.763,666,2717,3383,1858,578,965,1578,8390
10226,2018-4-29,Memphis Grizzlies,82,19705,3013,6788,0.444,758,2152,0.352,2255,4636,0.486,1361,1732,0.786,779,2544,3323,1767,613,1182,1900,8145
10227,2018-4-29,Sacramento Kings,82,19755,3179,7063,0.45,738,1967,0.375,2441,5096,0.479,1008,1371,0.735,777,2578,3355,1769,643,1083,1639,8104
10228,2018-4-30,Golden State Warriors,82,19730,3509,6980,0.503,926,2369,0.391,2583,4611,0.56,1360,1668,0.815,691,2877,3568,2402,656,1230,1606,9304
10229,2018-4-30,Houston Rockets,82,19755,3174,6906,0.46,1256,3470,0.362,1918,3436,0.558,1609,2061,0.781,739,2825,3564,1767,699,1081,1597,9213
10230,2018-4-30,New Orleans Pelicans,82,19955,3500,7241,0.483,837,2312,0.362,2663,4929,0.54,1324,1716,0.772,712,2924,3636,2195,657,1182,1570,9161
10231,2018-4-30,Toronto Raptors,82,19830,3383,7169,0.472,968,2703,0.358,2415,4466,0.541,1422,1790,0.794,800,2807,3607,1995,626,1045,1784,9156
10232,2018-4-30,Cleveland Cavaliers,82,19730,3311,6950,0.476,981,2636,0.372,2330,4314,0.54,1488,1909,0.779,694,2761,3455,1916,582,1091,1523,9091
10233,2018-4-30,Denver Nuggets,82,19880,3338,7102,0.47,940,2536,0.371,2398,4566,0.525,1404,1833,0.766,902,2748,3650,2058,627,1175,1533,9020
10234,2018-4-30,Philadelphia 76ers,82,19780,3349,7098,0.472,901,2445,0.369,2448,4653,0.526,1405,1868,0.752,893,2996,3889,2221,682,1301,1813,9004
10235,2018-4-30,Minnesota Timberwolves,82,19805,3365,7063,0.476,658,1845,0.357,2707,5218,0.519,1592,1980,0.804,848,2593,3441,1861,689,963,1495,8980
10236,2018-4-30,Los Angeles Clippers,82,19705,3302,7004,0.471,777,2196,0.354,2525,4808,0.525,1556,2095,0.743,832,2766,3598,1832,627,1154,1638,8937
10237,2018-4-30,Charlotte Hornets,82,19780,3197,7106,0.45,824,2233,0.369,2373,4873,0.487,1656,2216,0.747,826,2901,3727,1770,559,1011,1410,8874
10238,2018-4-30,Los Angeles Lakers,82,19905,3338,7248,0.461,822,2384,0.345,2516,4864,0.517,1364,1910,0.714,876,2926,3802,1949,633,1256,1738,8862
10239,2018-4-30,Oklahoma City Thunder,82,19830,3271,7220,0.453,881,2490,0.354,2390,4730,0.505,1421,1987,0.715,1024,2671,3695,1750,743,1102,1654,8844
10240,2018-4-30,Washington Wizards,82,19855,3275,7018,0.467,814,2173,0.375,2461,4845,0.508,1378,1785,0.772,823,2713,3536,2065,645,1152,1746,8742
10241,2018-4-30,Brooklyn Nets,82,19855,3136,7114,0.441,1041,2924,0.356,2095,4190,0.5,1428,1850,0.772,792,2851,3643,1942,512,1167,1688,8741
10242,2018-4-30,Milwaukee Bucks,82,19830,3257,6807,0.478,718,2024,0.355,2539,4783,0.531,1499,1916,0.782,688,2579,3267,1905,722,1078,1752,8731
10243,2018-4-30,Portland Trail Blazers,82,19755,3222,7132,0.452,845,2308,0.366,2377,4824,0.493,1372,1715,0.8,835,2893,3728,1599,573,1067,1599,8661
10244,2018-4-30,Indiana Pacers,82,19755,3345,7083,0.472,741,2010,0.369,2604,5073,0.513,1225,1573,0.779,788,2684,3472,1819,721,1048,1543,8656
10245,2018-4-30,New York Knicks,82,19830,3334,7194,0.463,673,1914,0.352,2661,5280,0.504,1225,1557,0.787,859,2752,3611,1912,552,1164,1682,8566
10246,2018-4-30,Utah Jazz,82,19755,3139,6797,0.462,887,2425,0.366,2252,4372,0.515,1375,1766,0.779,740,2807,3547,1839,708,1155,1608,8540
10247,2018-4-30,Boston Celtics,82,19805,3141,6975,0.45,939,2492,0.377,2202,4483,0.491,1308,1697,0.771,767,2878,3645,1842,604,1092,1618,8529
10248,2018-4-30,Phoenix Suns,82,19705,3153,7141,0.442,763,2286,0.334,2390,4855,0.492,1453,1963,0.74,842,2776,3618,1743,569,1235,1807,8522
10249,2018-4-30,Detroit Pistons,82,19805,3208,7129,0.45,886,2373,0.373,2322,4756,0.488,1207,1621,0.745,830,2756,3586,1868,628,1046,1508,8509
10250,2018-4-30,Atlanta Hawks,82,19705,3130,7014,0.446,917,2544,0.36,2213,4470,0.495,1298,1654,0.785,742,2693,3435,1946,638,1230,1606,8475
10251,2018-4-30,Orlando Magic,82,19730,3182,7042,0.452,844,2405,0.351,2338,4637,0.504,1271,1678,0.757,722,2692,3414,1921,622,1143,1580,8479
10252,2018-4-30,Miami Heat,82,19930,3184,6997,0.455,903,2506,0.36,2281,4491,0.508,1209,1601,0.755,763,2801,3564,1862,620,1119,1648,8480
10253,2018-4-30,Chicago Bulls,82,19855,3170,7286,0.435,906,2550,0.355,2264,4736,0.478,1194,1576,0.758,790,2873,3663,1923,626,1090,1572,8440
10254,2018-4-30,San Antonio Spurs,82,19730,3202,6999,0.457,696,1977,0.352,2506,5022,0.499,1324,1715,0.772,849,2777,3626,1868,628,1040,1409,8424
10255,2018-4-30,Dallas Mavericks,82,19805,3128,7041,0.444,967,2688,0.36,2161,4353,0.496,1167,1530,0.763,666,2717,3383,1858,578,965,1578,8390
10256,2018-4-30,Memphis Grizzlies,82,19705,3013,6788,0.444,758,2152,0.352,2255,4636,0.486,1361,1732,0.786,779,2544,3323,1767,613,1182,1900,8145
10257,2018-4-30,Sacramento Kings,82,19755,3179,7063,0.45,738,1967,0.375,2441,5096,0.479,1008,1371,0.735,777,2578,3355,1769,643,1083,1639,8104
10258,2018-5-1,Golden State Warriors,82,19730,3509,6980,0.503,926,2369,0.391,2583,4611,0.56,1360,1668,0.815,691,2877,3568,2402,656,1230,1606,9304
10259,2018-5-1,Houston Rockets,82,19755,3174,6906,0.46,1256,3470,0.362,1918,3436,0.558,1609,2061,0.781,739,2825,3564,1767,699,1081,1597,9213
10260,2018-5-1,New Orleans Pelicans,82,19955,3500,7241,0.483,837,2312,0.362,2663,4929,0.54,1324,1716,0.772,712,2924,3636,2195,657,1182,1570,9161
10261,2018-5-1,Toronto Raptors,82,19830,3383,7169,0.472,968,2703,0.358,2415,4466,0.541,1422,1790,0.794,800,2807,3607,1995,626,1045,1784,9156
10262,2018-5-1,Cleveland Cavaliers,82,19730,3311,6950,0.476,981,2636,0.372,2330,4314,0.54,1488,1909,0.779,694,2761,3455,1916,582,1091,1523,9091
10263,2018-5-1,Denver Nuggets,82,19880,3338,7102,0.47,940,2536,0.371,2398,4566,0.525,1404,1833,0.766,902,2748,3650,2058,627,1175,1533,9020
10264,2018-5-1,Philadelphia 76ers,82,19780,3349,7098,0.472,901,2445,0.369,2448,4653,0.526,1405,1868,0.752,893,2996,3889,2221,682,1301,1813,9004
10265,2018-5-1,Minnesota Timberwolves,82,19805,3365,7063,0.476,658,1845,0.357,2707,5218,0.519,1592,1980,0.804,848,2593,3441,1861,689,963,1495,8980
10266,2018-5-1,Los Angeles Clippers,82,19705,3302,7004,0.471,777,2196,0.354,2525,4808,0.525,1556,2095,0.743,832,2766,3598,1832,627,1154,1638,8937
10267,2018-5-1,Charlotte Hornets,82,19780,3197,7106,0.45,824,2233,0.369,2373,4873,0.487,1656,2216,0.747,826,2901,3727,1770,559,1011,1410,8874
10268,2018-5-1,Los Angeles Lakers,82,19905,3338,7248,0.461,822,2384,0.345,2516,4864,0.517,1364,1910,0.714,876,2926,3802,1949,633,1256,1738,8862
10269,2018-5-1,Oklahoma City Thunder,82,19830,3271,7220,0.453,881,2490,0.354,2390,4730,0.505,1421,1987,0.715,1024,2671,3695,1750,743,1102,1654,8844
10270,2018-5-1,Washington Wizards,82,19855,3275,7018,0.467,814,2173,0.375,2461,4845,0.508,1378,1785,0.772,823,2713,3536,2065,645,1152,1746,8742
10271,2018-5-1,Brooklyn Nets,82,19855,3136,7114,0.441,1041,2924,0.356,2095,4190,0.5,1428,1850,0.772,792,2851,3643,1942,512,1167,1688,8741
10272,2018-5-1,Milwaukee Bucks,82,19830,3257,6807,0.478,718,2024,0.355,2539,4783,0.531,1499,1916,0.782,688,2579,3267,1905,722,1078,1752,8731
10273,2018-5-1,Portland Trail Blazers,82,19755,3222,7132,0.452,845,2308,0.366,2377,4824,0.493,1372,1715,0.8,835,2893,3728,1599,573,1067,1599,8661
10274,2018-5-1,Indiana Pacers,82,19755,3345,7083,0.472,741,2010,0.369,2604,5073,0.513,1225,1573,0.779,788,2684,3472,1819,721,1048,1543,8656
10275,2018-5-1,New York Knicks,82,19830,3334,7194,0.463,673,1914,0.352,2661,5280,0.504,1225,1557,0.787,859,2752,3611,1912,552,1164,1682,8566
10276,2018-5-1,Utah Jazz,82,19755,3139,6797,0.462,887,2425,0.366,2252,4372,0.515,1375,1766,0.779,740,2807,3547,1839,708,1155,1608,8540
10277,2018-5-1,Boston Celtics,82,19805,3141,6975,0.45,939,2492,0.377,2202,4483,0.491,1308,1697,0.771,767,2878,3645,1842,604,1092,1618,8529
10278,2018-5-1,Phoenix Suns,82,19705,3153,7141,0.442,763,2286,0.334,2390,4855,0.492,1453,1963,0.74,842,2776,3618,1743,569,1235,1807,8522
10279,2018-5-1,Detroit Pistons,82,19805,3208,7129,0.45,886,2373,0.373,2322,4756,0.488,1207,1621,0.745,830,2756,3586,1868,628,1046,1508,8509
10280,2018-5-1,Atlanta Hawks,82,19705,3130,7014,0.446,917,2544,0.36,2213,4470,0.495,1298,1654,0.785,742,2693,3435,1946,638,1230,1606,8475
10281,2018-5-1,Orlando Magic,82,19730,3182,7042,0.452,844,2405,0.351,2338,4637,0.504,1271,1678,0.757,722,2692,3414,1921,622,1143,1580,8479
10282,2018-5-1,Miami Heat,82,19930,3184,6997,0.455,903,2506,0.36,2281,4491,0.508,1209,1601,0.755,763,2801,3564,1862,620,1119,1648,8480
10283,2018-5-1,Chicago Bulls,82,19855,3170,7286,0.435,906,2550,0.355,2264,4736,0.478,1194,1576,0.758,790,2873,3663,1923,626,1090,1572,8440
10284,2018-5-1,San Antonio Spurs,82,19730,3202,6999,0.457,696,1977,0.352,2506,5022,0.499,1324,1715,0.772,849,2777,3626,1868,628,1040,1409,8424
10285,2018-5-1,Dallas Mavericks,82,19805,3128,7041,0.444,967,2688,0.36,2161,4353,0.496,1167,1530,0.763,666,2717,3383,1858,578,965,1578,8390
10286,2018-5-1,Memphis Grizzlies,82,19705,3013,6788,0.444,758,2152,0.352,2255,4636,0.486,1361,1732,0.786,779,2544,3323,1767,613,1182,1900,8145
10287,2018-5-1,Sacramento Kings,82,19755,3179,7063,0.45,738,1967,0.375,2441,5096,0.479,1008,1371,0.735,777,2578,3355,1769,643,1083,1639,8104
10288,2018-5-2,Golden State Warriors,82,19730,3509,6980,0.503,926,2369,0.391,2583,4611,0.56,1360,1668,0.815,691,2877,3568,2402,656,1230,1606,9304
10289,2018-5-2,Houston Rockets,82,19755,3174,6906,0.46,1256,3470,0.362,1918,3436,0.558,1609,2061,0.781,739,2825,3564,1767,699,1081,1597,9213
10290,2018-5-2,New Orleans Pelicans,82,19955,3500,7241,0.483,837,2312,0.362,2663,4929,0.54,1324,1716,0.772,712,2924,3636,2195,657,1182,1570,9161
10291,2018-5-2,Toronto Raptors,82,19830,3383,7169,0.472,968,2703,0.358,2415,4466,0.541,1422,1790,0.794,800,2807,3607,1995,626,1045,1784,9156
10292,2018-5-2,Cleveland Cavaliers,82,19730,3311,6950,0.476,981,2636,0.372,2330,4314,0.54,1488,1909,0.779,694,2761,3455,1916,582,1091,1523,9091
10293,2018-5-2,Denver Nuggets,82,19880,3338,7102,0.47,940,2536,0.371,2398,4566,0.525,1404,1833,0.766,902,2748,3650,2058,627,1175,1533,9020
10294,2018-5-2,Philadelphia 76ers,82,19780,3349,7098,0.472,901,2445,0.369,2448,4653,0.526,1405,1868,0.752,893,2996,3889,2221,682,1301,1813,9004
10295,2018-5-2,Minnesota Timberwolves,82,19805,3365,7063,0.476,658,1845,0.357,2707,5218,0.519,1592,1980,0.804,848,2593,3441,1861,689,963,1495,8980
10296,2018-5-2,Los Angeles Clippers,82,19705,3302,7004,0.471,777,2196,0.354,2525,4808,0.525,1556,2095,0.743,832,2766,3598,1832,627,1154,1638,8937
10297,2018-5-2,Charlotte Hornets,82,19780,3197,7106,0.45,824,2233,0.369,2373,4873,0.487,1656,2216,0.747,826,2901,3727,1770,559,1011,1410,8874
10298,2018-5-2,Los Angeles Lakers,82,19905,3338,7248,0.461,822,2384,0.345,2516,4864,0.517,1364,1910,0.714,876,2926,3802,1949,633,1256,1738,8862
10299,2018-5-2,Oklahoma City Thunder,82,19830,3271,7220,0.453,881,2490,0.354,2390,4730,0.505,1421,1987,0.715,1024,2671,3695,1750,743,1102,1654,8844
10300,2018-5-2,Washington Wizards,82,19855,3275,7018,0.467,814,2173,0.375,2461,4845,0.508,1378,1785,0.772,823,2713,3536,2065,645,1152,1746,8742
10301,2018-5-2,Brooklyn Nets,82,19855,3136,7114,0.441,1041,2924,0.356,2095,4190,0.5,1428,1850,0.772,792,2851,3643,1942,512,1167,1688,8741
10302,2018-5-2,Milwaukee Bucks,82,19830,3257,6807,0.478,718,2024,0.355,2539,4783,0.531,1499,1916,0.782,688,2579,3267,1905,722,1078,1752,8731
10303,2018-5-2,Portland Trail Blazers,82,19755,3222,7132,0.452,845,2308,0.366,2377,4824,0.493,1372,1715,0.8,835,2893,3728,1599,573,1067,1599,8661
10304,2018-5-2,Indiana Pacers,82,19755,3345,7083,0.472,741,2010,0.369,2604,5073,0.513,1225,1573,0.779,788,2684,3472,1819,721,1048,1543,8656
10305,2018-5-2,New York Knicks,82,19830,3334,7194,0.463,673,1914,0.352,2661,5280,0.504,1225,1557,0.787,859,2752,3611,1912,552,1164,1682,8566
10306,2018-5-2,Utah Jazz,82,19755,3139,6797,0.462,887,2425,0.366,2252,4372,0.515,1375,1766,0.779,740,2807,3547,1839,708,1155,1608,8540
10307,2018-5-2,Boston Celtics,82,19805,3141,6975,0.45,939,2492,0.377,2202,4483,0.491,1308,1697,0.771,767,2878,3645,1842,604,1092,1618,8529
10308,2018-5-2,Phoenix Suns,82,19705,3153,7141,0.442,763,2286,0.334,2390,4855,0.492,1453,1963,0.74,842,2776,3618,1743,569,1235,1807,8522
10309,2018-5-2,Detroit Pistons,82,19805,3208,7129,0.45,886,2373,0.373,2322,4756,0.488,1207,1621,0.745,830,2756,3586,1868,628,1046,1508,8509
10310,2018-5-2,Atlanta Hawks,82,19705,3130,7014,0.446,917,2544,0.36,2213,4470,0.495,1298,1654,0.785,742,2693,3435,1946,638,1230,1606,8475
10311,2018-5-2,Orlando Magic,82,19730,3182,7042,0.452,844,2405,0.351,2338,4637,0.504,1271,1678,0.757,722,2692,3414,1921,622,1143,1580,8479
10312,2018-5-2,Miami Heat,82,19930,3184,6997,0.455,903,2506,0.36,2281,4491,0.508,1209,1601,0.755,763,2801,3564,1862,620,1119,1648,8480
10313,2018-5-2,Chicago Bulls,82,19855,3170,7286,0.435,906,2550,0.355,2264,4736,0.478,1194,1576,0.758,790,2873,3663,1923,626,1090,1572,8440
10314,2018-5-2,San Antonio Spurs,82,19730,3202,6999,0.457,696,1977,0.352,2506,5022,0.499,1324,1715,0.772,849,2777,3626,1868,628,1040,1409,8424
10315,2018-5-2,Dallas Mavericks,82,19805,3128,7041,0.444,967,2688,0.36,2161,4353,0.496,1167,1530,0.763,666,2717,3383,1858,578,965,1578,8390
10316,2018-5-2,Memphis Grizzlies,82,19705,3013,6788,0.444,758,2152,0.352,2255,4636,0.486,1361,1732,0.786,779,2544,3323,1767,613,1182,1900,8145
10317,2018-5-2,Sacramento Kings,82,19755,3179,7063,0.45,738,1967,0.375,2441,5096,0.479,1008,1371,0.735,777,2578,3355,1769,643,1083,1639,8104
10318,2018-5-3,Golden State Warriors,82,19730,3509,6980,0.503,926,2369,0.391,2583,4611,0.56,1360,1668,0.815,691,2877,3568,2402,656,1230,1606,9304
10319,2018-5-3,Houston Rockets,82,19755,3174,6906,0.46,1256,3470,0.362,1918,3436,0.558,1609,2061,0.781,739,2825,3564,1767,699,1081,1597,9213
10320,2018-5-3,New Orleans Pelicans,82,19955,3500,7241,0.483,837,2312,0.362,2663,4929,0.54,1324,1716,0.772,712,2924,3636,2195,657,1182,1570,9161
10321,2018-5-3,Toronto Raptors,82,19830,3383,7169,0.472,968,2703,0.358,2415,4466,0.541,1422,1790,0.794,800,2807,3607,1995,626,1045,1784,9156
10322,2018-5-3,Cleveland Cavaliers,82,19730,3311,6950,0.476,981,2636,0.372,2330,4314,0.54,1488,1909,0.779,694,2761,3455,1916,582,1091,1523,9091
10323,2018-5-3,Denver Nuggets,82,19880,3338,7102,0.47,940,2536,0.371,2398,4566,0.525,1404,1833,0.766,902,2748,3650,2058,627,1175,1533,9020
10324,2018-5-3,Philadelphia 76ers,82,19780,3349,7098,0.472,901,2445,0.369,2448,4653,0.526,1405,1868,0.752,893,2996,3889,2221,682,1301,1813,9004
10325,2018-5-3,Minnesota Timberwolves,82,19805,3365,7063,0.476,658,1845,0.357,2707,5218,0.519,1592,1980,0.804,848,2593,3441,1861,689,963,1495,8980
10326,2018-5-3,Los Angeles Clippers,82,19705,3302,7004,0.471,777,2196,0.354,2525,4808,0.525,1556,2095,0.743,832,2766,3598,1832,627,1154,1638,8937
10327,2018-5-3,Charlotte Hornets,82,19780,3197,7106,0.45,824,2233,0.369,2373,4873,0.487,1656,2216,0.747,826,2901,3727,1770,559,1011,1410,8874
10328,2018-5-3,Los Angeles Lakers,82,19905,3338,7248,0.461,822,2384,0.345,2516,4864,0.517,1364,1910,0.714,876,2926,3802,1949,633,1256,1738,8862
10329,2018-5-3,Oklahoma City Thunder,82,19830,3271,7220,0.453,881,2490,0.354,2390,4730,0.505,1421,1987,0.715,1024,2671,3695,1750,743,1102,1654,8844
10330,2018-5-3,Washington Wizards,82,19855,3275,7018,0.467,814,2173,0.375,2461,4845,0.508,1378,1785,0.772,823,2713,3536,2065,645,1152,1746,8742
10331,2018-5-3,Brooklyn Nets,82,19855,3136,7114,0.441,1041,2924,0.356,2095,4190,0.5,1428,1850,0.772,792,2851,3643,1942,512,1167,1688,8741
10332,2018-5-3,Milwaukee Bucks,82,19830,3257,6807,0.478,718,2024,0.355,2539,4783,0.531,1499,1916,0.782,688,2579,3267,1905,722,1078,1752,8731
10333,2018-5-3,Portland Trail Blazers,82,19755,3222,7132,0.452,845,2308,0.366,2377,4824,0.493,1372,1715,0.8,835,2893,3728,1599,573,1067,1599,8661
10334,2018-5-3,Indiana Pacers,82,19755,3345,7083,0.472,741,2010,0.369,2604,5073,0.513,1225,1573,0.779,788,2684,3472,1819,721,1048,1543,8656
10335,2018-5-3,New York Knicks,82,19830,3334,7194,0.463,673,1914,0.352,2661,5280,0.504,1225,1557,0.787,859,2752,3611,1912,552,1164,1682,8566
10336,2018-5-3,Utah Jazz,82,19755,3139,6797,0.462,887,2425,0.366,2252,4372,0.515,1375,1766,0.779,740,2807,3547,1839,708,1155,1608,8540
10337,2018-5-3,Boston Celtics,82,19805,3141,6975,0.45,939,2492,0.377,2202,4483,0.491,1308,1697,0.771,767,2878,3645,1842,604,1092,1618,8529
10338,2018-5-3,Phoenix Suns,82,19705,3153,7141,0.442,763,2286,0.334,2390,4855,0.492,1453,1963,0.74,842,2776,3618,1743,569,1235,1807,8522
10339,2018-5-3,Detroit Pistons,82,19805,3208,7129,0.45,886,2373,0.373,2322,4756,0.488,1207,1621,0.745,830,2756,3586,1868,628,1046,1508,8509
10340,2018-5-3,Atlanta Hawks,82,19705,3130,7014,0.446,917,2544,0.36,2213,4470,0.495,1298,1654,0.785,742,2693,3435,1946,638,1230,1606,8475
10341,2018-5-3,Orlando Magic,82,19730,3182,7042,0.452,844,2405,0.351,2338,4637,0.504,1271,1678,0.757,722,2692,3414,1921,622,1143,1580,8479
10342,2018-5-3,Miami Heat,82,19930,3184,6997,0.455,903,2506,0.36,2281,4491,0.508,1209,1601,0.755,763,2801,3564,1862,620,1119,1648,8480
10343,2018-5-3,Chicago Bulls,82,19855,3170,7286,0.435,906,2550,0.355,2264,4736,0.478,1194,1576,0.758,790,2873,3663,1923,626,1090,1572,8440
10344,2018-5-3,San Antonio Spurs,82,19730,3202,6999,0.457,696,1977,0.352,2506,5022,0.499,1324,1715,0.772,849,2777,3626,1868,628,1040,1409,8424
10345,2018-5-3,Dallas Mavericks,82,19805,3128,7041,0.444,967,2688,0.36,2161,4353,0.496,1167,1530,0.763,666,2717,3383,1858,578,965,1578,8390
10346,2018-5-3,Memphis Grizzlies,82,19705,3013,6788,0.444,758,2152,0.352,2255,4636,0.486,1361,1732,0.786,779,2544,3323,1767,613,1182,1900,8145
10347,2018-5-3,Sacramento Kings,82,19755,3179,7063,0.45,738,1967,0.375,2441,5096,0.479,1008,1371,0.735,777,2578,3355,1769,643,1083,1639,8104
10348,2018-5-4,Golden State Warriors,82,19730,3509,6980,0.503,926,2369,0.391,2583,4611,0.56,1360,1668,0.815,691,2877,3568,2402,656,1230,1606,9304
10349,2018-5-4,Houston Rockets,82,19755,3174,6906,0.46,1256,3470,0.362,1918,3436,0.558,1609,2061,0.781,739,2825,3564,1767,699,1081,1597,9213
10350,2018-5-4,New Orleans Pelicans,82,19955,3500,7241,0.483,837,2312,0.362,2663,4929,0.54,1324,1716,0.772,712,2924,3636,2195,657,1182,1570,9161
10351,2018-5-4,Toronto Raptors,82,19830,3383,7169,0.472,968,2703,0.358,2415,4466,0.541,1422,1790,0.794,800,2807,3607,1995,626,1045,1784,9156
10352,2018-5-4,Cleveland Cavaliers,82,19730,3311,6950,0.476,981,2636,0.372,2330,4314,0.54,1488,1909,0.779,694,2761,3455,1916,582,1091,1523,9091
10353,2018-5-4,Denver Nuggets,82,19880,3338,7102,0.47,940,2536,0.371,2398,4566,0.525,1404,1833,0.766,902,2748,3650,2058,627,1175,1533,9020
10354,2018-5-4,Philadelphia 76ers,82,19780,3349,7098,0.472,901,2445,0.369,2448,4653,0.526,1405,1868,0.752,893,2996,3889,2221,682,1301,1813,9004
10355,2018-5-4,Minnesota Timberwolves,82,19805,3365,7063,0.476,658,1845,0.357,2707,5218,0.519,1592,1980,0.804,848,2593,3441,1861,689,963,1495,8980
10356,2018-5-4,Los Angeles Clippers,82,19705,3302,7004,0.471,777,2196,0.354,2525,4808,0.525,1556,2095,0.743,832,2766,3598,1832,627,1154,1638,8937
10357,2018-5-4,Charlotte Hornets,82,19780,3197,7106,0.45,824,2233,0.369,2373,4873,0.487,1656,2216,0.747,826,2901,3727,1770,559,1011,1410,8874
10358,2018-5-4,Los Angeles Lakers,82,19905,3338,7248,0.461,822,2384,0.345,2516,4864,0.517,1364,1910,0.714,876,2926,3802,1949,633,1256,1738,8862
10359,2018-5-4,Oklahoma City Thunder,82,19830,3271,7220,0.453,881,2490,0.354,2390,4730,0.505,1421,1987,0.715,1024,2671,3695,1750,743,1102,1654,8844
10360,2018-5-4,Washington Wizards,82,19855,3275,7018,0.467,814,2173,0.375,2461,4845,0.508,1378,1785,0.772,823,2713,3536,2065,645,1152,1746,8742
10361,2018-5-4,Brooklyn Nets,82,19855,3136,7114,0.441,1041,2924,0.356,2095,4190,0.5,1428,1850,0.772,792,2851,3643,1942,512,1167,1688,8741
10362,2018-5-4,Milwaukee Bucks,82,19830,3257,6807,0.478,718,2024,0.355,2539,4783,0.531,1499,1916,0.782,688,2579,3267,1905,722,1078,1752,8731
10363,2018-5-4,Portland Trail Blazers,82,19755,3222,7132,0.452,845,2308,0.366,2377,4824,0.493,1372,1715,0.8,835,2893,3728,1599,573,1067,1599,8661
10364,2018-5-4,Indiana Pacers,82,19755,3345,7083,0.472,741,2010,0.369,2604,5073,0.513,1225,1573,0.779,788,2684,3472,1819,721,1048,1543,8656
10365,2018-5-4,New York Knicks,82,19830,3334,7194,0.463,673,1914,0.352,2661,5280,0.504,1225,1557,0.787,859,2752,3611,1912,552,1164,1682,8566
10366,2018-5-4,Utah Jazz,82,19755,3139,6797,0.462,887,2425,0.366,2252,4372,0.515,1375,1766,0.779,740,2807,3547,1839,708,1155,1608,8540
10367,2018-5-4,Boston Celtics,82,19805,3141,6975,0.45,939,2492,0.377,2202,4483,0.491,1308,1697,0.771,767,2878,3645,1842,604,1092,1618,8529
10368,2018-5-4,Phoenix Suns,82,19705,3153,7141,0.442,763,2286,0.334,2390,4855,0.492,1453,1963,0.74,842,2776,3618,1743,569,1235,1807,8522
10369,2018-5-4,Detroit Pistons,82,19805,3208,7129,0.45,886,2373,0.373,2322,4756,0.488,1207,1621,0.745,830,2756,3586,1868,628,1046,1508,8509
10370,2018-5-4,Atlanta Hawks,82,19705,3130,7014,0.446,917,2544,0.36,2213,4470,0.495,1298,1654,0.785,742,2693,3435,1946,638,1230,1606,8475
10371,2018-5-4,Orlando Magic,82,19730,3182,7042,0.452,844,2405,0.351,2338,4637,0.504,1271,1678,0.757,722,2692,3414,1921,622,1143,1580,8479
10372,2018-5-4,Miami Heat,82,19930,3184,6997,0.455,903,2506,0.36,2281,4491,0.508,1209,1601,0.755,763,2801,3564,1862,620,1119,1648,8480
10373,2018-5-4,Chicago Bulls,82,19855,3170,7286,0.435,906,2550,0.355,2264,4736,0.478,1194,1576,0.758,790,2873,3663,1923,626,1090,1572,8440
10374,2018-5-4,San Antonio Spurs,82,19730,3202,6999,0.457,696,1977,0.352,2506,5022,0.499,1324,1715,0.772,849,2777,3626,1868,628,1040,1409,8424
10375,2018-5-4,Dallas Mavericks,82,19805,3128,7041,0.444,967,2688,0.36,2161,4353,0.496,1167,1530,0.763,666,2717,3383,1858,578,965,1578,8390
10376,2018-5-4,Memphis Grizzlies,82,19705,3013,6788,0.444,758,2152,0.352,2255,4636,0.486,1361,1732,0.786,779,2544,3323,1767,613,1182,1900,8145
10377,2018-5-4,Sacramento Kings,82,19755,3179,7063,0.45,738,1967,0.375,2441,5096,0.479,1008,1371,0.735,777,2578,3355,1769,643,1083,1639,8104
10378,2018-5-5,Golden State Warriors,82,19730,3509,6980,0.503,926,2369,0.391,2583,4611,0.56,1360,1668,0.815,691,2877,3568,2402,656,1230,1606,9304
10379,2018-5-5,Houston Rockets,82,19755,3174,6906,0.46,1256,3470,0.362,1918,3436,0.558,1609,2061,0.781,739,2825,3564,1767,699,1081,1597,9213
10380,2018-5-5,New Orleans Pelicans,82,19955,3500,7241,0.483,837,2312,0.362,2663,4929,0.54,1324,1716,0.772,712,2924,3636,2195,657,1182,1570,9161
10381,2018-5-5,Toronto Raptors,82,19830,3383,7169,0.472,968,2703,0.358,2415,4466,0.541,1422,1790,0.794,800,2807,3607,1995,626,1045,1784,9156
10382,2018-5-5,Cleveland Cavaliers,82,19730,3311,6950,0.476,981,2636,0.372,2330,4314,0.54,1488,1909,0.779,694,2761,3455,1916,582,1091,1523,9091
10383,2018-5-5,Denver Nuggets,82,19880,3338,7102,0.47,940,2536,0.371,2398,4566,0.525,1404,1833,0.766,902,2748,3650,2058,627,1175,1533,9020
10384,2018-5-5,Philadelphia 76ers,82,19780,3349,7098,0.472,901,2445,0.369,2448,4653,0.526,1405,1868,0.752,893,2996,3889,2221,682,1301,1813,9004
10385,2018-5-5,Minnesota Timberwolves,82,19805,3365,7063,0.476,658,1845,0.357,2707,5218,0.519,1592,1980,0.804,848,2593,3441,1861,689,963,1495,8980
10386,2018-5-5,Los Angeles Clippers,82,19705,3302,7004,0.471,777,2196,0.354,2525,4808,0.525,1556,2095,0.743,832,2766,3598,1832,627,1154,1638,8937
10387,2018-5-5,Charlotte Hornets,82,19780,3197,7106,0.45,824,2233,0.369,2373,4873,0.487,1656,2216,0.747,826,2901,3727,1770,559,1011,1410,8874
10388,2018-5-5,Los Angeles Lakers,82,19905,3338,7248,0.461,822,2384,0.345,2516,4864,0.517,1364,1910,0.714,876,2926,3802,1949,633,1256,1738,8862
10389,2018-5-5,Oklahoma City Thunder,82,19830,3271,7220,0.453,881,2490,0.354,2390,4730,0.505,1421,1987,0.715,1024,2671,3695,1750,743,1102,1654,8844
10390,2018-5-5,Washington Wizards,82,19855,3275,7018,0.467,814,2173,0.375,2461,4845,0.508,1378,1785,0.772,823,2713,3536,2065,645,1152,1746,8742
10391,2018-5-5,Brooklyn Nets,82,19855,3136,7114,0.441,1041,2924,0.356,2095,4190,0.5,1428,1850,0.772,792,2851,3643,1942,512,1167,1688,8741
10392,2018-5-5,Milwaukee Bucks,82,19830,3257,6807,0.478,718,2024,0.355,2539,4783,0.531,1499,1916,0.782,688,2579,3267,1905,722,1078,1752,8731
10393,2018-5-5,Portland Trail Blazers,82,19755,3222,7132,0.452,845,2308,0.366,2377,4824,0.493,1372,1715,0.8,835,2893,3728,1599,573,1067,1599,8661
10394,2018-5-5,Indiana Pacers,82,19755,3345,7083,0.472,741,2010,0.369,2604,5073,0.513,1225,1573,0.779,788,2684,3472,1819,721,1048,1543,8656
10395,2018-5-5,New York Knicks,82,19830,3334,7194,0.463,673,1914,0.352,2661,5280,0.504,1225,1557,0.787,859,2752,3611,1912,552,1164,1682,8566
10396,2018-5-5,Utah Jazz,82,19755,3139,6797,0.462,887,2425,0.366,2252,4372,0.515,1375,1766,0.779,740,2807,3547,1839,708,1155,1608,8540
10397,2018-5-5,Boston Celtics,82,19805,3141,6975,0.45,939,2492,0.377,2202,4483,0.491,1308,1697,0.771,767,2878,3645,1842,604,1092,1618,8529
10398,2018-5-5,Phoenix Suns,82,19705,3153,7141,0.442,763,2286,0.334,2390,4855,0.492,1453,1963,0.74,842,2776,3618,1743,569,1235,1807,8522
10399,2018-5-5,Detroit Pistons,82,19805,3208,7129,0.45,886,2373,0.373,2322,4756,0.488,1207,1621,0.745,830,2756,3586,1868,628,1046,1508,8509
10400,2018-5-5,Atlanta Hawks,82,19705,3130,7014,0.446,917,2544,0.36,2213,4470,0.495,1298,1654,0.785,742,2693,3435,1946,638,1230,1606,8475
10401,2018-5-5,Orlando Magic,82,19730,3182,7042,0.452,844,2405,0.351,2338,4637,0.504,1271,1678,0.757,722,2692,3414,1921,622,1143,1580,8479
10402,2018-5-5,Miami Heat,82,19930,3184,6997,0.455,903,2506,0.36,2281,4491,0.508,1209,1601,0.755,763,2801,3564,1862,620,1119,1648,8480
10403,2018-5-5,Chicago Bulls,82,19855,3170,7286,0.435,906,2550,0.355,2264,4736,0.478,1194,1576,0.758,790,2873,3663,1923,626,1090,1572,8440
10404,2018-5-5,San Antonio Spurs,82,19730,3202,6999,0.457,696,1977,0.352,2506,5022,0.499,1324,1715,0.772,849,2777,3626,1868,628,1040,1409,8424
10405,2018-5-5,Dallas Mavericks,82,19805,3128,7041,0.444,967,2688,0.36,2161,4353,0.496,1167,1530,0.763,666,2717,3383,1858,578,965,1578,8390
10406,2018-5-5,Memphis Grizzlies,82,19705,3013,6788,0.444,758,2152,0.352,2255,4636,0.486,1361,1732,0.786,779,2544,3323,1767,613,1182,1900,8145
10407,2018-5-5,Sacramento Kings,82,19755,3179,7063,0.45,738,1967,0.375,2441,5096,0.479,1008,1371,0.735,777,2578,3355,1769,643,1083,1639,8104
10408,2018-5-6,Golden State Warriors,82,19730,3509,6980,0.503,926,2369,0.391,2583,4611,0.56,1360,1668,0.815,691,2877,3568,2402,656,1230,1606,9304
10409,2018-5-6,Houston Rockets,82,19755,3174,6906,0.46,1256,3470,0.362,1918,3436,0.558,1609,2061,0.781,739,2825,3564,1767,699,1081,1597,9213
10410,2018-5-6,New Orleans Pelicans,82,19955,3500,7241,0.483,837,2312,0.362,2663,4929,0.54,1324,1716,0.772,712,2924,3636,2195,657,1182,1570,9161
10411,2018-5-6,Toronto Raptors,82,19830,3383,7169,0.472,968,2703,0.358,2415,4466,0.541,1422,1790,0.794,800,2807,3607,1995,626,1045,1784,9156
10412,2018-5-6,Cleveland Cavaliers,82,19730,3311,6950,0.476,981,2636,0.372,2330,4314,0.54,1488,1909,0.779,694,2761,3455,1916,582,1091,1523,9091
10413,2018-5-6,Denver Nuggets,82,19880,3338,7102,0.47,940,2536,0.371,2398,4566,0.525,1404,1833,0.766,902,2748,3650,2058,627,1175,1533,9020
10414,2018-5-6,Philadelphia 76ers,82,19780,3349,7098,0.472,901,2445,0.369,2448,4653,0.526,1405,1868,0.752,893,2996,3889,2221,682,1301,1813,9004
10415,2018-5-6,Minnesota Timberwolves,82,19805,3365,7063,0.476,658,1845,0.357,2707,5218,0.519,1592,1980,0.804,848,2593,3441,1861,689,963,1495,8980
10416,2018-5-6,Los Angeles Clippers,82,19705,3302,7004,0.471,777,2196,0.354,2525,4808,0.525,1556,2095,0.743,832,2766,3598,1832,627,1154,1638,8937
10417,2018-5-6,Charlotte Hornets,82,19780,3197,7106,0.45,824,2233,0.369,2373,4873,0.487,1656,2216,0.747,826,2901,3727,1770,559,1011,1410,8874
10418,2018-5-6,Los Angeles Lakers,82,19905,3338,7248,0.461,822,2384,0.345,2516,4864,0.517,1364,1910,0.714,876,2926,3802,1949,633,1256,1738,8862
10419,2018-5-6,Oklahoma City Thunder,82,19830,3271,7220,0.453,881,2490,0.354,2390,4730,0.505,1421,1987,0.715,1024,2671,3695,1750,743,1102,1654,8844
10420,2018-5-6,Washington Wizards,82,19855,3275,7018,0.467,814,2173,0.375,2461,4845,0.508,1378,1785,0.772,823,2713,3536,2065,645,1152,1746,8742
10421,2018-5-6,Brooklyn Nets,82,19855,3136,7114,0.441,1041,2924,0.356,2095,4190,0.5,1428,1850,0.772,792,2851,3643,1942,512,1167,1688,8741
10422,2018-5-6,Milwaukee Bucks,82,19830,3257,6807,0.478,718,2024,0.355,2539,4783,0.531,1499,1916,0.782,688,2579,3267,1905,722,1078,1752,8731
10423,2018-5-6,Portland Trail Blazers,82,19755,3222,7132,0.452,845,2308,0.366,2377,4824,0.493,1372,1715,0.8,835,2893,3728,1599,573,1067,1599,8661
10424,2018-5-6,Indiana Pacers,82,19755,3345,7083,0.472,741,2010,0.369,2604,5073,0.513,1225,1573,0.779,788,2684,3472,1819,721,1048,1543,8656
10425,2018-5-6,New York Knicks,82,19830,3334,7194,0.463,673,1914,0.352,2661,5280,0.504,1225,1557,0.787,859,2752,3611,1912,552,1164,1682,8566
10426,2018-5-6,Utah Jazz,82,19755,3139,6797,0.462,887,2425,0.366,2252,4372,0.515,1375,1766,0.779,740,2807,3547,1839,708,1155,1608,8540
10427,2018-5-6,Boston Celtics,82,19805,3141,6975,0.45,939,2492,0.377,2202,4483,0.491,1308,1697,0.771,767,2878,3645,1842,604,1092,1618,8529
10428,2018-5-6,Phoenix Suns,82,19705,3153,7141,0.442,763,2286,0.334,2390,4855,0.492,1453,1963,0.74,842,2776,3618,1743,569,1235,1807,8522
10429,2018-5-6,Detroit Pistons,82,19805,3208,7129,0.45,886,2373,0.373,2322,4756,0.488,1207,1621,0.745,830,2756,3586,1868,628,1046,1508,8509
10430,2018-5-6,Atlanta Hawks,82,19705,3130,7014,0.446,917,2544,0.36,2213,4470,0.495,1298,1654,0.785,742,2693,3435,1946,638,1230,1606,8475
10431,2018-5-6,Orlando Magic,82,19730,3182,7042,0.452,844,2405,0.351,2338,4637,0.504,1271,1678,0.757,722,2692,3414,1921,622,1143,1580,8479
10432,2018-5-6,Miami Heat,82,19930,3184,6997,0.455,903,2506,0.36,2281,4491,0.508,1209,1601,0.755,763,2801,3564,1862,620,1119,1648,8480
10433,2018-5-6,Chicago Bulls,82,19855,3170,7286,0.435,906,2550,0.355,2264,4736,0.478,1194,1576,0.758,790,2873,3663,1923,626,1090,1572,8440
10434,2018-5-6,San Antonio Spurs,82,19730,3202,6999,0.457,696,1977,0.352,2506,5022,0.499,1324,1715,0.772,849,2777,3626,1868,628,1040,1409,8424
10435,2018-5-6,Dallas Mavericks,82,19805,3128,7041,0.444,967,2688,0.36,2161,4353,0.496,1167,1530,0.763,666,2717,3383,1858,578,965,1578,8390
10436,2018-5-6,Memphis Grizzlies,82,19705,3013,6788,0.444,758,2152,0.352,2255,4636,0.486,1361,1732,0.786,779,2544,3323,1767,613,1182,1900,8145
10437,2018-5-6,Sacramento Kings,82,19755,3179,7063,0.45,738,1967,0.375,2441,5096,0.479,1008,1371,0.735,777,2578,3355,1769,643,1083,1639,8104
10438,2018-5-7,Golden State Warriors,82,19730,3509,6980,0.503,926,2369,0.391,2583,4611,0.56,1360,1668,0.815,691,2877,3568,2402,656,1230,1606,9304
10439,2018-5-7,Houston Rockets,82,19755,3174,6906,0.46,1256,3470,0.362,1918,3436,0.558,1609,2061,0.781,739,2825,3564,1767,699,1081,1597,9213
10440,2018-5-7,New Orleans Pelicans,82,19955,3500,7241,0.483,837,2312,0.362,2663,4929,0.54,1324,1716,0.772,712,2924,3636,2195,657,1182,1570,9161
10441,2018-5-7,Toronto Raptors,82,19830,3383,7169,0.472,968,2703,0.358,2415,4466,0.541,1422,1790,0.794,800,2807,3607,1995,626,1045,1784,9156
10442,2018-5-7,Cleveland Cavaliers,82,19730,3311,6950,0.476,981,2636,0.372,2330,4314,0.54,1488,1909,0.779,694,2761,3455,1916,582,1091,1523,9091
10443,2018-5-7,Denver Nuggets,82,19880,3338,7102,0.47,940,2536,0.371,2398,4566,0.525,1404,1833,0.766,902,2748,3650,2058,627,1175,1533,9020
10444,2018-5-7,Philadelphia 76ers,82,19780,3349,7098,0.472,901,2445,0.369,2448,4653,0.526,1405,1868,0.752,893,2996,3889,2221,682,1301,1813,9004
10445,2018-5-7,Minnesota Timberwolves,82,19805,3365,7063,0.476,658,1845,0.357,2707,5218,0.519,1592,1980,0.804,848,2593,3441,1861,689,963,1495,8980
10446,2018-5-7,Los Angeles Clippers,82,19705,3302,7004,0.471,777,2196,0.354,2525,4808,0.525,1556,2095,0.743,832,2766,3598,1832,627,1154,1638,8937
10447,2018-5-7,Charlotte Hornets,82,19780,3197,7106,0.45,824,2233,0.369,2373,4873,0.487,1656,2216,0.747,826,2901,3727,1770,559,1011,1410,8874
10448,2018-5-7,Los Angeles Lakers,82,19905,3338,7248,0.461,822,2384,0.345,2516,4864,0.517,1364,1910,0.714,876,2926,3802,1949,633,1256,1738,8862
10449,2018-5-7,Oklahoma City Thunder,82,19830,3271,7220,0.453,881,2490,0.354,2390,4730,0.505,1421,1987,0.715,1024,2671,3695,1750,743,1102,1654,8844
10450,2018-5-7,Washington Wizards,82,19855,3275,7018,0.467,814,2173,0.375,2461,4845,0.508,1378,1785,0.772,823,2713,3536,2065,645,1152,1746,8742
10451,2018-5-7,Brooklyn Nets,82,19855,3136,7114,0.441,1041,2924,0.356,2095,4190,0.5,1428,1850,0.772,792,2851,3643,1942,512,1167,1688,8741
10452,2018-5-7,Milwaukee Bucks,82,19830,3257,6807,0.478,718,2024,0.355,2539,4783,0.531,1499,1916,0.782,688,2579,3267,1905,722,1078,1752,8731
10453,2018-5-7,Portland Trail Blazers,82,19755,3222,7132,0.452,845,2308,0.366,2377,4824,0.493,1372,1715,0.8,835,2893,3728,1599,573,1067,1599,8661
10454,2018-5-7,Indiana Pacers,82,19755,3345,7083,0.472,741,2010,0.369,2604,5073,0.513,1225,1573,0.779,788,2684,3472,1819,721,1048,1543,8656
10455,2018-5-7,New York Knicks,82,19830,3334,7194,0.463,673,1914,0.352,2661,5280,0.504,1225,1557,0.787,859,2752,3611,1912,552,1164,1682,8566
10456,2018-5-7,Utah Jazz,82,19755,3139,6797,0.462,887,2425,0.366,2252,4372,0.515,1375,1766,0.779,740,2807,3547,1839,708,1155,1608,8540
10457,2018-5-7,Boston Celtics,82,19805,3141,6975,0.45,939,2492,0.377,2202,4483,0.491,1308,1697,0.771,767,2878,3645,1842,604,1092,1618,8529
10458,2018-5-7,Phoenix Suns,82,19705,3153,7141,0.442,763,2286,0.334,2390,4855,0.492,1453,1963,0.74,842,2776,3618,1743,569,1235,1807,8522
10459,2018-5-7,Detroit Pistons,82,19805,3208,7129,0.45,886,2373,0.373,2322,4756,0.488,1207,1621,0.745,830,2756,3586,1868,628,1046,1508,8509
10460,2018-5-7,Atlanta Hawks,82,19705,3130,7014,0.446,917,2544,0.36,2213,4470,0.495,1298,1654,0.785,742,2693,3435,1946,638,1230,1606,8475
10461,2018-5-7,Orlando Magic,82,19730,3182,7042,0.452,844,2405,0.351,2338,4637,0.504,1271,1678,0.757,722,2692,3414,1921,622,1143,1580,8479
10462,2018-5-7,Miami Heat,82,19930,3184,6997,0.455,903,2506,0.36,2281,4491,0.508,1209,1601,0.755,763,2801,3564,1862,620,1119,1648,8480
10463,2018-5-7,Chicago Bulls,82,19855,3170,7286,0.435,906,2550,0.355,2264,4736,0.478,1194,1576,0.758,790,2873,3663,1923,626,1090,1572,8440
10464,2018-5-7,San Antonio Spurs,82,19730,3202,6999,0.457,696,1977,0.352,2506,5022,0.499,1324,1715,0.772,849,2777,3626,1868,628,1040,1409,8424
10465,2018-5-7,Dallas Mavericks,82,19805,3128,7041,0.444,967,2688,0.36,2161,4353,0.496,1167,1530,0.763,666,2717,3383,1858,578,965,1578,8390
10466,2018-5-7,Memphis Grizzlies,82,19705,3013,6788,0.444,758,2152,0.352,2255,4636,0.486,1361,1732,0.786,779,2544,3323,1767,613,1182,1900,8145
10467,2018-5-7,Sacramento Kings,82,19755,3179,7063,0.45,738,1967,0.375,2441,5096,0.479,1008,1371,0.735,777,2578,3355,1769,643,1083,1639,8104
10468,2018-5-8,Golden State Warriors,82,19730,3509,6980,0.503,926,2369,0.391,2583,4611,0.56,1360,1668,0.815,691,2877,3568,2402,656,1230,1606,9304
10469,2018-5-8,Houston Rockets,82,19755,3174,6906,0.46,1256,3470,0.362,1918,3436,0.558,1609,2061,0.781,739,2825,3564,1767,699,1081,1597,9213
10470,2018-5-8,New Orleans Pelicans,82,19955,3500,7241,0.483,837,2312,0.362,2663,4929,0.54,1324,1716,0.772,712,2924,3636,2195,657,1182,1570,9161
10471,2018-5-8,Toronto Raptors,82,19830,3383,7169,0.472,968,2703,0.358,2415,4466,0.541,1422,1790,0.794,800,2807,3607,1995,626,1045,1784,9156
10472,2018-5-8,Cleveland Cavaliers,82,19730,3311,6950,0.476,981,2636,0.372,2330,4314,0.54,1488,1909,0.779,694,2761,3455,1916,582,1091,1523,9091
10473,2018-5-8,Denver Nuggets,82,19880,3338,7102,0.47,940,2536,0.371,2398,4566,0.525,1404,1833,0.766,902,2748,3650,2058,627,1175,1533,9020
10474,2018-5-8,Philadelphia 76ers,82,19780,3349,7098,0.472,901,2445,0.369,2448,4653,0.526,1405,1868,0.752,893,2996,3889,2221,682,1301,1813,9004
10475,2018-5-8,Minnesota Timberwolves,82,19805,3365,7063,0.476,658,1845,0.357,2707,5218,0.519,1592,1980,0.804,848,2593,3441,1861,689,963,1495,8980
10476,2018-5-8,Los Angeles Clippers,82,19705,3302,7004,0.471,777,2196,0.354,2525,4808,0.525,1556,2095,0.743,832,2766,3598,1832,627,1154,1638,8937
10477,2018-5-8,Charlotte Hornets,82,19780,3197,7106,0.45,824,2233,0.369,2373,4873,0.487,1656,2216,0.747,826,2901,3727,1770,559,1011,1410,8874
10478,2018-5-8,Los Angeles Lakers,82,19905,3338,7248,0.461,822,2384,0.345,2516,4864,0.517,1364,1910,0.714,876,2926,3802,1949,633,1256,1738,8862
10479,2018-5-8,Oklahoma City Thunder,82,19830,3271,7220,0.453,881,2490,0.354,2390,4730,0.505,1421,1987,0.715,1024,2671,3695,1750,743,1102,1654,8844
10480,2018-5-8,Washington Wizards,82,19855,3275,7018,0.467,814,2173,0.375,2461,4845,0.508,1378,1785,0.772,823,2713,3536,2065,645,1152,1746,8742
10481,2018-5-8,Brooklyn Nets,82,19855,3136,7114,0.441,1041,2924,0.356,2095,4190,0.5,1428,1850,0.772,792,2851,3643,1942,512,1167,1688,8741
10482,2018-5-8,Milwaukee Bucks,82,19830,3257,6807,0.478,718,2024,0.355,2539,4783,0.531,1499,1916,0.782,688,2579,3267,1905,722,1078,1752,8731
10483,2018-5-8,Portland Trail Blazers,82,19755,3222,7132,0.452,845,2308,0.366,2377,4824,0.493,1372,1715,0.8,835,2893,3728,1599,573,1067,1599,8661
10484,2018-5-8,Indiana Pacers,82,19755,3345,7083,0.472,741,2010,0.369,2604,5073,0.513,1225,1573,0.779,788,2684,3472,1819,721,1048,1543,8656
10485,2018-5-8,New York Knicks,82,19830,3334,7194,0.463,673,1914,0.352,2661,5280,0.504,1225,1557,0.787,859,2752,3611,1912,552,1164,1682,8566
10486,2018-5-8,Utah Jazz,82,19755,3139,6797,0.462,887,2425,0.366,2252,4372,0.515,1375,1766,0.779,740,2807,3547,1839,708,1155,1608,8540
10487,2018-5-8,Boston Celtics,82,19805,3141,6975,0.45,939,2492,0.377,2202,4483,0.491,1308,1697,0.771,767,2878,3645,1842,604,1092,1618,8529
10488,2018-5-8,Phoenix Suns,82,19705,3153,7141,0.442,763,2286,0.334,2390,4855,0.492,1453,1963,0.74,842,2776,3618,1743,569,1235,1807,8522
10489,2018-5-8,Detroit Pistons,82,19805,3208,7129,0.45,886,2373,0.373,2322,4756,0.488,1207,1621,0.745,830,2756,3586,1868,628,1046,1508,8509
10490,2018-5-8,Atlanta Hawks,82,19705,3130,7014,0.446,917,2544,0.36,2213,4470,0.495,1298,1654,0.785,742,2693,3435,1946,638,1230,1606,8475
10491,2018-5-8,Orlando Magic,82,19730,3182,7042,0.452,844,2405,0.351,2338,4637,0.504,1271,1678,0.757,722,2692,3414,1921,622,1143,1580,8479
10492,2018-5-8,Miami Heat,82,19930,3184,6997,0.455,903,2506,0.36,2281,4491,0.508,1209,1601,0.755,763,2801,3564,1862,620,1119,1648,8480
10493,2018-5-8,Chicago Bulls,82,19855,3170,7286,0.435,906,2550,0.355,2264,4736,0.478,1194,1576,0.758,790,2873,3663,1923,626,1090,1572,8440
10494,2018-5-8,San Antonio Spurs,82,19730,3202,6999,0.457,696,1977,0.352,2506,5022,0.499,1324,1715,0.772,849,2777,3626,1868,628,1040,1409,8424
10495,2018-5-8,Dallas Mavericks,82,19805,3128,7041,0.444,967,2688,0.36,2161,4353,0.496,1167,1530,0.763,666,2717,3383,1858,578,965,1578,8390
10496,2018-5-8,Memphis Grizzlies,82,19705,3013,6788,0.444,758,2152,0.352,2255,4636,0.486,1361,1732,0.786,779,2544,3323,1767,613,1182,1900,8145
10497,2018-5-8,Sacramento Kings,82,19755,3179,7063,0.45,738,1967,0.375,2441,5096,0.479,1008,1371,0.735,777,2578,3355,1769,643,1083,1639,8104
10498,2018-5-9,Golden State Warriors,82,19730,3509,6980,0.503,926,2369,0.391,2583,4611,0.56,1360,1668,0.815,691,2877,3568,2402,656,1230,1606,9304
10499,2018-5-9,Houston Rockets,82,19755,3174,6906,0.46,1256,3470,0.362,1918,3436,0.558,1609,2061,0.781,739,2825,3564,1767,699,1081,1597,9213
10500,2018-5-9,New Orleans Pelicans,82,19955,3500,7241,0.483,837,2312,0.362,2663,4929,0.54,1324,1716,0.772,712,2924,3636,2195,657,1182,1570,9161
10501,2018-5-9,Toronto Raptors,82,19830,3383,7169,0.472,968,2703,0.358,2415,4466,0.541,1422,1790,0.794,800,2807,3607,1995,626,1045,1784,9156
10502,2018-5-9,Cleveland Cavaliers,82,19730,3311,6950,0.476,981,2636,0.372,2330,4314,0.54,1488,1909,0.779,694,2761,3455,1916,582,1091,1523,9091
10503,2018-5-9,Denver Nuggets,82,19880,3338,7102,0.47,940,2536,0.371,2398,4566,0.525,1404,1833,0.766,902,2748,3650,2058,627,1175,1533,9020
10504,2018-5-9,Philadelphia 76ers,82,19780,3349,7098,0.472,901,2445,0.369,2448,4653,0.526,1405,1868,0.752,893,2996,3889,2221,682,1301,1813,9004
10505,2018-5-9,Minnesota Timberwolves,82,19805,3365,7063,0.476,658,1845,0.357,2707,5218,0.519,1592,1980,0.804,848,2593,3441,1861,689,963,1495,8980
10506,2018-5-9,Los Angeles Clippers,82,19705,3302,7004,0.471,777,2196,0.354,2525,4808,0.525,1556,2095,0.743,832,2766,3598,1832,627,1154,1638,8937
10507,2018-5-9,Charlotte Hornets,82,19780,3197,7106,0.45,824,2233,0.369,2373,4873,0.487,1656,2216,0.747,826,2901,3727,1770,559,1011,1410,8874
10508,2018-5-9,Los Angeles Lakers,82,19905,3338,7248,0.461,822,2384,0.345,2516,4864,0.517,1364,1910,0.714,876,2926,3802,1949,633,1256,1738,8862
10509,2018-5-9,Oklahoma City Thunder,82,19830,3271,7220,0.453,881,2490,0.354,2390,4730,0.505,1421,1987,0.715,1024,2671,3695,1750,743,1102,1654,8844
10510,2018-5-9,Washington Wizards,82,19855,3275,7018,0.467,814,2173,0.375,2461,4845,0.508,1378,1785,0.772,823,2713,3536,2065,645,1152,1746,8742
10511,2018-5-9,Brooklyn Nets,82,19855,3136,7114,0.441,1041,2924,0.356,2095,4190,0.5,1428,1850,0.772,792,2851,3643,1942,512,1167,1688,8741
10512,2018-5-9,Milwaukee Bucks,82,19830,3257,6807,0.478,718,2024,0.355,2539,4783,0.531,1499,1916,0.782,688,2579,3267,1905,722,1078,1752,8731
10513,2018-5-9,Portland Trail Blazers,82,19755,3222,7132,0.452,845,2308,0.366,2377,4824,0.493,1372,1715,0.8,835,2893,3728,1599,573,1067,1599,8661
10514,2018-5-9,Indiana Pacers,82,19755,3345,7083,0.472,741,2010,0.369,2604,5073,0.513,1225,1573,0.779,788,2684,3472,1819,721,1048,1543,8656
10515,2018-5-9,New York Knicks,82,19830,3334,7194,0.463,673,1914,0.352,2661,5280,0.504,1225,1557,0.787,859,2752,3611,1912,552,1164,1682,8566
10516,2018-5-9,Utah Jazz,82,19755,3139,6797,0.462,887,2425,0.366,2252,4372,0.515,1375,1766,0.779,740,2807,3547,1839,708,1155,1608,8540
10517,2018-5-9,Boston Celtics,82,19805,3141,6975,0.45,939,2492,0.377,2202,4483,0.491,1308,1697,0.771,767,2878,3645,1842,604,1092,1618,8529
10518,2018-5-9,Phoenix Suns,82,19705,3153,7141,0.442,763,2286,0.334,2390,4855,0.492,1453,1963,0.74,842,2776,3618,1743,569,1235,1807,8522
10519,2018-5-9,Detroit Pistons,82,19805,3208,7129,0.45,886,2373,0.373,2322,4756,0.488,1207,1621,0.745,830,2756,3586,1868,628,1046,1508,8509
10520,2018-5-9,Atlanta Hawks,82,19705,3130,7014,0.446,917,2544,0.36,2213,4470,0.495,1298,1654,0.785,742,2693,3435,1946,638,1230,1606,8475
10521,2018-5-9,Orlando Magic,82,19730,3182,7042,0.452,844,2405,0.351,2338,4637,0.504,1271,1678,0.757,722,2692,3414,1921,622,1143,1580,8479
10522,2018-5-9,Miami Heat,82,19930,3184,6997,0.455,903,2506,0.36,2281,4491,0.508,1209,1601,0.755,763,2801,3564,1862,620,1119,1648,8480
10523,2018-5-9,Chicago Bulls,82,19855,3170,7286,0.435,906,2550,0.355,2264,4736,0.478,1194,1576,0.758,790,2873,3663,1923,626,1090,1572,8440
10524,2018-5-9,San Antonio Spurs,82,19730,3202,6999,0.457,696,1977,0.352,2506,5022,0.499,1324,1715,0.772,849,2777,3626,1868,628,1040,1409,8424
10525,2018-5-9,Dallas Mavericks,82,19805,3128,7041,0.444,967,2688,0.36,2161,4353,0.496,1167,1530,0.763,666,2717,3383,1858,578,965,1578,8390
10526,2018-5-9,Memphis Grizzlies,82,19705,3013,6788,0.444,758,2152,0.352,2255,4636,0.486,1361,1732,0.786,779,2544,3323,1767,613,1182,1900,8145
10527,2018-5-9,Sacramento Kings,82,19755,3179,7063,0.45,738,1967,0.375,2441,5096,0.479,1008,1371,0.735,777,2578,3355,1769,643,1083,1639,8104
10528,2018-5-10,Golden State Warriors,82,19730,3509,6980,0.503,926,2369,0.391,2583,4611,0.56,1360,1668,0.815,691,2877,3568,2402,656,1230,1606,9304
10529,2018-5-10,Houston Rockets,82,19755,3174,6906,0.46,1256,3470,0.362,1918,3436,0.558,1609,2061,0.781,739,2825,3564,1767,699,1081,1597,9213
10530,2018-5-10,New Orleans Pelicans,82,19955,3500,7241,0.483,837,2312,0.362,2663,4929,0.54,1324,1716,0.772,712,2924,3636,2195,657,1182,1570,9161
10531,2018-5-10,Toronto Raptors,82,19830,3383,7169,0.472,968,2703,0.358,2415,4466,0.541,1422,1790,0.794,800,2807,3607,1995,626,1045,1784,9156
10532,2018-5-10,Cleveland Cavaliers,82,19730,3311,6950,0.476,981,2636,0.372,2330,4314,0.54,1488,1909,0.779,694,2761,3455,1916,582,1091,1523,9091
10533,2018-5-10,Denver Nuggets,82,19880,3338,7102,0.47,940,2536,0.371,2398,4566,0.525,1404,1833,0.766,902,2748,3650,2058,627,1175,1533,9020
10534,2018-5-10,Philadelphia 76ers,82,19780,3349,7098,0.472,901,2445,0.369,2448,4653,0.526,1405,1868,0.752,893,2996,3889,2221,682,1301,1813,9004
10535,2018-5-10,Minnesota Timberwolves,82,19805,3365,7063,0.476,658,1845,0.357,2707,5218,0.519,1592,1980,0.804,848,2593,3441,1861,689,963,1495,8980
10536,2018-5-10,Los Angeles Clippers,82,19705,3302,7004,0.471,777,2196,0.354,2525,4808,0.525,1556,2095,0.743,832,2766,3598,1832,627,1154,1638,8937
10537,2018-5-10,Charlotte Hornets,82,19780,3197,7106,0.45,824,2233,0.369,2373,4873,0.487,1656,2216,0.747,826,2901,3727,1770,559,1011,1410,8874
10538,2018-5-10,Los Angeles Lakers,82,19905,3338,7248,0.461,822,2384,0.345,2516,4864,0.517,1364,1910,0.714,876,2926,3802,1949,633,1256,1738,8862
10539,2018-5-10,Oklahoma City Thunder,82,19830,3271,7220,0.453,881,2490,0.354,2390,4730,0.505,1421,1987,0.715,1024,2671,3695,1750,743,1102,1654,8844
10540,2018-5-10,Washington Wizards,82,19855,3275,7018,0.467,814,2173,0.375,2461,4845,0.508,1378,1785,0.772,823,2713,3536,2065,645,1152,1746,8742
10541,2018-5-10,Brooklyn Nets,82,19855,3136,7114,0.441,1041,2924,0.356,2095,4190,0.5,1428,1850,0.772,792,2851,3643,1942,512,1167,1688,8741
10542,2018-5-10,Milwaukee Bucks,82,19830,3257,6807,0.478,718,2024,0.355,2539,4783,0.531,1499,1916,0.782,688,2579,3267,1905,722,1078,1752,8731
10543,2018-5-10,Portland Trail Blazers,82,19755,3222,7132,0.452,845,2308,0.366,2377,4824,0.493,1372,1715,0.8,835,2893,3728,1599,573,1067,1599,8661
10544,2018-5-10,Indiana Pacers,82,19755,3345,7083,0.472,741,2010,0.369,2604,5073,0.513,1225,1573,0.779,788,2684,3472,1819,721,1048,1543,8656
10545,2018-5-10,New York Knicks,82,19830,3334,7194,0.463,673,1914,0.352,2661,5280,0.504,1225,1557,0.787,859,2752,3611,1912,552,1164,1682,8566
10546,2018-5-10,Utah Jazz,82,19755,3139,6797,0.462,887,2425,0.366,2252,4372,0.515,1375,1766,0.779,740,2807,3547,1839,708,1155,1608,8540
10547,2018-5-10,Boston Celtics,82,19805,3141,6975,0.45,939,2492,0.377,2202,4483,0.491,1308,1697,0.771,767,2878,3645,1842,604,1092,1618,8529
10548,2018-5-10,Phoenix Suns,82,19705,3153,7141,0.442,763,2286,0.334,2390,4855,0.492,1453,1963,0.74,842,2776,3618,1743,569,1235,1807,8522
10549,2018-5-10,Detroit Pistons,82,19805,3208,7129,0.45,886,2373,0.373,2322,4756,0.488,1207,1621,0.745,830,2756,3586,1868,628,1046,1508,8509
10550,2018-5-10,Atlanta Hawks,82,19705,3130,7014,0.446,917,2544,0.36,2213,4470,0.495,1298,1654,0.785,742,2693,3435,1946,638,1230,1606,8475
10551,2018-5-10,Orlando Magic,82,19730,3182,7042,0.452,844,2405,0.351,2338,4637,0.504,1271,1678,0.757,722,2692,3414,1921,622,1143,1580,8479
10552,2018-5-10,Miami Heat,82,19930,3184,6997,0.455,903,2506,0.36,2281,4491,0.508,1209,1601,0.755,763,2801,3564,1862,620,1119,1648,8480
10553,2018-5-10,Chicago Bulls,82,19855,3170,7286,0.435,906,2550,0.355,2264,4736,0.478,1194,1576,0.758,790,2873,3663,1923,626,1090,1572,8440
10554,2018-5-10,San Antonio Spurs,82,19730,3202,6999,0.457,696,1977,0.352,2506,5022,0.499,1324,1715,0.772,849,2777,3626,1868,628,1040,1409,8424
10555,2018-5-10,Dallas Mavericks,82,19805,3128,7041,0.444,967,2688,0.36,2161,4353,0.496,1167,1530,0.763,666,2717,3383,1858,578,965,1578,8390
10556,2018-5-10,Memphis Grizzlies,82,19705,3013,6788,0.444,758,2152,0.352,2255,4636,0.486,1361,1732,0.786,779,2544,3323,1767,613,1182,1900,8145
10557,2018-5-10,Sacramento Kings,82,19755,3179,7063,0.45,738,1967,0.375,2441,5096,0.479,1008,1371,0.735,777,2578,3355,1769,643,1083,1639,8104
10558,2018-5-11,Golden State Warriors,82,19730,3509,6980,0.503,926,2369,0.391,2583,4611,0.56,1360,1668,0.815,691,2877,3568,2402,656,1230,1606,9304
10559,2018-5-11,Houston Rockets,82,19755,3174,6906,0.46,1256,3470,0.362,1918,3436,0.558,1609,2061,0.781,739,2825,3564,1767,699,1081,1597,9213
10560,2018-5-11,New Orleans Pelicans,82,19955,3500,7241,0.483,837,2312,0.362,2663,4929,0.54,1324,1716,0.772,712,2924,3636,2195,657,1182,1570,9161
10561,2018-5-11,Toronto Raptors,82,19830,3383,7169,0.472,968,2703,0.358,2415,4466,0.541,1422,1790,0.794,800,2807,3607,1995,626,1045,1784,9156
10562,2018-5-11,Cleveland Cavaliers,82,19730,3311,6950,0.476,981,2636,0.372,2330,4314,0.54,1488,1909,0.779,694,2761,3455,1916,582,1091,1523,9091
10563,2018-5-11,Denver Nuggets,82,19880,3338,7102,0.47,940,2536,0.371,2398,4566,0.525,1404,1833,0.766,902,2748,3650,2058,627,1175,1533,9020
10564,2018-5-11,Philadelphia 76ers,82,19780,3349,7098,0.472,901,2445,0.369,2448,4653,0.526,1405,1868,0.752,893,2996,3889,2221,682,1301,1813,9004
10565,2018-5-11,Minnesota Timberwolves,82,19805,3365,7063,0.476,658,1845,0.357,2707,5218,0.519,1592,1980,0.804,848,2593,3441,1861,689,963,1495,8980
10566,2018-5-11,Los Angeles Clippers,82,19705,3302,7004,0.471,777,2196,0.354,2525,4808,0.525,1556,2095,0.743,832,2766,3598,1832,627,1154,1638,8937
10567,2018-5-11,Charlotte Hornets,82,19780,3197,7106,0.45,824,2233,0.369,2373,4873,0.487,1656,2216,0.747,826,2901,3727,1770,559,1011,1410,8874
10568,2018-5-11,Los Angeles Lakers,82,19905,3338,7248,0.461,822,2384,0.345,2516,4864,0.517,1364,1910,0.714,876,2926,3802,1949,633,1256,1738,8862
10569,2018-5-11,Oklahoma City Thunder,82,19830,3271,7220,0.453,881,2490,0.354,2390,4730,0.505,1421,1987,0.715,1024,2671,3695,1750,743,1102,1654,8844
10570,2018-5-11,Washington Wizards,82,19855,3275,7018,0.467,814,2173,0.375,2461,4845,0.508,1378,1785,0.772,823,2713,3536,2065,645,1152,1746,8742
10571,2018-5-11,Brooklyn Nets,82,19855,3136,7114,0.441,1041,2924,0.356,2095,4190,0.5,1428,1850,0.772,792,2851,3643,1942,512,1167,1688,8741
10572,2018-5-11,Milwaukee Bucks,82,19830,3257,6807,0.478,718,2024,0.355,2539,4783,0.531,1499,1916,0.782,688,2579,3267,1905,722,1078,1752,8731
10573,2018-5-11,Portland Trail Blazers,82,19755,3222,7132,0.452,845,2308,0.366,2377,4824,0.493,1372,1715,0.8,835,2893,3728,1599,573,1067,1599,8661
10574,2018-5-11,Indiana Pacers,82,19755,3345,7083,0.472,741,2010,0.369,2604,5073,0.513,1225,1573,0.779,788,2684,3472,1819,721,1048,1543,8656
10575,2018-5-11,New York Knicks,82,19830,3334,7194,0.463,673,1914,0.352,2661,5280,0.504,1225,1557,0.787,859,2752,3611,1912,552,1164,1682,8566
10576,2018-5-11,Utah Jazz,82,19755,3139,6797,0.462,887,2425,0.366,2252,4372,0.515,1375,1766,0.779,740,2807,3547,1839,708,1155,1608,8540
10577,2018-5-11,Boston Celtics,82,19805,3141,6975,0.45,939,2492,0.377,2202,4483,0.491,1308,1697,0.771,767,2878,3645,1842,604,1092,1618,8529
10578,2018-5-11,Phoenix Suns,82,19705,3153,7141,0.442,763,2286,0.334,2390,4855,0.492,1453,1963,0.74,842,2776,3618,1743,569,1235,1807,8522
10579,2018-5-11,Detroit Pistons,82,19805,3208,7129,0.45,886,2373,0.373,2322,4756,0.488,1207,1621,0.745,830,2756,3586,1868,628,1046,1508,8509
10580,2018-5-11,Atlanta Hawks,82,19705,3130,7014,0.446,917,2544,0.36,2213,4470,0.495,1298,1654,0.785,742,2693,3435,1946,638,1230,1606,8475
10581,2018-5-11,Orlando Magic,82,19730,3182,7042,0.452,844,2405,0.351,2338,4637,0.504,1271,1678,0.757,722,2692,3414,1921,622,1143,1580,8479
10582,2018-5-11,Miami Heat,82,19930,3184,6997,0.455,903,2506,0.36,2281,4491,0.508,1209,1601,0.755,763,2801,3564,1862,620,1119,1648,8480
10583,2018-5-11,Chicago Bulls,82,19855,3170,7286,0.435,906,2550,0.355,2264,4736,0.478,1194,1576,0.758,790,2873,3663,1923,626,1090,1572,8440
10584,2018-5-11,San Antonio Spurs,82,19730,3202,6999,0.457,696,1977,0.352,2506,5022,0.499,1324,1715,0.772,849,2777,3626,1868,628,1040,1409,8424
10585,2018-5-11,Dallas Mavericks,82,19805,3128,7041,0.444,967,2688,0.36,2161,4353,0.496,1167,1530,0.763,666,2717,3383,1858,578,965,1578,8390
10586,2018-5-11,Memphis Grizzlies,82,19705,3013,6788,0.444,758,2152,0.352,2255,4636,0.486,1361,1732,0.786,779,2544,3323,1767,613,1182,1900,8145
10587,2018-5-11,Sacramento Kings,82,19755,3179,7063,0.45,738,1967,0.375,2441,5096,0.479,1008,1371,0.735,777,2578,3355,1769,643,1083,1639,8104
10588,2018-5-12,Golden State Warriors,82,19730,3509,6980,0.503,926,2369,0.391,2583,4611,0.56,1360,1668,0.815,691,2877,3568,2402,656,1230,1606,9304
10589,2018-5-12,Houston Rockets,82,19755,3174,6906,0.46,1256,3470,0.362,1918,3436,0.558,1609,2061,0.781,739,2825,3564,1767,699,1081,1597,9213
10590,2018-5-12,New Orleans Pelicans,82,19955,3500,7241,0.483,837,2312,0.362,2663,4929,0.54,1324,1716,0.772,712,2924,3636,2195,657,1182,1570,9161
10591,2018-5-12,Toronto Raptors,82,19830,3383,7169,0.472,968,2703,0.358,2415,4466,0.541,1422,1790,0.794,800,2807,3607,1995,626,1045,1784,9156
10592,2018-5-12,Cleveland Cavaliers,82,19730,3311,6950,0.476,981,2636,0.372,2330,4314,0.54,1488,1909,0.779,694,2761,3455,1916,582,1091,1523,9091
10593,2018-5-12,Denver Nuggets,82,19880,3338,7102,0.47,940,2536,0.371,2398,4566,0.525,1404,1833,0.766,902,2748,3650,2058,627,1175,1533,9020
10594,2018-5-12,Philadelphia 76ers,82,19780,3349,7098,0.472,901,2445,0.369,2448,4653,0.526,1405,1868,0.752,893,2996,3889,2221,682,1301,1813,9004
10595,2018-5-12,Minnesota Timberwolves,82,19805,3365,7063,0.476,658,1845,0.357,2707,5218,0.519,1592,1980,0.804,848,2593,3441,1861,689,963,1495,8980
10596,2018-5-12,Los Angeles Clippers,82,19705,3302,7004,0.471,777,2196,0.354,2525,4808,0.525,1556,2095,0.743,832,2766,3598,1832,627,1154,1638,8937
10597,2018-5-12,Charlotte Hornets,82,19780,3197,7106,0.45,824,2233,0.369,2373,4873,0.487,1656,2216,0.747,826,2901,3727,1770,559,1011,1410,8874
10598,2018-5-12,Los Angeles Lakers,82,19905,3338,7248,0.461,822,2384,0.345,2516,4864,0.517,1364,1910,0.714,876,2926,3802,1949,633,1256,1738,8862
10599,2018-5-12,Oklahoma City Thunder,82,19830,3271,7220,0.453,881,2490,0.354,2390,4730,0.505,1421,1987,0.715,1024,2671,3695,1750,743,1102,1654,8844
10600,2018-5-12,Washington Wizards,82,19855,3275,7018,0.467,814,2173,0.375,2461,4845,0.508,1378,1785,0.772,823,2713,3536,2065,645,1152,1746,8742
10601,2018-5-12,Brooklyn Nets,82,19855,3136,7114,0.441,1041,2924,0.356,2095,4190,0.5,1428,1850,0.772,792,2851,3643,1942,512,1167,1688,8741
10602,2018-5-12,Milwaukee Bucks,82,19830,3257,6807,0.478,718,2024,0.355,2539,4783,0.531,1499,1916,0.782,688,2579,3267,1905,722,1078,1752,8731
10603,2018-5-12,Portland Trail Blazers,82,19755,3222,7132,0.452,845,2308,0.366,2377,4824,0.493,1372,1715,0.8,835,2893,3728,1599,573,1067,1599,8661
10604,2018-5-12,Indiana Pacers,82,19755,3345,7083,0.472,741,2010,0.369,2604,5073,0.513,1225,1573,0.779,788,2684,3472,1819,721,1048,1543,8656
10605,2018-5-12,New York Knicks,82,19830,3334,7194,0.463,673,1914,0.352,2661,5280,0.504,1225,1557,0.787,859,2752,3611,1912,552,1164,1682,8566
10606,2018-5-12,Utah Jazz,82,19755,3139,6797,0.462,887,2425,0.366,2252,4372,0.515,1375,1766,0.779,740,2807,3547,1839,708,1155,1608,8540
10607,2018-5-12,Boston Celtics,82,19805,3141,6975,0.45,939,2492,0.377,2202,4483,0.491,1308,1697,0.771,767,2878,3645,1842,604,1092,1618,8529
10608,2018-5-12,Phoenix Suns,82,19705,3153,7141,0.442,763,2286,0.334,2390,4855,0.492,1453,1963,0.74,842,2776,3618,1743,569,1235,1807,8522
10609,2018-5-12,Detroit Pistons,82,19805,3208,7129,0.45,886,2373,0.373,2322,4756,0.488,1207,1621,0.745,830,2756,3586,1868,628,1046,1508,8509
10610,2018-5-12,Atlanta Hawks,82,19705,3130,7014,0.446,917,2544,0.36,2213,4470,0.495,1298,1654,0.785,742,2693,3435,1946,638,1230,1606,8475
10611,2018-5-12,Orlando Magic,82,19730,3182,7042,0.452,844,2405,0.351,2338,4637,0.504,1271,1678,0.757,722,2692,3414,1921,622,1143,1580,8479
10612,2018-5-12,Miami Heat,82,19930,3184,6997,0.455,903,2506,0.36,2281,4491,0.508,1209,1601,0.755,763,2801,3564,1862,620,1119,1648,8480
10613,2018-5-12,Chicago Bulls,82,19855,3170,7286,0.435,906,2550,0.355,2264,4736,0.478,1194,1576,0.758,790,2873,3663,1923,626,1090,1572,8440
10614,2018-5-12,San Antonio Spurs,82,19730,3202,6999,0.457,696,1977,0.352,2506,5022,0.499,1324,1715,0.772,849,2777,3626,1868,628,1040,1409,8424
10615,2018-5-12,Dallas Mavericks,82,19805,3128,7041,0.444,967,2688,0.36,2161,4353,0.496,1167,1530,0.763,666,2717,3383,1858,578,965,1578,8390
10616,2018-5-12,Memphis Grizzlies,82,19705,3013,6788,0.444,758,2152,0.352,2255,4636,0.486,1361,1732,0.786,779,2544,3323,1767,613,1182,1900,8145
10617,2018-5-12,Sacramento Kings,82,19755,3179,7063,0.45,738,1967,0.375,2441,5096,0.479,1008,1371,0.735,777,2578,3355,1769,643,1083,1639,8104
10618,2018-5-13,Golden State Warriors,82,19730,3509,6980,0.503,926,2369,0.391,2583,4611,0.56,1360,1668,0.815,691,2877,3568,2402,656,1230,1606,9304
10619,2018-5-13,Houston Rockets,82,19755,3174,6906,0.46,1256,3470,0.362,1918,3436,0.558,1609,2061,0.781,739,2825,3564,1767,699,1081,1597,9213
10620,2018-5-13,New Orleans Pelicans,82,19955,3500,7241,0.483,837,2312,0.362,2663,4929,0.54,1324,1716,0.772,712,2924,3636,2195,657,1182,1570,9161
10621,2018-5-13,Toronto Raptors,82,19830,3383,7169,0.472,968,2703,0.358,2415,4466,0.541,1422,1790,0.794,800,2807,3607,1995,626,1045,1784,9156
10622,2018-5-13,Cleveland Cavaliers,82,19730,3311,6950,0.476,981,2636,0.372,2330,4314,0.54,1488,1909,0.779,694,2761,3455,1916,582,1091,1523,9091
10623,2018-5-13,Denver Nuggets,82,19880,3338,7102,0.47,940,2536,0.371,2398,4566,0.525,1404,1833,0.766,902,2748,3650,2058,627,1175,1533,9020
10624,2018-5-13,Philadelphia 76ers,82,19780,3349,7098,0.472,901,2445,0.369,2448,4653,0.526,1405,1868,0.752,893,2996,3889,2221,682,1301,1813,9004
10625,2018-5-13,Minnesota Timberwolves,82,19805,3365,7063,0.476,658,1845,0.357,2707,5218,0.519,1592,1980,0.804,848,2593,3441,1861,689,963,1495,8980
10626,2018-5-13,Los Angeles Clippers,82,19705,3302,7004,0.471,777,2196,0.354,2525,4808,0.525,1556,2095,0.743,832,2766,3598,1832,627,1154,1638,8937
10627,2018-5-13,Charlotte Hornets,82,19780,3197,7106,0.45,824,2233,0.369,2373,4873,0.487,1656,2216,0.747,826,2901,3727,1770,559,1011,1410,8874
10628,2018-5-13,Los Angeles Lakers,82,19905,3338,7248,0.461,822,2384,0.345,2516,4864,0.517,1364,1910,0.714,876,2926,3802,1949,633,1256,1738,8862
10629,2018-5-13,Oklahoma City Thunder,82,19830,3271,7220,0.453,881,2490,0.354,2390,4730,0.505,1421,1987,0.715,1024,2671,3695,1750,743,1102,1654,8844
10630,2018-5-13,Washington Wizards,82,19855,3275,7018,0.467,814,2173,0.375,2461,4845,0.508,1378,1785,0.772,823,2713,3536,2065,645,1152,1746,8742
10631,2018-5-13,Brooklyn Nets,82,19855,3136,7114,0.441,1041,2924,0.356,2095,4190,0.5,1428,1850,0.772,792,2851,3643,1942,512,1167,1688,8741
10632,2018-5-13,Milwaukee Bucks,82,19830,3257,6807,0.478,718,2024,0.355,2539,4783,0.531,1499,1916,0.782,688,2579,3267,1905,722,1078,1752,8731
10633,2018-5-13,Portland Trail Blazers,82,19755,3222,7132,0.452,845,2308,0.366,2377,4824,0.493,1372,1715,0.8,835,2893,3728,1599,573,1067,1599,8661
10634,2018-5-13,Indiana Pacers,82,19755,3345,7083,0.472,741,2010,0.369,2604,5073,0.513,1225,1573,0.779,788,2684,3472,1819,721,1048,1543,8656
10635,2018-5-13,New York Knicks,82,19830,3334,7194,0.463,673,1914,0.352,2661,5280,0.504,1225,1557,0.787,859,2752,3611,1912,552,1164,1682,8566
10636,2018-5-13,Utah Jazz,82,19755,3139,6797,0.462,887,2425,0.366,2252,4372,0.515,1375,1766,0.779,740,2807,3547,1839,708,1155,1608,8540
10637,2018-5-13,Boston Celtics,82,19805,3141,6975,0.45,939,2492,0.377,2202,4483,0.491,1308,1697,0.771,767,2878,3645,1842,604,1092,1618,8529
10638,2018-5-13,Phoenix Suns,82,19705,3153,7141,0.442,763,2286,0.334,2390,4855,0.492,1453,1963,0.74,842,2776,3618,1743,569,1235,1807,8522
10639,2018-5-13,Detroit Pistons,82,19805,3208,7129,0.45,886,2373,0.373,2322,4756,0.488,1207,1621,0.745,830,2756,3586,1868,628,1046,1508,8509
10640,2018-5-13,Atlanta Hawks,82,19705,3130,7014,0.446,917,2544,0.36,2213,4470,0.495,1298,1654,0.785,742,2693,3435,1946,638,1230,1606,8475
10641,2018-5-13,Orlando Magic,82,19730,3182,7042,0.452,844,2405,0.351,2338,4637,0.504,1271,1678,0.757,722,2692,3414,1921,622,1143,1580,8479
10642,2018-5-13,Miami Heat,82,19930,3184,6997,0.455,903,2506,0.36,2281,4491,0.508,1209,1601,0.755,763,2801,3564,1862,620,1119,1648,8480
10643,2018-5-13,Chicago Bulls,82,19855,3170,7286,0.435,906,2550,0.355,2264,4736,0.478,1194,1576,0.758,790,2873,3663,1923,626,1090,1572,8440
10644,2018-5-13,San Antonio Spurs,82,19730,3202,6999,0.457,696,1977,0.352,2506,5022,0.499,1324,1715,0.772,849,2777,3626,1868,628,1040,1409,8424
10645,2018-5-13,Dallas Mavericks,82,19805,3128,7041,0.444,967,2688,0.36,2161,4353,0.496,1167,1530,0.763,666,2717,3383,1858,578,965,1578,8390
10646,2018-5-13,Memphis Grizzlies,82,19705,3013,6788,0.444,758,2152,0.352,2255,4636,0.486,1361,1732,0.786,779,2544,3323,1767,613,1182,1900,8145
10647,2018-5-13,Sacramento Kings,82,19755,3179,7063,0.45,738,1967,0.375,2441,5096,0.479,1008,1371,0.735,777,2578,3355,1769,643,1083,1639,8104
10648,2018-5-14,Golden State Warriors,82,19730,3509,6980,0.503,926,2369,0.391,2583,4611,0.56,1360,1668,0.815,691,2877,3568,2402,656,1230,1606,9304
10649,2018-5-14,Houston Rockets,82,19755,3174,6906,0.46,1256,3470,0.362,1918,3436,0.558,1609,2061,0.781,739,2825,3564,1767,699,1081,1597,9213
10650,2018-5-14,New Orleans Pelicans,82,19955,3500,7241,0.483,837,2312,0.362,2663,4929,0.54,1324,1716,0.772,712,2924,3636,2195,657,1182,1570,9161
10651,2018-5-14,Toronto Raptors,82,19830,3383,7169,0.472,968,2703,0.358,2415,4466,0.541,1422,1790,0.794,800,2807,3607,1995,626,1045,1784,9156
10652,2018-5-14,Cleveland Cavaliers,82,19730,3311,6950,0.476,981,2636,0.372,2330,4314,0.54,1488,1909,0.779,694,2761,3455,1916,582,1091,1523,9091
10653,2018-5-14,Denver Nuggets,82,19880,3338,7102,0.47,940,2536,0.371,2398,4566,0.525,1404,1833,0.766,902,2748,3650,2058,627,1175,1533,9020
10654,2018-5-14,Philadelphia 76ers,82,19780,3349,7098,0.472,901,2445,0.369,2448,4653,0.526,1405,1868,0.752,893,2996,3889,2221,682,1301,1813,9004
10655,2018-5-14,Minnesota Timberwolves,82,19805,3365,7063,0.476,658,1845,0.357,2707,5218,0.519,1592,1980,0.804,848,2593,3441,1861,689,963,1495,8980
10656,2018-5-14,Los Angeles Clippers,82,19705,3302,7004,0.471,777,2196,0.354,2525,4808,0.525,1556,2095,0.743,832,2766,3598,1832,627,1154,1638,8937
10657,2018-5-14,Charlotte Hornets,82,19780,3197,7106,0.45,824,2233,0.369,2373,4873,0.487,1656,2216,0.747,826,2901,3727,1770,559,1011,1410,8874
10658,2018-5-14,Los Angeles Lakers,82,19905,3338,7248,0.461,822,2384,0.345,2516,4864,0.517,1364,1910,0.714,876,2926,3802,1949,633,1256,1738,8862
10659,2018-5-14,Oklahoma City Thunder,82,19830,3271,7220,0.453,881,2490,0.354,2390,4730,0.505,1421,1987,0.715,1024,2671,3695,1750,743,1102,1654,8844
10660,2018-5-14,Washington Wizards,82,19855,3275,7018,0.467,814,2173,0.375,2461,4845,0.508,1378,1785,0.772,823,2713,3536,2065,645,1152,1746,8742
10661,2018-5-14,Brooklyn Nets,82,19855,3136,7114,0.441,1041,2924,0.356,2095,4190,0.5,1428,1850,0.772,792,2851,3643,1942,512,1167,1688,8741
10662,2018-5-14,Milwaukee Bucks,82,19830,3257,6807,0.478,718,2024,0.355,2539,4783,0.531,1499,1916,0.782,688,2579,3267,1905,722,1078,1752,8731
10663,2018-5-14,Portland Trail Blazers,82,19755,3222,7132,0.452,845,2308,0.366,2377,4824,0.493,1372,1715,0.8,835,2893,3728,1599,573,1067,1599,8661
10664,2018-5-14,Indiana Pacers,82,19755,3345,7083,0.472,741,2010,0.369,2604,5073,0.513,1225,1573,0.779,788,2684,3472,1819,721,1048,1543,8656
10665,2018-5-14,New York Knicks,82,19830,3334,7194,0.463,673,1914,0.352,2661,5280,0.504,1225,1557,0.787,859,2752,3611,1912,552,1164,1682,8566
10666,2018-5-14,Utah Jazz,82,19755,3139,6797,0.462,887,2425,0.366,2252,4372,0.515,1375,1766,0.779,740,2807,3547,1839,708,1155,1608,8540
10667,2018-5-14,Boston Celtics,82,19805,3141,6975,0.45,939,2492,0.377,2202,4483,0.491,1308,1697,0.771,767,2878,3645,1842,604,1092,1618,8529
10668,2018-5-14,Phoenix Suns,82,19705,3153,7141,0.442,763,2286,0.334,2390,4855,0.492,1453,1963,0.74,842,2776,3618,1743,569,1235,1807,8522
10669,2018-5-14,Detroit Pistons,82,19805,3208,7129,0.45,886,2373,0.373,2322,4756,0.488,1207,1621,0.745,830,2756,3586,1868,628,1046,1508,8509
10670,2018-5-14,Atlanta Hawks,82,19705,3130,7014,0.446,917,2544,0.36,2213,4470,0.495,1298,1654,0.785,742,2693,3435,1946,638,1230,1606,8475
10671,2018-5-14,Orlando Magic,82,19730,3182,7042,0.452,844,2405,0.351,2338,4637,0.504,1271,1678,0.757,722,2692,3414,1921,622,1143,1580,8479
10672,2018-5-14,Miami Heat,82,19930,3184,6997,0.455,903,2506,0.36,2281,4491,0.508,1209,1601,0.755,763,2801,3564,1862,620,1119,1648,8480
10673,2018-5-14,Chicago Bulls,82,19855,3170,7286,0.435,906,2550,0.355,2264,4736,0.478,1194,1576,0.758,790,2873,3663,1923,626,1090,1572,8440
10674,2018-5-14,San Antonio Spurs,82,19730,3202,6999,0.457,696,1977,0.352,2506,5022,0.499,1324,1715,0.772,849,2777,3626,1868,628,1040,1409,8424
10675,2018-5-14,Dallas Mavericks,82,19805,3128,7041,0.444,967,2688,0.36,2161,4353,0.496,1167,1530,0.763,666,2717,3383,1858,578,965,1578,8390
10676,2018-5-14,Memphis Grizzlies,82,19705,3013,6788,0.444,758,2152,0.352,2255,4636,0.486,1361,1732,0.786,779,2544,3323,1767,613,1182,1900,8145
10677,2018-5-14,Sacramento Kings,82,19755,3179,7063,0.45,738,1967,0.375,2441,5096,0.479,1008,1371,0.735,777,2578,3355,1769,643,1083,1639,8104
10678,2018-5-15,Golden State Warriors,82,19730,3509,6980,0.503,926,2369,0.391,2583,4611,0.56,1360,1668,0.815,691,2877,3568,2402,656,1230,1606,9304
10679,2018-5-15,Houston Rockets,82,19755,3174,6906,0.46,1256,3470,0.362,1918,3436,0.558,1609,2061,0.781,739,2825,3564,1767,699,1081,1597,9213
10680,2018-5-15,New Orleans Pelicans,82,19955,3500,7241,0.483,837,2312,0.362,2663,4929,0.54,1324,1716,0.772,712,2924,3636,2195,657,1182,1570,9161
10681,2018-5-15,Toronto Raptors,82,19830,3383,7169,0.472,968,2703,0.358,2415,4466,0.541,1422,1790,0.794,800,2807,3607,1995,626,1045,1784,9156
10682,2018-5-15,Cleveland Cavaliers,82,19730,3311,6950,0.476,981,2636,0.372,2330,4314,0.54,1488,1909,0.779,694,2761,3455,1916,582,1091,1523,9091
10683,2018-5-15,Denver Nuggets,82,19880,3338,7102,0.47,940,2536,0.371,2398,4566,0.525,1404,1833,0.766,902,2748,3650,2058,627,1175,1533,9020
10684,2018-5-15,Philadelphia 76ers,82,19780,3349,7098,0.472,901,2445,0.369,2448,4653,0.526,1405,1868,0.752,893,2996,3889,2221,682,1301,1813,9004
10685,2018-5-15,Minnesota Timberwolves,82,19805,3365,7063,0.476,658,1845,0.357,2707,5218,0.519,1592,1980,0.804,848,2593,3441,1861,689,963,1495,8980
10686,2018-5-15,Los Angeles Clippers,82,19705,3302,7004,0.471,777,2196,0.354,2525,4808,0.525,1556,2095,0.743,832,2766,3598,1832,627,1154,1638,8937
10687,2018-5-15,Charlotte Hornets,82,19780,3197,7106,0.45,824,2233,0.369,2373,4873,0.487,1656,2216,0.747,826,2901,3727,1770,559,1011,1410,8874
10688,2018-5-15,Los Angeles Lakers,82,19905,3338,7248,0.461,822,2384,0.345,2516,4864,0.517,1364,1910,0.714,876,2926,3802,1949,633,1256,1738,8862
10689,2018-5-15,Oklahoma City Thunder,82,19830,3271,7220,0.453,881,2490,0.354,2390,4730,0.505,1421,1987,0.715,1024,2671,3695,1750,743,1102,1654,8844
10690,2018-5-15,Washington Wizards,82,19855,3275,7018,0.467,814,2173,0.375,2461,4845,0.508,1378,1785,0.772,823,2713,3536,2065,645,1152,1746,8742
10691,2018-5-15,Brooklyn Nets,82,19855,3136,7114,0.441,1041,2924,0.356,2095,4190,0.5,1428,1850,0.772,792,2851,3643,1942,512,1167,1688,8741
10692,2018-5-15,Milwaukee Bucks,82,19830,3257,6807,0.478,718,2024,0.355,2539,4783,0.531,1499,1916,0.782,688,2579,3267,1905,722,1078,1752,8731
10693,2018-5-15,Portland Trail Blazers,82,19755,3222,7132,0.452,845,2308,0.366,2377,4824,0.493,1372,1715,0.8,835,2893,3728,1599,573,1067,1599,8661
10694,2018-5-15,Indiana Pacers,82,19755,3345,7083,0.472,741,2010,0.369,2604,5073,0.513,1225,1573,0.779,788,2684,3472,1819,721,1048,1543,8656
10695,2018-5-15,New York Knicks,82,19830,3334,7194,0.463,673,1914,0.352,2661,5280,0.504,1225,1557,0.787,859,2752,3611,1912,552,1164,1682,8566
10696,2018-5-15,Utah Jazz,82,19755,3139,6797,0.462,887,2425,0.366,2252,4372,0.515,1375,1766,0.779,740,2807,3547,1839,708,1155,1608,8540
10697,2018-5-15,Boston Celtics,82,19805,3141,6975,0.45,939,2492,0.377,2202,4483,0.491,1308,1697,0.771,767,2878,3645,1842,604,1092,1618,8529
10698,2018-5-15,Phoenix Suns,82,19705,3153,7141,0.442,763,2286,0.334,2390,4855,0.492,1453,1963,0.74,842,2776,3618,1743,569,1235,1807,8522
10699,2018-5-15,Detroit Pistons,82,19805,3208,7129,0.45,886,2373,0.373,2322,4756,0.488,1207,1621,0.745,830,2756,3586,1868,628,1046,1508,8509
10700,2018-5-15,Atlanta Hawks,82,19705,3130,7014,0.446,917,2544,0.36,2213,4470,0.495,1298,1654,0.785,742,2693,3435,1946,638,1230,1606,8475
10701,2018-5-15,Orlando Magic,82,19730,3182,7042,0.452,844,2405,0.351,2338,4637,0.504,1271,1678,0.757,722,2692,3414,1921,622,1143,1580,8479
10702,2018-5-15,Miami Heat,82,19930,3184,6997,0.455,903,2506,0.36,2281,4491,0.508,1209,1601,0.755,763,2801,3564,1862,620,1119,1648,8480
10703,2018-5-15,Chicago Bulls,82,19855,3170,7286,0.435,906,2550,0.355,2264,4736,0.478,1194,1576,0.758,790,2873,3663,1923,626,1090,1572,8440
10704,2018-5-15,San Antonio Spurs,82,19730,3202,6999,0.457,696,1977,0.352,2506,5022,0.499,1324,1715,0.772,849,2777,3626,1868,628,1040,1409,8424
10705,2018-5-15,Dallas Mavericks,82,19805,3128,7041,0.444,967,2688,0.36,2161,4353,0.496,1167,1530,0.763,666,2717,3383,1858,578,965,1578,8390
10706,2018-5-15,Memphis Grizzlies,82,19705,3013,6788,0.444,758,2152,0.352,2255,4636,0.486,1361,1732,0.786,779,2544,3323,1767,613,1182,1900,8145
10707,2018-5-15,Sacramento Kings,82,19755,3179,7063,0.45,738,1967,0.375,2441,5096,0.479,1008,1371,0.735,777,2578,3355,1769,643,1083,1639,8104
10708,2018-5-16,Golden State Warriors,82,19730,3509,6980,0.503,926,2369,0.391,2583,4611,0.56,1360,1668,0.815,691,2877,3568,2402,656,1230,1606,9304
10709,2018-5-16,Houston Rockets,82,19755,3174,6906,0.46,1256,3470,0.362,1918,3436,0.558,1609,2061,0.781,739,2825,3564,1767,699,1081,1597,9213
10710,2018-5-16,New Orleans Pelicans,82,19955,3500,7241,0.483,837,2312,0.362,2663,4929,0.54,1324,1716,0.772,712,2924,3636,2195,657,1182,1570,9161
10711,2018-5-16,Toronto Raptors,82,19830,3383,7169,0.472,968,2703,0.358,2415,4466,0.541,1422,1790,0.794,800,2807,3607,1995,626,1045,1784,9156
10712,2018-5-16,Cleveland Cavaliers,82,19730,3311,6950,0.476,981,2636,0.372,2330,4314,0.54,1488,1909,0.779,694,2761,3455,1916,582,1091,1523,9091
10713,2018-5-16,Denver Nuggets,82,19880,3338,7102,0.47,940,2536,0.371,2398,4566,0.525,1404,1833,0.766,902,2748,3650,2058,627,1175,1533,9020
10714,2018-5-16,Philadelphia 76ers,82,19780,3349,7098,0.472,901,2445,0.369,2448,4653,0.526,1405,1868,0.752,893,2996,3889,2221,682,1301,1813,9004
10715,2018-5-16,Minnesota Timberwolves,82,19805,3365,7063,0.476,658,1845,0.357,2707,5218,0.519,1592,1980,0.804,848,2593,3441,1861,689,963,1495,8980
10716,2018-5-16,Los Angeles Clippers,82,19705,3302,7004,0.471,777,2196,0.354,2525,4808,0.525,1556,2095,0.743,832,2766,3598,1832,627,1154,1638,8937
10717,2018-5-16,Charlotte Hornets,82,19780,3197,7106,0.45,824,2233,0.369,2373,4873,0.487,1656,2216,0.747,826,2901,3727,1770,559,1011,1410,8874
10718,2018-5-16,Los Angeles Lakers,82,19905,3338,7248,0.461,822,2384,0.345,2516,4864,0.517,1364,1910,0.714,876,2926,3802,1949,633,1256,1738,8862
10719,2018-5-16,Oklahoma City Thunder,82,19830,3271,7220,0.453,881,2490,0.354,2390,4730,0.505,1421,1987,0.715,1024,2671,3695,1750,743,1102,1654,8844
10720,2018-5-16,Washington Wizards,82,19855,3275,7018,0.467,814,2173,0.375,2461,4845,0.508,1378,1785,0.772,823,2713,3536,2065,645,1152,1746,8742
10721,2018-5-16,Brooklyn Nets,82,19855,3136,7114,0.441,1041,2924,0.356,2095,4190,0.5,1428,1850,0.772,792,2851,3643,1942,512,1167,1688,8741
10722,2018-5-16,Milwaukee Bucks,82,19830,3257,6807,0.478,718,2024,0.355,2539,4783,0.531,1499,1916,0.782,688,2579,3267,1905,722,1078,1752,8731
10723,2018-5-16,Portland Trail Blazers,82,19755,3222,7132,0.452,845,2308,0.366,2377,4824,0.493,1372,1715,0.8,835,2893,3728,1599,573,1067,1599,8661
10724,2018-5-16,Indiana Pacers,82,19755,3345,7083,0.472,741,2010,0.369,2604,5073,0.513,1225,1573,0.779,788,2684,3472,1819,721,1048,1543,8656
10725,2018-5-16,New York Knicks,82,19830,3334,7194,0.463,673,1914,0.352,2661,5280,0.504,1225,1557,0.787,859,2752,3611,1912,552,1164,1682,8566
10726,2018-5-16,Utah Jazz,82,19755,3139,6797,0.462,887,2425,0.366,2252,4372,0.515,1375,1766,0.779,740,2807,3547,1839,708,1155,1608,8540
10727,2018-5-16,Boston Celtics,82,19805,3141,6975,0.45,939,2492,0.377,2202,4483,0.491,1308,1697,0.771,767,2878,3645,1842,604,1092,1618,8529
10728,2018-5-16,Phoenix Suns,82,19705,3153,7141,0.442,763,2286,0.334,2390,4855,0.492,1453,1963,0.74,842,2776,3618,1743,569,1235,1807,8522
10729,2018-5-16,Detroit Pistons,82,19805,3208,7129,0.45,886,2373,0.373,2322,4756,0.488,1207,1621,0.745,830,2756,3586,1868,628,1046,1508,8509
10730,2018-5-16,Atlanta Hawks,82,19705,3130,7014,0.446,917,2544,0.36,2213,4470,0.495,1298,1654,0.785,742,2693,3435,1946,638,1230,1606,8475
10731,2018-5-16,Orlando Magic,82,19730,3182,7042,0.452,844,2405,0.351,2338,4637,0.504,1271,1678,0.757,722,2692,3414,1921,622,1143,1580,8479
10732,2018-5-16,Miami Heat,82,19930,3184,6997,0.455,903,2506,0.36,2281,4491,0.508,1209,1601,0.755,763,2801,3564,1862,620,1119,1648,8480
10733,2018-5-16,Chicago Bulls,82,19855,3170,7286,0.435,906,2550,0.355,2264,4736,0.478,1194,1576,0.758,790,2873,3663,1923,626,1090,1572,8440
10734,2018-5-16,San Antonio Spurs,82,19730,3202,6999,0.457,696,1977,0.352,2506,5022,0.499,1324,1715,0.772,849,2777,3626,1868,628,1040,1409,8424
10735,2018-5-16,Dallas Mavericks,82,19805,3128,7041,0.444,967,2688,0.36,2161,4353,0.496,1167,1530,0.763,666,2717,3383,1858,578,965,1578,8390
10736,2018-5-16,Memphis Grizzlies,82,19705,3013,6788,0.444,758,2152,0.352,2255,4636,0.486,1361,1732,0.786,779,2544,3323,1767,613,1182,1900,8145
10737,2018-5-16,Sacramento Kings,82,19755,3179,7063,0.45,738,1967,0.375,2441,5096,0.479,1008,1371,0.735,777,2578,3355,1769,643,1083,1639,8104
10738,2018-5-17,Golden State Warriors,82,19730,3509,6980,0.503,926,2369,0.391,2583,4611,0.56,1360,1668,0.815,691,2877,3568,2402,656,1230,1606,9304
10739,2018-5-17,Houston Rockets,82,19755,3174,6906,0.46,1256,3470,0.362,1918,3436,0.558,1609,2061,0.781,739,2825,3564,1767,699,1081,1597,9213
10740,2018-5-17,New Orleans Pelicans,82,19955,3500,7241,0.483,837,2312,0.362,2663,4929,0.54,1324,1716,0.772,712,2924,3636,2195,657,1182,1570,9161
10741,2018-5-17,Toronto Raptors,82,19830,3383,7169,0.472,968,2703,0.358,2415,4466,0.541,1422,1790,0.794,800,2807,3607,1995,626,1045,1784,9156
10742,2018-5-17,Cleveland Cavaliers,82,19730,3311,6950,0.476,981,2636,0.372,2330,4314,0.54,1488,1909,0.779,694,2761,3455,1916,582,1091,1523,9091
10743,2018-5-17,Denver Nuggets,82,19880,3338,7102,0.47,940,2536,0.371,2398,4566,0.525,1404,1833,0.766,902,2748,3650,2058,627,1175,1533,9020
10744,2018-5-17,Philadelphia 76ers,82,19780,3349,7098,0.472,901,2445,0.369,2448,4653,0.526,1405,1868,0.752,893,2996,3889,2221,682,1301,1813,9004
10745,2018-5-17,Minnesota Timberwolves,82,19805,3365,7063,0.476,658,1845,0.357,2707,5218,0.519,1592,1980,0.804,848,2593,3441,1861,689,963,1495,8980
10746,2018-5-17,Los Angeles Clippers,82,19705,3302,7004,0.471,777,2196,0.354,2525,4808,0.525,1556,2095,0.743,832,2766,3598,1832,627,1154,1638,8937
10747,2018-5-17,Charlotte Hornets,82,19780,3197,7106,0.45,824,2233,0.369,2373,4873,0.487,1656,2216,0.747,826,2901,3727,1770,559,1011,1410,8874
10748,2018-5-17,Los Angeles Lakers,82,19905,3338,7248,0.461,822,2384,0.345,2516,4864,0.517,1364,1910,0.714,876,2926,3802,1949,633,1256,1738,8862
10749,2018-5-17,Oklahoma City Thunder,82,19830,3271,7220,0.453,881,2490,0.354,2390,4730,0.505,1421,1987,0.715,1024,2671,3695,1750,743,1102,1654,8844
10750,2018-5-17,Washington Wizards,82,19855,3275,7018,0.467,814,2173,0.375,2461,4845,0.508,1378,1785,0.772,823,2713,3536,2065,645,1152,1746,8742
10751,2018-5-17,Brooklyn Nets,82,19855,3136,7114,0.441,1041,2924,0.356,2095,4190,0.5,1428,1850,0.772,792,2851,3643,1942,512,1167,1688,8741
10752,2018-5-17,Milwaukee Bucks,82,19830,3257,6807,0.478,718,2024,0.355,2539,4783,0.531,1499,1916,0.782,688,2579,3267,1905,722,1078,1752,8731
10753,2018-5-17,Portland Trail Blazers,82,19755,3222,7132,0.452,845,2308,0.366,2377,4824,0.493,1372,1715,0.8,835,2893,3728,1599,573,1067,1599,8661
10754,2018-5-17,Indiana Pacers,82,19755,3345,7083,0.472,741,2010,0.369,2604,5073,0.513,1225,1573,0.779,788,2684,3472,1819,721,1048,1543,8656
10755,2018-5-17,New York Knicks,82,19830,3334,7194,0.463,673,1914,0.352,2661,5280,0.504,1225,1557,0.787,859,2752,3611,1912,552,1164,1682,8566
10756,2018-5-17,Utah Jazz,82,19755,3139,6797,0.462,887,2425,0.366,2252,4372,0.515,1375,1766,0.779,740,2807,3547,1839,708,1155,1608,8540
10757,2018-5-17,Boston Celtics,82,19805,3141,6975,0.45,939,2492,0.377,2202,4483,0.491,1308,1697,0.771,767,2878,3645,1842,604,1092,1618,8529
10758,2018-5-17,Phoenix Suns,82,19705,3153,7141,0.442,763,2286,0.334,2390,4855,0.492,1453,1963,0.74,842,2776,3618,1743,569,1235,1807,8522
10759,2018-5-17,Detroit Pistons,82,19805,3208,7129,0.45,886,2373,0.373,2322,4756,0.488,1207,1621,0.745,830,2756,3586,1868,628,1046,1508,8509
10760,2018-5-17,Atlanta Hawks,82,19705,3130,7014,0.446,917,2544,0.36,2213,4470,0.495,1298,1654,0.785,742,2693,3435,1946,638,1230,1606,8475
10761,2018-5-17,Orlando Magic,82,19730,3182,7042,0.452,844,2405,0.351,2338,4637,0.504,1271,1678,0.757,722,2692,3414,1921,622,1143,1580,8479
10762,2018-5-17,Miami Heat,82,19930,3184,6997,0.455,903,2506,0.36,2281,4491,0.508,1209,1601,0.755,763,2801,3564,1862,620,1119,1648,8480
10763,2018-5-17,Chicago Bulls,82,19855,3170,7286,0.435,906,2550,0.355,2264,4736,0.478,1194,1576,0.758,790,2873,3663,1923,626,1090,1572,8440
10764,2018-5-17,San Antonio Spurs,82,19730,3202,6999,0.457,696,1977,0.352,2506,5022,0.499,1324,1715,0.772,849,2777,3626,1868,628,1040,1409,8424
10765,2018-5-17,Dallas Mavericks,82,19805,3128,7041,0.444,967,2688,0.36,2161,4353,0.496,1167,1530,0.763,666,2717,3383,1858,578,965,1578,8390
10766,2018-5-17,Memphis Grizzlies,82,19705,3013,6788,0.444,758,2152,0.352,2255,4636,0.486,1361,1732,0.786,779,2544,3323,1767,613,1182,1900,8145
10767,2018-5-17,Sacramento Kings,82,19755,3179,7063,0.45,738,1967,0.375,2441,5096,0.479,1008,1371,0.735,777,2578,3355,1769,643,1083,1639,8104
10768,2018-5-18,Golden State Warriors,82,19730,3509,6980,0.503,926,2369,0.391,2583,4611,0.56,1360,1668,0.815,691,2877,3568,2402,656,1230,1606,9304
10769,2018-5-18,Houston Rockets,82,19755,3174,6906,0.46,1256,3470,0.362,1918,3436,0.558,1609,2061,0.781,739,2825,3564,1767,699,1081,1597,9213
10770,2018-5-18,New Orleans Pelicans,82,19955,3500,7241,0.483,837,2312,0.362,2663,4929,0.54,1324,1716,0.772,712,2924,3636,2195,657,1182,1570,9161
10771,2018-5-18,Toronto Raptors,82,19830,3383,7169,0.472,968,2703,0.358,2415,4466,0.541,1422,1790,0.794,800,2807,3607,1995,626,1045,1784,9156
10772,2018-5-18,Cleveland Cavaliers,82,19730,3311,6950,0.476,981,2636,0.372,2330,4314,0.54,1488,1909,0.779,694,2761,3455,1916,582,1091,1523,9091
10773,2018-5-18,Denver Nuggets,82,19880,3338,7102,0.47,940,2536,0.371,2398,4566,0.525,1404,1833,0.766,902,2748,3650,2058,627,1175,1533,9020
10774,2018-5-18,Philadelphia 76ers,82,19780,3349,7098,0.472,901,2445,0.369,2448,4653,0.526,1405,1868,0.752,893,2996,3889,2221,682,1301,1813,9004
10775,2018-5-18,Minnesota Timberwolves,82,19805,3365,7063,0.476,658,1845,0.357,2707,5218,0.519,1592,1980,0.804,848,2593,3441,1861,689,963,1495,8980
10776,2018-5-18,Los Angeles Clippers,82,19705,3302,7004,0.471,777,2196,0.354,2525,4808,0.525,1556,2095,0.743,832,2766,3598,1832,627,1154,1638,8937
10777,2018-5-18,Charlotte Hornets,82,19780,3197,7106,0.45,824,2233,0.369,2373,4873,0.487,1656,2216,0.747,826,2901,3727,1770,559,1011,1410,8874
10778,2018-5-18,Los Angeles Lakers,82,19905,3338,7248,0.461,822,2384,0.345,2516,4864,0.517,1364,1910,0.714,876,2926,3802,1949,633,1256,1738,8862
10779,2018-5-18,Oklahoma City Thunder,82,19830,3271,7220,0.453,881,2490,0.354,2390,4730,0.505,1421,1987,0.715,1024,2671,3695,1750,743,1102,1654,8844
10780,2018-5-18,Washington Wizards,82,19855,3275,7018,0.467,814,2173,0.375,2461,4845,0.508,1378,1785,0.772,823,2713,3536,2065,645,1152,1746,8742
10781,2018-5-18,Brooklyn Nets,82,19855,3136,7114,0.441,1041,2924,0.356,2095,4190,0.5,1428,1850,0.772,792,2851,3643,1942,512,1167,1688,8741
10782,2018-5-18,Milwaukee Bucks,82,19830,3257,6807,0.478,718,2024,0.355,2539,4783,0.531,1499,1916,0.782,688,2579,3267,1905,722,1078,1752,8731
10783,2018-5-18,Portland Trail Blazers,82,19755,3222,7132,0.452,845,2308,0.366,2377,4824,0.493,1372,1715,0.8,835,2893,3728,1599,573,1067,1599,8661
10784,2018-5-18,Indiana Pacers,82,19755,3345,7083,0.472,741,2010,0.369,2604,5073,0.513,1225,1573,0.779,788,2684,3472,1819,721,1048,1543,8656
10785,2018-5-18,New York Knicks,82,19830,3334,7194,0.463,673,1914,0.352,2661,5280,0.504,1225,1557,0.787,859,2752,3611,1912,552,1164,1682,8566
10786,2018-5-18,Utah Jazz,82,19755,3139,6797,0.462,887,2425,0.366,2252,4372,0.515,1375,1766,0.779,740,2807,3547,1839,708,1155,1608,8540
10787,2018-5-18,Boston Celtics,82,19805,3141,6975,0.45,939,2492,0.377,2202,4483,0.491,1308,1697,0.771,767,2878,3645,1842,604,1092,1618,8529
10788,2018-5-18,Phoenix Suns,82,19705,3153,7141,0.442,763,2286,0.334,2390,4855,0.492,1453,1963,0.74,842,2776,3618,1743,569,1235,1807,8522
10789,2018-5-18,Detroit Pistons,82,19805,3208,7129,0.45,886,2373,0.373,2322,4756,0.488,1207,1621,0.745,830,2756,3586,1868,628,1046,1508,8509
10790,2018-5-18,Atlanta Hawks,82,19705,3130,7014,0.446,917,2544,0.36,2213,4470,0.495,1298,1654,0.785,742,2693,3435,1946,638,1230,1606,8475
10791,2018-5-18,Orlando Magic,82,19730,3182,7042,0.452,844,2405,0.351,2338,4637,0.504,1271,1678,0.757,722,2692,3414,1921,622,1143,1580,8479
10792,2018-5-18,Miami Heat,82,19930,3184,6997,0.455,903,2506,0.36,2281,4491,0.508,1209,1601,0.755,763,2801,3564,1862,620,1119,1648,8480
10793,2018-5-18,Chicago Bulls,82,19855,3170,7286,0.435,906,2550,0.355,2264,4736,0.478,1194,1576,0.758,790,2873,3663,1923,626,1090,1572,8440
10794,2018-5-18,San Antonio Spurs,82,19730,3202,6999,0.457,696,1977,0.352,2506,5022,0.499,1324,1715,0.772,849,2777,3626,1868,628,1040,1409,8424
10795,2018-5-18,Dallas Mavericks,82,19805,3128,7041,0.444,967,2688,0.36,2161,4353,0.496,1167,1530,0.763,666,2717,3383,1858,578,965,1578,8390
10796,2018-5-18,Memphis Grizzlies,82,19705,3013,6788,0.444,758,2152,0.352,2255,4636,0.486,1361,1732,0.786,779,2544,3323,1767,613,1182,1900,8145
10797,2018-5-18,Sacramento Kings,82,19755,3179,7063,0.45,738,1967,0.375,2441,5096,0.479,1008,1371,0.735,777,2578,3355,1769,643,1083,1639,8104
10798,2018-5-19,Golden State Warriors,82,19730,3509,6980,0.503,926,2369,0.391,2583,4611,0.56,1360,1668,0.815,691,2877,3568,2402,656,1230,1606,9304
10799,2018-5-19,Houston Rockets,82,19755,3174,6906,0.46,1256,3470,0.362,1918,3436,0.558,1609,2061,0.781,739,2825,3564,1767,699,1081,1597,9213
10800,2018-5-19,New Orleans Pelicans,82,19955,3500,7241,0.483,837,2312,0.362,2663,4929,0.54,1324,1716,0.772,712,2924,3636,2195,657,1182,1570,9161
10801,2018-5-19,Toronto Raptors,82,19830,3383,7169,0.472,968,2703,0.358,2415,4466,0.541,1422,1790,0.794,800,2807,3607,1995,626,1045,1784,9156
10802,2018-5-19,Cleveland Cavaliers,82,19730,3311,6950,0.476,981,2636,0.372,2330,4314,0.54,1488,1909,0.779,694,2761,3455,1916,582,1091,1523,9091
10803,2018-5-19,Denver Nuggets,82,19880,3338,7102,0.47,940,2536,0.371,2398,4566,0.525,1404,1833,0.766,902,2748,3650,2058,627,1175,1533,9020
10804,2018-5-19,Philadelphia 76ers,82,19780,3349,7098,0.472,901,2445,0.369,2448,4653,0.526,1405,1868,0.752,893,2996,3889,2221,682,1301,1813,9004
10805,2018-5-19,Minnesota Timberwolves,82,19805,3365,7063,0.476,658,1845,0.357,2707,5218,0.519,1592,1980,0.804,848,2593,3441,1861,689,963,1495,8980
10806,2018-5-19,Los Angeles Clippers,82,19705,3302,7004,0.471,777,2196,0.354,2525,4808,0.525,1556,2095,0.743,832,2766,3598,1832,627,1154,1638,8937
10807,2018-5-19,Charlotte Hornets,82,19780,3197,7106,0.45,824,2233,0.369,2373,4873,0.487,1656,2216,0.747,826,2901,3727,1770,559,1011,1410,8874
10808,2018-5-19,Los Angeles Lakers,82,19905,3338,7248,0.461,822,2384,0.345,2516,4864,0.517,1364,1910,0.714,876,2926,3802,1949,633,1256,1738,8862
10809,2018-5-19,Oklahoma City Thunder,82,19830,3271,7220,0.453,881,2490,0.354,2390,4730,0.505,1421,1987,0.715,1024,2671,3695,1750,743,1102,1654,8844
10810,2018-5-19,Washington Wizards,82,19855,3275,7018,0.467,814,2173,0.375,2461,4845,0.508,1378,1785,0.772,823,2713,3536,2065,645,1152,1746,8742
10811,2018-5-19,Brooklyn Nets,82,19855,3136,7114,0.441,1041,2924,0.356,2095,4190,0.5,1428,1850,0.772,792,2851,3643,1942,512,1167,1688,8741
10812,2018-5-19,Milwaukee Bucks,82,19830,3257,6807,0.478,718,2024,0.355,2539,4783,0.531,1499,1916,0.782,688,2579,3267,1905,722,1078,1752,8731
10813,2018-5-19,Portland Trail Blazers,82,19755,3222,7132,0.452,845,2308,0.366,2377,4824,0.493,1372,1715,0.8,835,2893,3728,1599,573,1067,1599,8661
10814,2018-5-19,Indiana Pacers,82,19755,3345,7083,0.472,741,2010,0.369,2604,5073,0.513,1225,1573,0.779,788,2684,3472,1819,721,1048,1543,8656
10815,2018-5-19,New York Knicks,82,19830,3334,7194,0.463,673,1914,0.352,2661,5280,0.504,1225,1557,0.787,859,2752,3611,1912,552,1164,1682,8566
10816,2018-5-19,Utah Jazz,82,19755,3139,6797,0.462,887,2425,0.366,2252,4372,0.515,1375,1766,0.779,740,2807,3547,1839,708,1155,1608,8540
10817,2018-5-19,Boston Celtics,82,19805,3141,6975,0.45,939,2492,0.377,2202,4483,0.491,1308,1697,0.771,767,2878,3645,1842,604,1092,1618,8529
10818,2018-5-19,Phoenix Suns,82,19705,3153,7141,0.442,763,2286,0.334,2390,4855,0.492,1453,1963,0.74,842,2776,3618,1743,569,1235,1807,8522
10819,2018-5-19,Detroit Pistons,82,19805,3208,7129,0.45,886,2373,0.373,2322,4756,0.488,1207,1621,0.745,830,2756,3586,1868,628,1046,1508,8509
10820,2018-5-19,Atlanta Hawks,82,19705,3130,7014,0.446,917,2544,0.36,2213,4470,0.495,1298,1654,0.785,742,2693,3435,1946,638,1230,1606,8475
10821,2018-5-19,Orlando Magic,82,19730,3182,7042,0.452,844,2405,0.351,2338,4637,0.504,1271,1678,0.757,722,2692,3414,1921,622,1143,1580,8479
10822,2018-5-19,Miami Heat,82,19930,3184,6997,0.455,903,2506,0.36,2281,4491,0.508,1209,1601,0.755,763,2801,3564,1862,620,1119,1648,8480
10823,2018-5-19,Chicago Bulls,82,19855,3170,7286,0.435,906,2550,0.355,2264,4736,0.478,1194,1576,0.758,790,2873,3663,1923,626,1090,1572,8440
10824,2018-5-19,San Antonio Spurs,82,19730,3202,6999,0.457,696,1977,0.352,2506,5022,0.499,1324,1715,0.772,849,2777,3626,1868,628,1040,1409,8424
10825,2018-5-19,Dallas Mavericks,82,19805,3128,7041,0.444,967,2688,0.36,2161,4353,0.496,1167,1530,0.763,666,2717,3383,1858,578,965,1578,8390
10826,2018-5-19,Memphis Grizzlies,82,19705,3013,6788,0.444,758,2152,0.352,2255,4636,0.486,1361,1732,0.786,779,2544,3323,1767,613,1182,1900,8145
10827,2018-5-19,Sacramento Kings,82,19755,3179,7063,0.45,738,1967,0.375,2441,5096,0.479,1008,1371,0.735,777,2578,3355,1769,643,1083,1639,8104
10828,2018-5-20,Golden State Warriors,82,19730,3509,6980,0.503,926,2369,0.391,2583,4611,0.56,1360,1668,0.815,691,2877,3568,2402,656,1230,1606,9304
10829,2018-5-20,Houston Rockets,82,19755,3174,6906,0.46,1256,3470,0.362,1918,3436,0.558,1609,2061,0.781,739,2825,3564,1767,699,1081,1597,9213
10830,2018-5-20,New Orleans Pelicans,82,19955,3500,7241,0.483,837,2312,0.362,2663,4929,0.54,1324,1716,0.772,712,2924,3636,2195,657,1182,1570,9161
10831,2018-5-20,Toronto Raptors,82,19830,3383,7169,0.472,968,2703,0.358,2415,4466,0.541,1422,1790,0.794,800,2807,3607,1995,626,1045,1784,9156
10832,2018-5-20,Cleveland Cavaliers,82,19730,3311,6950,0.476,981,2636,0.372,2330,4314,0.54,1488,1909,0.779,694,2761,3455,1916,582,1091,1523,9091
10833,2018-5-20,Denver Nuggets,82,19880,3338,7102,0.47,940,2536,0.371,2398,4566,0.525,1404,1833,0.766,902,2748,3650,2058,627,1175,1533,9020
10834,2018-5-20,Philadelphia 76ers,82,19780,3349,7098,0.472,901,2445,0.369,2448,4653,0.526,1405,1868,0.752,893,2996,3889,2221,682,1301,1813,9004
10835,2018-5-20,Minnesota Timberwolves,82,19805,3365,7063,0.476,658,1845,0.357,2707,5218,0.519,1592,1980,0.804,848,2593,3441,1861,689,963,1495,8980
10836,2018-5-20,Los Angeles Clippers,82,19705,3302,7004,0.471,777,2196,0.354,2525,4808,0.525,1556,2095,0.743,832,2766,3598,1832,627,1154,1638,8937
10837,2018-5-20,Charlotte Hornets,82,19780,3197,7106,0.45,824,2233,0.369,2373,4873,0.487,1656,2216,0.747,826,2901,3727,1770,559,1011,1410,8874
10838,2018-5-20,Los Angeles Lakers,82,19905,3338,7248,0.461,822,2384,0.345,2516,4864,0.517,1364,1910,0.714,876,2926,3802,1949,633,1256,1738,8862
10839,2018-5-20,Oklahoma City Thunder,82,19830,3271,7220,0.453,881,2490,0.354,2390,4730,0.505,1421,1987,0.715,1024,2671,3695,1750,743,1102,1654,8844
10840,2018-5-20,Washington Wizards,82,19855,3275,7018,0.467,814,2173,0.375,2461,4845,0.508,1378,1785,0.772,823,2713,3536,2065,645,1152,1746,8742
10841,2018-5-20,Brooklyn Nets,82,19855,3136,7114,0.441,1041,2924,0.356,2095,4190,0.5,1428,1850,0.772,792,2851,3643,1942,512,1167,1688,8741
10842,2018-5-20,Milwaukee Bucks,82,19830,3257,6807,0.478,718,2024,0.355,2539,4783,0.531,1499,1916,0.782,688,2579,3267,1905,722,1078,1752,8731
10843,2018-5-20,Portland Trail Blazers,82,19755,3222,7132,0.452,845,2308,0.366,2377,4824,0.493,1372,1715,0.8,835,2893,3728,1599,573,1067,1599,8661
10844,2018-5-20,Indiana Pacers,82,19755,3345,7083,0.472,741,2010,0.369,2604,5073,0.513,1225,1573,0.779,788,2684,3472,1819,721,1048,1543,8656
10845,2018-5-20,New York Knicks,82,19830,3334,7194,0.463,673,1914,0.352,2661,5280,0.504,1225,1557,0.787,859,2752,3611,1912,552,1164,1682,8566
10846,2018-5-20,Utah Jazz,82,19755,3139,6797,0.462,887,2425,0.366,2252,4372,0.515,1375,1766,0.779,740,2807,3547,1839,708,1155,1608,8540
10847,2018-5-20,Boston Celtics,82,19805,3141,6975,0.45,939,2492,0.377,2202,4483,0.491,1308,1697,0.771,767,2878,3645,1842,604,1092,1618,8529
10848,2018-5-20,Phoenix Suns,82,19705,3153,7141,0.442,763,2286,0.334,2390,4855,0.492,1453,1963,0.74,842,2776,3618,1743,569,1235,1807,8522
10849,2018-5-20,Detroit Pistons,82,19805,3208,7129,0.45,886,2373,0.373,2322,4756,0.488,1207,1621,0.745,830,2756,3586,1868,628,1046,1508,8509
10850,2018-5-20,Atlanta Hawks,82,19705,3130,7014,0.446,917,2544,0.36,2213,4470,0.495,1298,1654,0.785,742,2693,3435,1946,638,1230,1606,8475
10851,2018-5-20,Orlando Magic,82,19730,3182,7042,0.452,844,2405,0.351,2338,4637,0.504,1271,1678,0.757,722,2692,3414,1921,622,1143,1580,8479
10852,2018-5-20,Miami Heat,82,19930,3184,6997,0.455,903,2506,0.36,2281,4491,0.508,1209,1601,0.755,763,2801,3564,1862,620,1119,1648,8480
10853,2018-5-20,Chicago Bulls,82,19855,3170,7286,0.435,906,2550,0.355,2264,4736,0.478,1194,1576,0.758,790,2873,3663,1923,626,1090,1572,8440
10854,2018-5-20,San Antonio Spurs,82,19730,3202,6999,0.457,696,1977,0.352,2506,5022,0.499,1324,1715,0.772,849,2777,3626,1868,628,1040,1409,8424
10855,2018-5-20,Dallas Mavericks,82,19805,3128,7041,0.444,967,2688,0.36,2161,4353,0.496,1167,1530,0.763,666,2717,3383,1858,578,965,1578,8390
10856,2018-5-20,Memphis Grizzlies,82,19705,3013,6788,0.444,758,2152,0.352,2255,4636,0.486,1361,1732,0.786,779,2544,3323,1767,613,1182,1900,8145
10857,2018-5-20,Sacramento Kings,82,19755,3179,7063,0.45,738,1967,0.375,2441,5096,0.479,1008,1371,0.735,777,2578,3355,1769,643,1083,1639,8104
10858,2018-5-21,Golden State Warriors,82,19730,3509,6980,0.503,926,2369,0.391,2583,4611,0.56,1360,1668,0.815,691,2877,3568,2402,656,1230,1606,9304
10859,2018-5-21,Houston Rockets,82,19755,3174,6906,0.46,1256,3470,0.362,1918,3436,0.558,1609,2061,0.781,739,2825,3564,1767,699,1081,1597,9213
10860,2018-5-21,New Orleans Pelicans,82,19955,3500,7241,0.483,837,2312,0.362,2663,4929,0.54,1324,1716,0.772,712,2924,3636,2195,657,1182,1570,9161
10861,2018-5-21,Toronto Raptors,82,19830,3383,7169,0.472,968,2703,0.358,2415,4466,0.541,1422,1790,0.794,800,2807,3607,1995,626,1045,1784,9156
10862,2018-5-21,Cleveland Cavaliers,82,19730,3311,6950,0.476,981,2636,0.372,2330,4314,0.54,1488,1909,0.779,694,2761,3455,1916,582,1091,1523,9091
10863,2018-5-21,Denver Nuggets,82,19880,3338,7102,0.47,940,2536,0.371,2398,4566,0.525,1404,1833,0.766,902,2748,3650,2058,627,1175,1533,9020
10864,2018-5-21,Philadelphia 76ers,82,19780,3349,7098,0.472,901,2445,0.369,2448,4653,0.526,1405,1868,0.752,893,2996,3889,2221,682,1301,1813,9004
10865,2018-5-21,Minnesota Timberwolves,82,19805,3365,7063,0.476,658,1845,0.357,2707,5218,0.519,1592,1980,0.804,848,2593,3441,1861,689,963,1495,8980
10866,2018-5-21,Los Angeles Clippers,82,19705,3302,7004,0.471,777,2196,0.354,2525,4808,0.525,1556,2095,0.743,832,2766,3598,1832,627,1154,1638,8937
10867,2018-5-21,Charlotte Hornets,82,19780,3197,7106,0.45,824,2233,0.369,2373,4873,0.487,1656,2216,0.747,826,2901,3727,1770,559,1011,1410,8874
10868,2018-5-21,Los Angeles Lakers,82,19905,3338,7248,0.461,822,2384,0.345,2516,4864,0.517,1364,1910,0.714,876,2926,3802,1949,633,1256,1738,8862
10869,2018-5-21,Oklahoma City Thunder,82,19830,3271,7220,0.453,881,2490,0.354,2390,4730,0.505,1421,1987,0.715,1024,2671,3695,1750,743,1102,1654,8844
10870,2018-5-21,Washington Wizards,82,19855,3275,7018,0.467,814,2173,0.375,2461,4845,0.508,1378,1785,0.772,823,2713,3536,2065,645,1152,1746,8742
10871,2018-5-21,Brooklyn Nets,82,19855,3136,7114,0.441,1041,2924,0.356,2095,4190,0.5,1428,1850,0.772,792,2851,3643,1942,512,1167,1688,8741
10872,2018-5-21,Milwaukee Bucks,82,19830,3257,6807,0.478,718,2024,0.355,2539,4783,0.531,1499,1916,0.782,688,2579,3267,1905,722,1078,1752,8731
10873,2018-5-21,Portland Trail Blazers,82,19755,3222,7132,0.452,845,2308,0.366,2377,4824,0.493,1372,1715,0.8,835,2893,3728,1599,573,1067,1599,8661
10874,2018-5-21,Indiana Pacers,82,19755,3345,7083,0.472,741,2010,0.369,2604,5073,0.513,1225,1573,0.779,788,2684,3472,1819,721,1048,1543,8656
10875,2018-5-21,New York Knicks,82,19830,3334,7194,0.463,673,1914,0.352,2661,5280,0.504,1225,1557,0.787,859,2752,3611,1912,552,1164,1682,8566
10876,2018-5-21,Utah Jazz,82,19755,3139,6797,0.462,887,2425,0.366,2252,4372,0.515,1375,1766,0.779,740,2807,3547,1839,708,1155,1608,8540
10877,2018-5-21,Boston Celtics,82,19805,3141,6975,0.45,939,2492,0.377,2202,4483,0.491,1308,1697,0.771,767,2878,3645,1842,604,1092,1618,8529
10878,2018-5-21,Phoenix Suns,82,19705,3153,7141,0.442,763,2286,0.334,2390,4855,0.492,1453,1963,0.74,842,2776,3618,1743,569,1235,1807,8522
10879,2018-5-21,Detroit Pistons,82,19805,3208,7129,0.45,886,2373,0.373,2322,4756,0.488,1207,1621,0.745,830,2756,3586,1868,628,1046,1508,8509
10880,2018-5-21,Atlanta Hawks,82,19705,3130,7014,0.446,917,2544,0.36,2213,4470,0.495,1298,1654,0.785,742,2693,3435,1946,638,1230,1606,8475
10881,2018-5-21,Orlando Magic,82,19730,3182,7042,0.452,844,2405,0.351,2338,4637,0.504,1271,1678,0.757,722,2692,3414,1921,622,1143,1580,8479
10882,2018-5-21,Miami Heat,82,19930,3184,6997,0.455,903,2506,0.36,2281,4491,0.508,1209,1601,0.755,763,2801,3564,1862,620,1119,1648,8480
10883,2018-5-21,Chicago Bulls,82,19855,3170,7286,0.435,906,2550,0.355,2264,4736,0.478,1194,1576,0.758,790,2873,3663,1923,626,1090,1572,8440
10884,2018-5-21,San Antonio Spurs,82,19730,3202,6999,0.457,696,1977,0.352,2506,5022,0.499,1324,1715,0.772,849,2777,3626,1868,628,1040,1409,8424
10885,2018-5-21,Dallas Mavericks,82,19805,3128,7041,0.444,967,2688,0.36,2161,4353,0.496,1167,1530,0.763,666,2717,3383,1858,578,965,1578,8390
10886,2018-5-21,Memphis Grizzlies,82,19705,3013,6788,0.444,758,2152,0.352,2255,4636,0.486,1361,1732,0.786,779,2544,3323,1767,613,1182,1900,8145
10887,2018-5-21,Sacramento Kings,82,19755,3179,7063,0.45,738,1967,0.375,2441,5096,0.479,1008,1371,0.735,777,2578,3355,1769,643,1083,1639,8104
10888,2018-5-22,Golden State Warriors,82,19730,3509,6980,0.503,926,2369,0.391,2583,4611,0.56,1360,1668,0.815,691,2877,3568,2402,656,1230,1606,9304
10889,2018-5-22,Houston Rockets,82,19755,3174,6906,0.46,1256,3470,0.362,1918,3436,0.558,1609,2061,0.781,739,2825,3564,1767,699,1081,1597,9213
10890,2018-5-22,New Orleans Pelicans,82,19955,3500,7241,0.483,837,2312,0.362,2663,4929,0.54,1324,1716,0.772,712,2924,3636,2195,657,1182,1570,9161
10891,2018-5-22,Toronto Raptors,82,19830,3383,7169,0.472,968,2703,0.358,2415,4466,0.541,1422,1790,0.794,800,2807,3607,1995,626,1045,1784,9156
10892,2018-5-22,Cleveland Cavaliers,82,19730,3311,6950,0.476,981,2636,0.372,2330,4314,0.54,1488,1909,0.779,694,2761,3455,1916,582,1091,1523,9091
10893,2018-5-22,Denver Nuggets,82,19880,3338,7102,0.47,940,2536,0.371,2398,4566,0.525,1404,1833,0.766,902,2748,3650,2058,627,1175,1533,9020
10894,2018-5-22,Philadelphia 76ers,82,19780,3349,7098,0.472,901,2445,0.369,2448,4653,0.526,1405,1868,0.752,893,2996,3889,2221,682,1301,1813,9004
10895,2018-5-22,Minnesota Timberwolves,82,19805,3365,7063,0.476,658,1845,0.357,2707,5218,0.519,1592,1980,0.804,848,2593,3441,1861,689,963,1495,8980
10896,2018-5-22,Los Angeles Clippers,82,19705,3302,7004,0.471,777,2196,0.354,2525,4808,0.525,1556,2095,0.743,832,2766,3598,1832,627,1154,1638,8937
10897,2018-5-22,Charlotte Hornets,82,19780,3197,7106,0.45,824,2233,0.369,2373,4873,0.487,1656,2216,0.747,826,2901,3727,1770,559,1011,1410,8874
10898,2018-5-22,Los Angeles Lakers,82,19905,3338,7248,0.461,822,2384,0.345,2516,4864,0.517,1364,1910,0.714,876,2926,3802,1949,633,1256,1738,8862
10899,2018-5-22,Oklahoma City Thunder,82,19830,3271,7220,0.453,881,2490,0.354,2390,4730,0.505,1421,1987,0.715,1024,2671,3695,1750,743,1102,1654,8844
10900,2018-5-22,Washington Wizards,82,19855,3275,7018,0.467,814,2173,0.375,2461,4845,0.508,1378,1785,0.772,823,2713,3536,2065,645,1152,1746,8742
10901,2018-5-22,Brooklyn Nets,82,19855,3136,7114,0.441,1041,2924,0.356,2095,4190,0.5,1428,1850,0.772,792,2851,3643,1942,512,1167,1688,8741
10902,2018-5-22,Milwaukee Bucks,82,19830,3257,6807,0.478,718,2024,0.355,2539,4783,0.531,1499,1916,0.782,688,2579,3267,1905,722,1078,1752,8731
10903,2018-5-22,Portland Trail Blazers,82,19755,3222,7132,0.452,845,2308,0.366,2377,4824,0.493,1372,1715,0.8,835,2893,3728,1599,573,1067,1599,8661
10904,2018-5-22,Indiana Pacers,82,19755,3345,7083,0.472,741,2010,0.369,2604,5073,0.513,1225,1573,0.779,788,2684,3472,1819,721,1048,1543,8656
10905,2018-5-22,New York Knicks,82,19830,3334,7194,0.463,673,1914,0.352,2661,5280,0.504,1225,1557,0.787,859,2752,3611,1912,552,1164,1682,8566
10906,2018-5-22,Utah Jazz,82,19755,3139,6797,0.462,887,2425,0.366,2252,4372,0.515,1375,1766,0.779,740,2807,3547,1839,708,1155,1608,8540
10907,2018-5-22,Boston Celtics,82,19805,3141,6975,0.45,939,2492,0.377,2202,4483,0.491,1308,1697,0.771,767,2878,3645,1842,604,1092,1618,8529
10908,2018-5-22,Phoenix Suns,82,19705,3153,7141,0.442,763,2286,0.334,2390,4855,0.492,1453,1963,0.74,842,2776,3618,1743,569,1235,1807,8522
10909,2018-5-22,Detroit Pistons,82,19805,3208,7129,0.45,886,2373,0.373,2322,4756,0.488,1207,1621,0.745,830,2756,3586,1868,628,1046,1508,8509
10910,2018-5-22,Atlanta Hawks,82,19705,3130,7014,0.446,917,2544,0.36,2213,4470,0.495,1298,1654,0.785,742,2693,3435,1946,638,1230,1606,8475
10911,2018-5-22,Orlando Magic,82,19730,3182,7042,0.452,844,2405,0.351,2338,4637,0.504,1271,1678,0.757,722,2692,3414,1921,622,1143,1580,8479
10912,2018-5-22,Miami Heat,82,19930,3184,6997,0.455,903,2506,0.36,2281,4491,0.508,1209,1601,0.755,763,2801,3564,1862,620,1119,1648,8480
10913,2018-5-22,Chicago Bulls,82,19855,3170,7286,0.435,906,2550,0.355,2264,4736,0.478,1194,1576,0.758,790,2873,3663,1923,626,1090,1572,8440
10914,2018-5-22,San Antonio Spurs,82,19730,3202,6999,0.457,696,1977,0.352,2506,5022,0.499,1324,1715,0.772,849,2777,3626,1868,628,1040,1409,8424
10915,2018-5-22,Dallas Mavericks,82,19805,3128,7041,0.444,967,2688,0.36,2161,4353,0.496,1167,1530,0.763,666,2717,3383,1858,578,965,1578,8390
10916,2018-5-22,Memphis Grizzlies,82,19705,3013,6788,0.444,758,2152,0.352,2255,4636,0.486,1361,1732,0.786,779,2544,3323,1767,613,1182,1900,8145
10917,2018-5-22,Sacramento Kings,82,19755,3179,7063,0.45,738,1967,0.375,2441,5096,0.479,1008,1371,0.735,777,2578,3355,1769,643,1083,1639,8104
10918,2018-5-23,Golden State Warriors,82,19730,3509,6980,0.503,926,2369,0.391,2583,4611,0.56,1360,1668,0.815,691,2877,3568,2402,656,1230,1606,9304
10919,2018-5-23,Houston Rockets,82,19755,3174,6906,0.46,1256,3470,0.362,1918,3436,0.558,1609,2061,0.781,739,2825,3564,1767,699,1081,1597,9213
10920,2018-5-23,New Orleans Pelicans,82,19955,3500,7241,0.483,837,2312,0.362,2663,4929,0.54,1324,1716,0.772,712,2924,3636,2195,657,1182,1570,9161
10921,2018-5-23,Toronto Raptors,82,19830,3383,7169,0.472,968,2703,0.358,2415,4466,0.541,1422,1790,0.794,800,2807,3607,1995,626,1045,1784,9156
10922,2018-5-23,Cleveland Cavaliers,82,19730,3311,6950,0.476,981,2636,0.372,2330,4314,0.54,1488,1909,0.779,694,2761,3455,1916,582,1091,1523,9091
10923,2018-5-23,Denver Nuggets,82,19880,3338,7102,0.47,940,2536,0.371,2398,4566,0.525,1404,1833,0.766,902,2748,3650,2058,627,1175,1533,9020
10924,2018-5-23,Philadelphia 76ers,82,19780,3349,7098,0.472,901,2445,0.369,2448,4653,0.526,1405,1868,0.752,893,2996,3889,2221,682,1301,1813,9004
10925,2018-5-23,Minnesota Timberwolves,82,19805,3365,7063,0.476,658,1845,0.357,2707,5218,0.519,1592,1980,0.804,848,2593,3441,1861,689,963,1495,8980
10926,2018-5-23,Los Angeles Clippers,82,19705,3302,7004,0.471,777,2196,0.354,2525,4808,0.525,1556,2095,0.743,832,2766,3598,1832,627,1154,1638,8937
10927,2018-5-23,Charlotte Hornets,82,19780,3197,7106,0.45,824,2233,0.369,2373,4873,0.487,1656,2216,0.747,826,2901,3727,1770,559,1011,1410,8874
10928,2018-5-23,Los Angeles Lakers,82,19905,3338,7248,0.461,822,2384,0.345,2516,4864,0.517,1364,1910,0.714,876,2926,3802,1949,633,1256,1738,8862
10929,2018-5-23,Oklahoma City Thunder,82,19830,3271,7220,0.453,881,2490,0.354,2390,4730,0.505,1421,1987,0.715,1024,2671,3695,1750,743,1102,1654,8844
10930,2018-5-23,Washington Wizards,82,19855,3275,7018,0.467,814,2173,0.375,2461,4845,0.508,1378,1785,0.772,823,2713,3536,2065,645,1152,1746,8742
10931,2018-5-23,Brooklyn Nets,82,19855,3136,7114,0.441,1041,2924,0.356,2095,4190,0.5,1428,1850,0.772,792,2851,3643,1942,512,1167,1688,8741
10932,2018-5-23,Milwaukee Bucks,82,19830,3257,6807,0.478,718,2024,0.355,2539,4783,0.531,1499,1916,0.782,688,2579,3267,1905,722,1078,1752,8731
10933,2018-5-23,Portland Trail Blazers,82,19755,3222,7132,0.452,845,2308,0.366,2377,4824,0.493,1372,1715,0.8,835,2893,3728,1599,573,1067,1599,8661
10934,2018-5-23,Indiana Pacers,82,19755,3345,7083,0.472,741,2010,0.369,2604,5073,0.513,1225,1573,0.779,788,2684,3472,1819,721,1048,1543,8656
10935,2018-5-23,New York Knicks,82,19830,3334,7194,0.463,673,1914,0.352,2661,5280,0.504,1225,1557,0.787,859,2752,3611,1912,552,1164,1682,8566
10936,2018-5-23,Utah Jazz,82,19755,3139,6797,0.462,887,2425,0.366,2252,4372,0.515,1375,1766,0.779,740,2807,3547,1839,708,1155,1608,8540
10937,2018-5-23,Boston Celtics,82,19805,3141,6975,0.45,939,2492,0.377,2202,4483,0.491,1308,1697,0.771,767,2878,3645,1842,604,1092,1618,8529
10938,2018-5-23,Phoenix Suns,82,19705,3153,7141,0.442,763,2286,0.334,2390,4855,0.492,1453,1963,0.74,842,2776,3618,1743,569,1235,1807,8522
10939,2018-5-23,Detroit Pistons,82,19805,3208,7129,0.45,886,2373,0.373,2322,4756,0.488,1207,1621,0.745,830,2756,3586,1868,628,1046,1508,8509
10940,2018-5-23,Atlanta Hawks,82,19705,3130,7014,0.446,917,2544,0.36,2213,4470,0.495,1298,1654,0.785,742,2693,3435,1946,638,1230,1606,8475
10941,2018-5-23,Orlando Magic,82,19730,3182,7042,0.452,844,2405,0.351,2338,4637,0.504,1271,1678,0.757,722,2692,3414,1921,622,1143,1580,8479
10942,2018-5-23,Miami Heat,82,19930,3184,6997,0.455,903,2506,0.36,2281,4491,0.508,1209,1601,0.755,763,2801,3564,1862,620,1119,1648,8480
10943,2018-5-23,Chicago Bulls,82,19855,3170,7286,0.435,906,2550,0.355,2264,4736,0.478,1194,1576,0.758,790,2873,3663,1923,626,1090,1572,8440
10944,2018-5-23,San Antonio Spurs,82,19730,3202,6999,0.457,696,1977,0.352,2506,5022,0.499,1324,1715,0.772,849,2777,3626,1868,628,1040,1409,8424
10945,2018-5-23,Dallas Mavericks,82,19805,3128,7041,0.444,967,2688,0.36,2161,4353,0.496,1167,1530,0.763,666,2717,3383,1858,578,965,1578,8390
10946,2018-5-23,Memphis Grizzlies,82,19705,3013,6788,0.444,758,2152,0.352,2255,4636,0.486,1361,1732,0.786,779,2544,3323,1767,613,1182,1900,8145
10947,2018-5-23,Sacramento Kings,82,19755,3179,7063,0.45,738,1967,0.375,2441,5096,0.479,1008,1371,0.735,777,2578,3355,1769,643,1083,1639,8104
10948,2018-5-24,Golden State Warriors,82,19730,3509,6980,0.503,926,2369,0.391,2583,4611,0.56,1360,1668,0.815,691,2877,3568,2402,656,1230,1606,9304
10949,2018-5-24,Houston Rockets,82,19755,3174,6906,0.46,1256,3470,0.362,1918,3436,0.558,1609,2061,0.781,739,2825,3564,1767,699,1081,1597,9213
10950,2018-5-24,New Orleans Pelicans,82,19955,3500,7241,0.483,837,2312,0.362,2663,4929,0.54,1324,1716,0.772,712,2924,3636,2195,657,1182,1570,9161
10951,2018-5-24,Toronto Raptors,82,19830,3383,7169,0.472,968,2703,0.358,2415,4466,0.541,1422,1790,0.794,800,2807,3607,1995,626,1045,1784,9156
10952,2018-5-24,Cleveland Cavaliers,82,19730,3311,6950,0.476,981,2636,0.372,2330,4314,0.54,1488,1909,0.779,694,2761,3455,1916,582,1091,1523,9091
10953,2018-5-24,Denver Nuggets,82,19880,3338,7102,0.47,940,2536,0.371,2398,4566,0.525,1404,1833,0.766,902,2748,3650,2058,627,1175,1533,9020
10954,2018-5-24,Philadelphia 76ers,82,19780,3349,7098,0.472,901,2445,0.369,2448,4653,0.526,1405,1868,0.752,893,2996,3889,2221,682,1301,1813,9004
10955,2018-5-24,Minnesota Timberwolves,82,19805,3365,7063,0.476,658,1845,0.357,2707,5218,0.519,1592,1980,0.804,848,2593,3441,1861,689,963,1495,8980
10956,2018-5-24,Los Angeles Clippers,82,19705,3302,7004,0.471,777,2196,0.354,2525,4808,0.525,1556,2095,0.743,832,2766,3598,1832,627,1154,1638,8937
10957,2018-5-24,Charlotte Hornets,82,19780,3197,7106,0.45,824,2233,0.369,2373,4873,0.487,1656,2216,0.747,826,2901,3727,1770,559,1011,1410,8874
10958,2018-5-24,Los Angeles Lakers,82,19905,3338,7248,0.461,822,2384,0.345,2516,4864,0.517,1364,1910,0.714,876,2926,3802,1949,633,1256,1738,8862
10959,2018-5-24,Oklahoma City Thunder,82,19830,3271,7220,0.453,881,2490,0.354,2390,4730,0.505,1421,1987,0.715,1024,2671,3695,1750,743,1102,1654,8844
10960,2018-5-24,Washington Wizards,82,19855,3275,7018,0.467,814,2173,0.375,2461,4845,0.508,1378,1785,0.772,823,2713,3536,2065,645,1152,1746,8742
10961,2018-5-24,Brooklyn Nets,82,19855,3136,7114,0.441,1041,2924,0.356,2095,4190,0.5,1428,1850,0.772,792,2851,3643,1942,512,1167,1688,8741
10962,2018-5-24,Milwaukee Bucks,82,19830,3257,6807,0.478,718,2024,0.355,2539,4783,0.531,1499,1916,0.782,688,2579,3267,1905,722,1078,1752,8731
10963,2018-5-24,Portland Trail Blazers,82,19755,3222,7132,0.452,845,2308,0.366,2377,4824,0.493,1372,1715,0.8,835,2893,3728,1599,573,1067,1599,8661
10964,2018-5-24,Indiana Pacers,82,19755,3345,7083,0.472,741,2010,0.369,2604,5073,0.513,1225,1573,0.779,788,2684,3472,1819,721,1048,1543,8656
10965,2018-5-24,New York Knicks,82,19830,3334,7194,0.463,673,1914,0.352,2661,5280,0.504,1225,1557,0.787,859,2752,3611,1912,552,1164,1682,8566
10966,2018-5-24,Utah Jazz,82,19755,3139,6797,0.462,887,2425,0.366,2252,4372,0.515,1375,1766,0.779,740,2807,3547,1839,708,1155,1608,8540
10967,2018-5-24,Boston Celtics,82,19805,3141,6975,0.45,939,2492,0.377,2202,4483,0.491,1308,1697,0.771,767,2878,3645,1842,604,1092,1618,8529
10968,2018-5-24,Phoenix Suns,82,19705,3153,7141,0.442,763,2286,0.334,2390,4855,0.492,1453,1963,0.74,842,2776,3618,1743,569,1235,1807,8522
10969,2018-5-24,Detroit Pistons,82,19805,3208,7129,0.45,886,2373,0.373,2322,4756,0.488,1207,1621,0.745,830,2756,3586,1868,628,1046,1508,8509
10970,2018-5-24,Atlanta Hawks,82,19705,3130,7014,0.446,917,2544,0.36,2213,4470,0.495,1298,1654,0.785,742,2693,3435,1946,638,1230,1606,8475
10971,2018-5-24,Orlando Magic,82,19730,3182,7042,0.452,844,2405,0.351,2338,4637,0.504,1271,1678,0.757,722,2692,3414,1921,622,1143,1580,8479
10972,2018-5-24,Miami Heat,82,19930,3184,6997,0.455,903,2506,0.36,2281,4491,0.508,1209,1601,0.755,763,2801,3564,1862,620,1119,1648,8480
10973,2018-5-24,Chicago Bulls,82,19855,3170,7286,0.435,906,2550,0.355,2264,4736,0.478,1194,1576,0.758,790,2873,3663,1923,626,1090,1572,8440
10974,2018-5-24,San Antonio Spurs,82,19730,3202,6999,0.457,696,1977,0.352,2506,5022,0.499,1324,1715,0.772,849,2777,3626,1868,628,1040,1409,8424
10975,2018-5-24,Dallas Mavericks,82,19805,3128,7041,0.444,967,2688,0.36,2161,4353,0.496,1167,1530,0.763,666,2717,3383,1858,578,965,1578,8390
10976,2018-5-24,Memphis Grizzlies,82,19705,3013,6788,0.444,758,2152,0.352,2255,4636,0.486,1361,1732,0.786,779,2544,3323,1767,613,1182,1900,8145
10977,2018-5-24,Sacramento Kings,82,19755,3179,7063,0.45,738,1967,0.375,2441,5096,0.479,1008,1371,0.735,777,2578,3355,1769,643,1083,1639,8104
10978,2018-5-25,Golden State Warriors,82,19730,3509,6980,0.503,926,2369,0.391,2583,4611,0.56,1360,1668,0.815,691,2877,3568,2402,656,1230,1606,9304
10979,2018-5-25,Houston Rockets,82,19755,3174,6906,0.46,1256,3470,0.362,1918,3436,0.558,1609,2061,0.781,739,2825,3564,1767,699,1081,1597,9213
10980,2018-5-25,New Orleans Pelicans,82,19955,3500,7241,0.483,837,2312,0.362,2663,4929,0.54,1324,1716,0.772,712,2924,3636,2195,657,1182,1570,9161
10981,2018-5-25,Toronto Raptors,82,19830,3383,7169,0.472,968,2703,0.358,2415,4466,0.541,1422,1790,0.794,800,2807,3607,1995,626,1045,1784,9156
10982,2018-5-25,Cleveland Cavaliers,82,19730,3311,6950,0.476,981,2636,0.372,2330,4314,0.54,1488,1909,0.779,694,2761,3455,1916,582,1091,1523,9091
10983,2018-5-25,Denver Nuggets,82,19880,3338,7102,0.47,940,2536,0.371,2398,4566,0.525,1404,1833,0.766,902,2748,3650,2058,627,1175,1533,9020
10984,2018-5-25,Philadelphia 76ers,82,19780,3349,7098,0.472,901,2445,0.369,2448,4653,0.526,1405,1868,0.752,893,2996,3889,2221,682,1301,1813,9004
10985,2018-5-25,Minnesota Timberwolves,82,19805,3365,7063,0.476,658,1845,0.357,2707,5218,0.519,1592,1980,0.804,848,2593,3441,1861,689,963,1495,8980
10986,2018-5-25,Los Angeles Clippers,82,19705,3302,7004,0.471,777,2196,0.354,2525,4808,0.525,1556,2095,0.743,832,2766,3598,1832,627,1154,1638,8937
10987,2018-5-25,Charlotte Hornets,82,19780,3197,7106,0.45,824,2233,0.369,2373,4873,0.487,1656,2216,0.747,826,2901,3727,1770,559,1011,1410,8874
10988,2018-5-25,Los Angeles Lakers,82,19905,3338,7248,0.461,822,2384,0.345,2516,4864,0.517,1364,1910,0.714,876,2926,3802,1949,633,1256,1738,8862
10989,2018-5-25,Oklahoma City Thunder,82,19830,3271,7220,0.453,881,2490,0.354,2390,4730,0.505,1421,1987,0.715,1024,2671,3695,1750,743,1102,1654,8844
10990,2018-5-25,Washington Wizards,82,19855,3275,7018,0.467,814,2173,0.375,2461,4845,0.508,1378,1785,0.772,823,2713,3536,2065,645,1152,1746,8742
10991,2018-5-25,Brooklyn Nets,82,19855,3136,7114,0.441,1041,2924,0.356,2095,4190,0.5,1428,1850,0.772,792,2851,3643,1942,512,1167,1688,8741
10992,2018-5-25,Milwaukee Bucks,82,19830,3257,6807,0.478,718,2024,0.355,2539,4783,0.531,1499,1916,0.782,688,2579,3267,1905,722,1078,1752,8731
10993,2018-5-25,Portland Trail Blazers,82,19755,3222,7132,0.452,845,2308,0.366,2377,4824,0.493,1372,1715,0.8,835,2893,3728,1599,573,1067,1599,8661
10994,2018-5-25,Indiana Pacers,82,19755,3345,7083,0.472,741,2010,0.369,2604,5073,0.513,1225,1573,0.779,788,2684,3472,1819,721,1048,1543,8656
10995,2018-5-25,New York Knicks,82,19830,3334,7194,0.463,673,1914,0.352,2661,5280,0.504,1225,1557,0.787,859,2752,3611,1912,552,1164,1682,8566
10996,2018-5-25,Utah Jazz,82,19755,3139,6797,0.462,887,2425,0.366,2252,4372,0.515,1375,1766,0.779,740,2807,3547,1839,708,1155,1608,8540
10997,2018-5-25,Boston Celtics,82,19805,3141,6975,0.45,939,2492,0.377,2202,4483,0.491,1308,1697,0.771,767,2878,3645,1842,604,1092,1618,8529
10998,2018-5-25,Phoenix Suns,82,19705,3153,7141,0.442,763,2286,0.334,2390,4855,0.492,1453,1963,0.74,842,2776,3618,1743,569,1235,1807,8522
10999,2018-5-25,Detroit Pistons,82,19805,3208,7129,0.45,886,2373,0.373,2322,4756,0.488,1207,1621,0.745,830,2756,3586,1868,628,1046,1508,8509
11000,2018-5-25,Atlanta Hawks,82,19705,3130,7014,0.446,917,2544,0.36,2213,4470,0.495,1298,1654,0.785,742,2693,3435,1946,638,1230,1606,8475
11001,2018-5-25,Orlando Magic,82,19730,3182,7042,0.452,844,2405,0.351,2338,4637,0.504,1271,1678,0.757,722,2692,3414,1921,622,1143,1580,8479
11002,2018-5-25,Miami Heat,82,19930,3184,6997,0.455,903,2506,0.36,2281,4491,0.508,1209,1601,0.755,763,2801,3564,1862,620,1119,1648,8480
11003,2018-5-25,Chicago Bulls,82,19855,3170,7286,0.435,906,2550,0.355,2264,4736,0.478,1194,1576,0.758,790,2873,3663,1923,626,1090,1572,8440
11004,2018-5-25,San Antonio Spurs,82,19730,3202,6999,0.457,696,1977,0.352,2506,5022,0.499,1324,1715,0.772,849,2777,3626,1868,628,1040,1409,8424
11005,2018-5-25,Dallas Mavericks,82,19805,3128,7041,0.444,967,2688,0.36,2161,4353,0.496,1167,1530,0.763,666,2717,3383,1858,578,965,1578,8390
11006,2018-5-25,Memphis Grizzlies,82,19705,3013,6788,0.444,758,2152,0.352,2255,4636,0.486,1361,1732,0.786,779,2544,3323,1767,613,1182,1900,8145
11007,2018-5-25,Sacramento Kings,82,19755,3179,7063,0.45,738,1967,0.375,2441,5096,0.479,1008,1371,0.735,777,2578,3355,1769,643,1083,1639,8104
